_______________________________________________
871
मास : सं०० (सं.)। (१) महीना। 'सावन भादव मास ।' मा० १.१६ (२) तीस दिन का समय । “मास दिवस तह रहेउँ खरारी ।' मा० ४.६.७
मासा : मास । मा० १.३४.५
मासु : मास+कए । महीना । 'हिम रितु अगहन मासु सुहावा ।' मा० १.३१२.५
माहँ  : महिं । में, भीतर । जिमि मन माहँ मनोरथ गोई ।' मा० २.३१६.१
माहली : सं०पू० (सं० महल्लिक-दे० महल-अरबी-महल से संबद्ध)। रनिवास का रक्षक=काञ्चुकीय । 'कोने ईस किए कपि भालु खास माहली।' कवि० ७.२३
माहिं, माही : माहं । मैं (परसर्ग)। 'भय बिषाद मन माहिं ।' मा० २.१५८ १.५.५
माहिषमतीँँ: सं०स्त्री० (सं० माहिष्मती)। नगरी विशेष सहस्रबाहु (अर्जुन) ___की राजधानी । कवि० ६.२५
माहुर : सं०० (सं० मधुर विष>प्रा० महुर; सं० माधुर=विष सम्बन्धी चूर्ण ___ आदि>प्रा० माहुर)। विष । 'मरमु पछि मनु माहुर देई ।' मा० २.१६०.७
माहुरु : माहुर+कए० । 'अमिअ सुजीवनु माहुरु मीचू ।' मा० १.६.६
माहूँ: (१) में । ‘सोच जनि मन माहूं।' विन० २७५.३ (२) मध्य में, अन्तर्गत । माया सब सिय माया माहूं।' मा० २.२५२.३
मिट, मिटइ : आ०प्रए० (सं० म्लेट्यते>प्रा० मेट्टइ =मिट्टइ) । मिटता है, नष्ट होता है (म्लेट उन्मादे)। 'मिटइ न मलिन सुभाउ अभंगू ।' मा० १.७.४ 'सुमिरत जाहि मिटइ अग्याना।' मा० १.५३.४ (मूल अर्थ उन्मत्त होना है)।
मिटत : वकृ०० । मिटता-ते । 'सरगहुं मिटत न सावत ।' विन० १८५.४
मिटति : वकृस्त्री० । मिटती, दूर होती । 'अजहुँ न छाया मिटति तुम्हारी।' मा० १.१४१.५
मिटहिं : आ०प्रब । मिटते हैं, नष्ट होते हैं। 'मिहिं दोष दुख दारिद दावा ।'  मा० १.१.७
मिटा : भूकृ०० । समाप्त हुआ । 'सब कर मिटा बिषादु ।' मा० १.६८
मिटाई : पूकृ० । मिटा कर, समाप्त कर । 'निरहि निमि नप के मरजाद मिटाई ।' गी० १.१०८.६
मिटाए : भूकृ.पु । मिटा देने पर । सूने पर सून से मनो मिटाए आंक के।' गी० १.६४.२
मिटि : पूकृ० । मिट कर । 'जासु कृपा अस भ्रम मिटि जाई ।' मा० १.११८.३
मिटिहहिं : आ०भ०प्रब० । 'मिटेंगे, नष्ट होंगे । 'मिटिहहिं पाप प्रपंच सब ।' मा० २.२६३
मिटिहिं : मिटिहहिं । 'पाप मिटिहिं किमि मेरे।' मा० १.१३८.४
872
_______________________________________________
मिटिहि : आ० भ०प्रए । मिटेगा-गी। 'आन उपाय न मिटिहि कलेसू ।' मा० १.७२.२
मिटिहैं : मिटिहहिं । 'सोच सकल मिटिहैं ।' विन० १३५.५
मिटी : भूक०स्त्री० । समाप्त हो गयी। मिटी मोहमय सूल ।' मा० १.२८५
मिटे : भूक ०० ब० । समाप्त हो गये। 'छन महुँ मिटे सकल श्रुति सेतू ।' मा० १.८४.६
मिटेउ : भूकृ०पू०कए० । मिट गया । मिटेउ छोभु ।' मा० २.२६८.१
मिटेहुं : मिट जाने पर भी । 'तुलसी मिटै न मरि मिटेहुँ ।' दो० ३१६
मिटंै : मिटहिं । कवि० ७.१४४
मिटै : (१) मिटइ । मिटता है । 'तुलसी मिटै न मोह तम ।' वैरा०२ (२) चाहे  मिटे । 'भएँ ग्यान बरु मिटै न मोह ।' मा० २.१६६.३
मिटैगो : आ.भ.प्रए । मिटेगा। 'मएह न मिटैगो मेरो मानसिक पछिताउ ।' गी० २.५७.१
मिट् यो : मिटेउ । 'मिट्यो मन को संदेह ।' कृ० ३६
मितप्रद : वि. (सं०) नपा-तुला या सीमित (मित) देने वाला, अल्प दाता। मा० . ३.५.५
मित-भोगी : वि० (सं०) । परिमित भोग (या भोजन) करने वाला संयमी । मा० ३.४५.८
मिताई : सं०स्त्री० (सं० मित्रता>प्रा० मित्तया)। सौहार्द, मैत्री। 'ते सठ हठि कत करत मिताई।' मा० ४.७.३
मिति : सं०स्त्री० (सं०) । नाप, तौल, सीमा । 'राम कथा के मिति जग नाहीं।' मा० १.३३.५
मित्र : (१) सं०० (सं.)। सखा, सुहृद् । 'धीरज धरम मित्र अरु नारी ।' मा० ३.५.७ (२) स्वपक्षी (विपक्ष या शत्रु का विलोम), शुभेच्छ तथा विपत्ति में सहभागी। 'जे हमारे अरि मित्र उदासी ।' मा० २.३.२ (३) सूर्य । दो० ३२२
मित्रक : मित्र का । 'मित्रक दुख रज मेरु समाना ।' मा० ४.७.२
मित्रहि : मित्र से, को। 'मित्र हि कहि सब कथा सुनाई।' मा० १.१७१.२
मिथिला : सं०स्त्री. (सं०) । (१) निमि के पुत्र (जनक वंश के पूर्वज) द्वारा बसायी हुई नगरी । (२) मिथिला जनपद । मा० २.२७०
मिथिलाधनी : मिथिला जनपद के स्वामी जनकराज । मा० २.३०१ छं०
मिथिलाधिप : जनकराज । कवि० ७.१
मिथिलापति : जनकराज । मा० १.२१४.८
मिथिलेस : (सं० मिथिलेश) जनकराज । मा० २.२८४
_______________________________________________
873

मिथिलेसकिसोरी, कुमारी : जानकी जी । मा० २.८२.२; ४.५.२
मिथिलेसि : मिथिलेस+स्त्री० । जनकराज की रानी । मा० २.२८३
मिथिलेसु, मिथिलेसू : मिथिलेस+कए। जनकराज (सीरध्वज)। मा० २.२७४; २.३१५.२
मिथ्या : अव्यय (सं.) । (१) असत्, जिसका आभासमात्र हो-~बाद में प्रतीति बदल जाय=प्रातिभासिक । 'समझें मिथ्या सोपि ।' मा० ७.७१ ख (२) व्यथं, निष्प्रयोजन । 'कालहि कर्महि ईस्वरहि मिथ्या दोस लगाइ ।' मा० ७.४३
मिथ्याबाद : (१) मिथ्या कथन, असत्य जल्पन । पर अपबाद मिथ्याबाद बानी हई ।' विन० २५२.२ (२) असत् को सत् मानने का दर्शन ।
मिथ्यावादी : (१) वि० (सं० मिथ्यावादिन्) । असत् जगत्-सुखों तथा देहादि को सत् मानने वाला (२) झठ बोलने वाला (३) असत्य को ही अज्ञानवश सत्य कहने वाला । 'बालक भ्रमहिं न भ्रमहिं गृहादी । कहहिं परसपर मिथ्याबादी ।' मा० ७.७३.६
मिथ्यारंभ : (१) वि० (सं०) । असत्य तथा निरर्थक (मिथ्या) कार्य (आरम्भ) करने वाला (२) सृष्टि (आरम्भ) को मिथ्या मानने वाला (वैष्णवमत में सृष्टि प्रपञ्च सत्य तथा नित्य है और उसका प्रयोजन लीला है) । मा० ७.६८.४
मिल : मिलइ । मिलता है, मिल सकता है। 'सील कि मिल बिनु बुध सेवकाई ।' मा० ७.१०.६
मिल, मिलह, ई : आ.प्रए० (सं० मिलति--मिल संगमे>प्रा० मिलइ) । (१) जुटता-ती है । 'तैसी मिलइ सहाइ।' मा० १.१५६ (२) भेंटा जाता है । कोज मनि मिलइ ।' मा० ४.२४.२ (३) प्राप्त हो। 'हे बिधि मिलइ कवन बिधि बाला ।' मा० १.१३१.८ (४) मिश्रित होता है । 'कीहि मिलइ नीच जल संगा।' मा० १.७.६ (५) अन्तर्भूत हो जाता है । 'गगनु मगन मकु मेघहिं मिलई ।' मा० २.२३२.२
मिलइ : पू० (सं० मेलयित्वा>प्रा० मिल्लविअ>अ० मिल्लवि)। मिला कर, मिश्रित करके । 'सगुन खीरु अवगुनु जल ताता। मिलइ रचइ पर पंच बिधाता।' मा० २.२३२.५
मिलए : दे० मिलये।
मिलएसि : आ.- भूक०पु+प्रए । उसने मिला दिए =मीस डाले। 'कछु मिल एसि धरि धूरि ।' मा० ५.१८
मिलत : वपु । मिलता-मिलते; मिलते समय । मिलत एक दारुन दुख देहीं।' मा० १.५.४
मिलति : वकृ० स्त्री० । मिलती, भेटती। पुनि पुनि मिलति परति गहि चरना ।' मा० १.१०२.७
874
_______________________________________________
मिलतेउँ : क्रियाति००उए । तो मैं मिलता । 'मिलतेषु तात कवन बिघि तोही।' मा० ७.६६.४
मिलतेहु : क्रियाति००मब०। (यदि) तुम मिलते । 'जौं तुम्ह मिलतेहु प्रथम मुनीसा ।' मा० १.११.१।
मिलन : (१) सं०पू० (सं०)। संयोग । 'मिलन कठिन उर भा संदेहू ।' मा० १.६८.५ (२) भेंट । 'मिलन सुभग संबाद ।' मा० १.४३ ख (३) भक० अध्यय । मिलने । 'ससिहि मिलन तम के गन आए।' गी०१.२६.५
मिलनि, मिलनी : सं०स्त्री० । मिलने की क्रिया+रीति । 'अवलोकनि बोलनि मिलनि ।'  मा० १.४२; ७.१६.४
मिलन : मिलन+कए । भेंट । 'मुनि गन मिलन बिसेषि बन ।' मा० २.४१
मिलन्यौ : (मिलनि+ऊ) मिलने की रीति भी। 'निज मिलन्यो नहिं मोहि सिखाई।' कृ० २५
मिलब : भक०० । (१) मिलना । मिलब हमार भुलाब निज।' मा० १.१६५ (२) मिलना (होगा-मिलूंगा)। 'चौथे दिवस मिलब मैं आई।' मा० १.१७१५
मिलये : भूक०पू०प० । मिला दिये । मीस दिये। 'ते मिलये धरि धरि ।' कवि० ७.१३२
मिलयो : भकृ०पु०कए । मिलाया, मिश्रित किया। 'तन मिलय जल पय की नाई।' कृ० २५
मिलव, मिलवइ : आ०प्रए० (सं० मेलयति>प्रा० मेलवइ =मिलवइ)। मिलता है, मिश्रित करता है। कोटिन्ह मीजि मिलव महि गर्दा।' मा० ६.६७.३
मिलवत : वक० पु । मिलाता-ते, मिश्रित करता-ते। मिलवत अमिय माहुर घोरि के ।' पा०म० छं०७
मिलवहिं : आप्रब० । मिश्रित करते हैं-कर देंगे-कर सकते हैं । 'मदि गर्द मिलवहिं दस सोसा।' मा० ५.५५.७
मिलहिं : आ०प्रब० । मिलते हैं, मिलें, मिल सकते हैं। बिनु हरि कृपा मिलहिं नहिं. संता ।' मा० ५.७.४
मिलहु : आ०मद । मिलो, भेंट करो । 'सीता देइ मिलहु ।' मा० ५.५२
मिला : भूकृ००। 'मिला जाइ जब अनुज तुम्हारा !' मा० ५.५४.२
मिलाइ : पूक ० । मिला कर, मिश्रित कर (परिचित करा कर तथा एकीभूत करा कर) । 'सादर सबहि मिलाइ समाजहि निपट निकट बैठारि ।' गी० ५.३६.३
मिलाउब : भक० । मिलाया जायगा । 'अस बरु तुम्हहि मिलाउब आनी।' मा०. १.८०.४
_______________________________________________
875
मिलापु : सं०पु० (सं० मेलाप मेलापक) कए । मिलन । 'गृह गीध को मिलापु।' कवि० ७.२१
मिलाहिं : मिलहि । 'पूरुब भाग मिलाहिं।' वैरा० २४
मिलि : पूक० । मिलकर । (१) जुट कर । 'सब मिलि करहु छाडि छल छोहू ।' मा० १.८.३ (२) भेंट कर । मिलि सप्रेम पुनि आसिष दीन्ही ।' मा. १.३४२.८ (३) संयुक्त होकर । 'तूल न ताहि सकल मिलि ।' मा० ५.४
मिलिअ, मिलिए : आ०कवा०प्रए । मिला जाय । 'भरतहि मिलिअ, न होइहि रारी ।' मा० २.१६२.५ मिलिए पै नाथ रघुनाथु पहिचानि के ।' कवि० ६.२६
मिलिक : संस्त्री० (अरबी-(१) मलिक जमीन । (२) मिल्क राज्याधिकार) । राज्याधिकार का भू-भाग। यह ब्रज भूमि सकल सुरपति सों मदन मिलिक करि पाई ।' कृ० ३२
मिलित : भूकृ०वि० (सं.) । संयुक्त । 'नृप मनि मुकुट मिलित पदपीठा।' मा० २.६८.१
मिलिबे : भकृ० । मिलने । मिलिबे को साजु सजि ।' कवि० ६.२३
मिलिबो : भकृ.पु.कए। मिलन । 'सोहै सितासित को मिलिबो।' कवि० ७.१४४
मिलिहहिं : आ०म०प्रब० । मिलेंगे। 'मिलिहहिं राम ।' मा० २.२२५.२
मिलिहि : आ०भ०प्रए० । मिलेगा । 'अस स्वामी एहि कहें मिलिहि ।' मा० १.६७. मिलेगी । 'मिलिहि जानकी।' मा० ४.५८
मिलिहौं : आ०भ० उए । मिलंगा । गी० ५.२८.७
मिलीं : भूकृस्त्री०ब० । भेटीं। 'भगिनीं मिली। मा० १.६३.२
मिली : भूकृ० स्त्री० । 'सादर भले हि मिली एक माता।' मा० १.६३.२
मिलु : आ० - आज्ञा- मए । तू मिल । 'सद मिल जाइ तिन्हहि ।' मा० ५.४१.५
मिलें : मिलने से-पर । 'सुरसरि मिलें सो पावन जैसें ।' मा० १.७०.२
मिले : (१) भूकृ.पुं०ब० । भेटे । 'हरषि मिले उठि रमानिकेता ।' मा० १.१२८.५ (२) मिलें । तिनहिं मिले मन भयो कुपथ रत ।' विन० १८७.२
मिलेउ, मिलेऊ : भकृ००कए । मिला। 'अब लगि मोहि न मिलेउ कोउ ।' मा० १.१६१ क; ५.२६.६
मिलेहि : मिलते ही-मिल ही गया था कि परिणाम मिलने के समय में ही । मिलेहि माझ बिधि बास बेगारी।' मा० २.४७.१
मिलेहु : आ०-भूकृ००+मब० । तुम मिले । 'मिले हु राम तुम्ह समन बिषादा ।' ___मा० ४.७.१६
मिलै : मिलहिं । ते तब मिलें द्रव जब सोई ।' विन० १३६.१०
876
_______________________________________________
मिलै : (१) मिलइ । मिलता है, मिल सकता है। 'तेहि दिन ताहि न मिले अहारा ।' मा० ५७.८ (२) मिलइ । मिला कर। 'जड़ पंच मिल जेहिं देह करी।' कवि० ७.२७
मिलौं : आ० उए । मिलू, मिल सकू । 'जब लगि मिलों तुम्हहि तनु त्यागी।' मा० ३.८.६
मिलौ : आ०-कामना+प्रार्थना-प्रए० (सं० मिलत>प्रा. मिलउ)। मिले । 'बरु मिली सीतहि सांवरो।' जा०म०ई० ७
मिल्यो : मिलेउ । 'कहा बिभीषन ले मिल्यो।' दो० १६५
मिष : सं०० (सं.)। बहाना, ब्याज । विन० २७.१
मिस : मिष (प्रा०) । 'कछु दिन जाइ रहौं मिस एहीं।' मा० १.६१.६
मिसकीनता : सं०स्त्री० (अरबी-मिसकीन =निकम्मा, निर्बल, कुख्यात, जर्जर, अकिंचन । अरबी-मसुकनत =अकिंचनता आदि)। दरिद्रता, निर्बलता, निष्क्रियता, कुख्याति । 'लाभ जोगछेम को गरीबी मिसकीनता ।' विन० २६२.३
मींजत : मीजत । विन० १३६.७
मींजि : मीजि । विन० ८३.५
मींजिबो : भक००कए० । मींजना, मसलना । 'हाथ मोंजिबो हाथ रह्यो ।' गी० २.८४.१
मींजो : भूकृ००कए० । मसला, रगड़ कर लगाया । 'मोजो गुरु पीठि (शाबाशी  दी) । विन० ७६.३'
मीच : मीचु । दो० ३४
मोचि : पूकृ० । मूद कर, मोलित करके । 'नयन मीचि रहे पौदि कन्हाई ।' कृ० १३
मीचु, मीचू : (१) सं०स्त्री० (सं० मत्यु>प्रा० मिच्चु, मिच्चू ) । मौत, मरण । मा० २.२५२.६, मा० १.६.६ (२) जन्मकुण्डल में आठवाँ-मृत्यु का स्थान । 'दारुन बैरी मीचु के बीच बिराजति नारि ।' दो० २६८
मीचुमई : वि० (सं० मृत्यमय>प्रा० मिच्चमइअ) । मृत्यु से परिव्याप्त । 'जल ____ थल मीचुमई है।' कवि० ७.१७६
मीजत : वकृ.पु । मसलता-ते । 'अधर दसन दसि मोजत हाथा ।' मा० ६.३१.६
मीजहिं, मीजही : आ०प्रब० । मसलते हैं । 'परम क्रोध मीजहिं सब हाथा ।' मा० ५.५५.५
मीजि : पू० । मीज कर, मसल कर । 'कोटिन्ह मीजि मिलव महि गर्दा ।' मा० ६.६७.३
मीजिहैं : आ०भ०प्र० । मसलेंगे, मलेंगे । 'मढ़ मीजि हैं हाथ ।' दो० १६५
_______________________________________________
877
मोठ, मोठा : वि.पु. (सं० मिष्ट, मृष्ट>प्रा० मिट्ठ) मीठा, मधुर (चिकना) । मन ____मलीन मुह मीठ नृप ।' मा० २.१७
मीठि, मीठो : वि० स्त्री० (सं० मिष्टा, मृष्टा>प्रा० मिट्ठी) । मधुर । मा० १.२६०.५
मीठे : वि००ब० (प्रा० मिट्ठ मिट्ठय)। मधुर, प्रिय । 'मुख मीठे मानस मलिन ।' दो० २६६
मीठो : मीठा+कए० (अ० मिट्ठउ) । मीठो अरु कठवति भरो। दो० १५
मीत : सं०० (सं० मित्र>प्रा. मित्त) । सुहृद्, सखा, स्वपक्षी। मा० १ ४
मीतु : मीत+कए० । अद्वितीय मित्र | ‘माधव सरिस मीतु हितकारी।' मा०. २.१०५.३
मीन : (१) सं०० (स्त्री.) (सं०)। मत्स्य । मा० १.२२ (२) नक्षत्र राशिविशेष । ___कोढ़ में की खाजु सी सनीचरी है मीन की ।' कवि० ७.१७७
मीनता : संस्त्री० (सं.)। मत्त्यभाव (जैसा प्रेम मछली जल से करती है और जलधारा के सम्मुख बहती है, उसी प्रकार का अनन्य तथा आराध्यमुखी प्रेम) । “सीतापति भक्ति सुरसरि नीर मीनता।' विन० २६२.५
मीनराउ : (दे० राउ) मीनराज, महामच्छ । विन० १८२.६
मीना : मीन । मा० १.२७.४
मीनु : मीन-+कए । अकेला मत्स्य । 'मीनु दीन जनु जल तें काढ़ें ।' मा० २.७०.३
मीला : मिला। संयुक्त । 'खेल गरुड़ जिमि अहिगन मीला ।' मा० ६.६६.१
मीसी : भूकृ० स्त्री०। (१) मिश्रित-शकर, मक्खन आदि में मिलाई हुई। (२) मीजी हुई, मसल कर छोटे टुकड़ों में की हुई । 'छोटी मोटी मीसी रोटी। कृ० २
मुंदरी : मुदरी । रा०प्र० ३.७.१
मुंह : (१) मुहँ । 'मुह भरि भरत न भूलि कही।' गी० ७.३७.१ (२) मुख से ! _ 'अपने मुह तुम्ह आपनि करनी' 'बरनी।' मा० १.२७४.६
मुँहभरि : ठीक से, पूर्णतः बोलकर । गी० ७.३७.१
मुँहाचाही : संस्त्री० । परस्पर (असमर्थता-सूचक) मुख देखने की क्रिया । आनाकानी, कंठहसी, महा चाही होन लागी।' गी० १.८४.८
मुंज : सं०पुं० (सं०) । मूज, सरकण्डा ।
मुंजाटवी : (मज+अटवी) मूज का वन । विन० ५५.६
मुंड : सं०पु० (सं०) । सिर, कपाल । मा० ६.४४
मुंडमय : वि० (सं.)। मुण्डों से परिव्याप्त । मा० २.१६२.२
मुंडमाल : कपाल-माला । कवि० ७.१४६
मुंडित : भूक०वि० (सं.)। मुड़ाए हुए, केश सफाचट कराये हुए । मा० ५.११.४
878
मुई : भूक०स्त्री० (सं० मृता>प्रा० मुई)। (१) मर गयी। 'नारि मृई गृह संपति नासी।' मा० ७.१००.६ (२) मरणतुल्य क्लेश में पड़ी। 'जननी कत भार मुई दसमास ।' कवि० ७.४० ।
मुएँ : मरने पर । 'मुएँ करइ का सुधा तड़ागा ।' मा० १.२६१.२
मुए : भूकृ०० ब० । मरे हुए। 'मुए मारि मंगल चहत ।' मा० २.३०१
मुएहि : मरे हुए को । 'मुएहि बधे नहिं कछु मनु साई।' मा० ६.३१.१
मुएहुं, मुएहु : मरने पर भी । 'मुएहं न मिटिहि ।' मा० २.३६.५
मुकता : सं०स्त्री (सं० मुक्ता)। मोती। मा० २.२६१.४
मुकतावलि : (सं० मुक्तावलि) मुक्तामाला। विन० ७.४.४
मुकतावहिंगे : आ०भ०पू०प्रब० । छड़ाएंगे, मक्त करेंगे। 'सब परे बंदि कब मुकतावहिंगे।' गी० ५.१०.४
मुकताहल : सं०० (सं० मुक्ताफल>प्रा० मुत्ताहल)। मोती। सीप में फले हुए मोतियों की लड़ी । 'मुकताहल गुन गन चुनइ ।' मा० २.१२८
मुकाम : संपु० (अरबी) । ठहराव, पड़ाव, डेरा। 'सोच न कूच मुकाम को।' विन० १५६.३
मुकुंद : सं०० (सं०) । विष्णु । मा० ६.१०३
मुकुंदा : मुकुंद । मा० १.१८६ छं० १ ।
मुकुट : सं०० (सं०) । (१) शिरोभूषण । मा० १.१०६ (२) श्रेष्ठ (भृकुट तुल्य) । 'भटमुकुटमानी ।' विन० २६.४
मुकुटमनि : (१) मुकुट में खचित मणि । 'एक छत्रु एकु मुकुटमनि ।' मा० १.२० (२) शिरोमणि, श्रेष्ठ । 'सुनहु महीपति-मुकुटमनि ।' मा० १.२६१
मुकुटांगदादि : (मुकुट, अंगद आदि) शिरोभूषण, बाहुभूषण आदि विविध अलंकरण । मा० ७.१२ छं० २
मुकटु : मुकुट+कए० । 'मुकुटु सम कीन्हा।' मा० २.२.६
मुकुत : वि० (सं० मुक्त)। (१) मायारहित, मोक्षप्राप्त, जन्म-मरण से मुक्त । 'भए मकुत हरि नाम प्रभाऊ ।' मा० १.२६.७ (२) विदेहमुक्त+जीवन्मुक्त । 'मुएँ मुकुत, जीवत म कुत, म कुत मुकृतहूं बीचु ।' दो० २२५ (३) मुकुता। मोती । 'केस मुकुत सखि मरकत मनिमय होत ।' बर ०६
मुकुता : मुकता ! मा० १.११.१
मुकुतादाम : (दे० दाम) मोतियों को लड़ी । गी० ७.१९.३
मुकुताफल : मुकताहल । जा०म० ५३
मुकुतामनि : मणितुल्य जगमगाते मोती । मा० १.११.६
मुकुतावली : मुकतावलि । गी० ७.६.२
_______________________________________________
879
मुकुताहल : मुकताहल ! 'बिथुरे नभ मकुताहल तारा ।' मा० ६.१२.३
मुकुताहलनि : मुकुताहल + संब० । मुक्ता फलों (के) । 'आलबाल मुकुताहलनि ।' दो० ३०१
मुकुति : मुक्ति । मा० १.१६.३
मुकुर : सं०० (सं.)। दर्पण । मा० १.१.४
मुकुरु : मुकर+कए० । एक दर्पण । 'मकुरु कर लीन्हा ।' मा० २.२.६
मुक्ख : मुख । 'परत दसकंध मुक्ख भर ।' कवि० १.११
मुक्त : वि० (सं०) । बन्धनरहित, जन्म-मरणरहित, मोक्षप्राप्त । मा० ३.३६
मुक्तकृत : वि० (सं० मुक्त कृत) । मुक्त करने वाला-वाले । विन० ५०.४
मुक्ता : मुकता (सं०) । मोती । गी० १.१०८.६
मुक्ति : सं०स्त्री० (सं.)। (१) छुटकारा, स्वतन्त्रता । (२) दार्शनिक दृष्टि से संसार से छुटकारा। इस मुक्तदशा के चार प्रकार हैं--(क) सायज्य= परमेश्वर और जीव की अभेद दशा। 'सो साजुज्य मुक्ति नर पाइहि ।' मा० ६.३.२ (ख) सारूप्य = ईश्वर के समान रूप की प्राप्ति जिसमें सर्वकर्तत्व को छोड़कर सभी कल्याणगुण जीव में आ जाते हैं। (ग) सालोक्य = ईश्वर लोक की प्राप्ति । (घ) साष्टि= ईश्वरवत् ऐश्वर्य की प्राप्ति । चारों ही परस्पर पूरक हैं-केवल पक्षभेद है। 'ऋषि सिद्धि कल्यान मुक्ति नर पावई हो ।' रा०न० २०
मुख : सं०० (सं.)। (१) वदन । 'मुख आव न बाता।' मा० १.७३.८ (२) मखाकार, चेहरा । 'निज मुख मुकुर बिलोकहु जाई ।' मा० १.१३५.६
मुखछबि : (१) मुख की शोभ । (२) मुख का बिम्ब । 'मुखछबि कहि न जाइ मोहि पाहीं ।' मा० १.२३३.६
मुखनि : मुख+संब० । मुखों (से)। 'निज निज मुखनि कही निज होनी ।' मा० १.३.३
मुखर : वि० (सं.)। (१) वाचाल, व्यर्थ अधिक बोलने वाला । 'मुख र मानप्रिय _ ग्यान गुमानी।' मा० २.१७२.६ (२) शब्दकारी। 'जनु खग मुखर ।' मा० १.१६५.७ (३) शब्द, रव ।
मुखरकारी : वि० । शब्द करने वाला। 'नपुर बर मधुर मुखरकारी ।' गी० १.२५.३
मुखहिं : मुखों से । 'मुखहिं निसान बजावहिं भेरी ।' मा० ६.३६.१
मुखागर : वि०+सं०० (सं० मुखागर)। जबानी, पत्रादि के बिना केवल मुख से कहा हुआ सन्देश । मा० ५.५२
मुखारबिंद : (१) कमल (अरविन्द) सदृश विकासयुक्त मुख । गी० १.३८.५ (२) मुखरूपी कमल । 'पियत राम मुखारबिंद मरंद।' गी० ७.२३.३
880
_______________________________________________
मुखिमा : सं+वि०० (सं० मुख्य)। (१) मुख = अग्रभाग में रहने वाला; मुख के समान सर्वोपार; गणमख्य, नायक, अग्रणी। राजा । 'मुखि आ मुख सो चाहिऐ।' मा० २.३१५ (२) यथप । 'महा महा मुख आ जे पावहिं ।' मा० ६.४५.१
मुखी : (समासान्त में) वि०स्त्री० (सं.)। मुख वाली। 'निसिनाथ मुखी।' कवि० २.१५
मुख : मुख+कए । मा० २.१०४.२
मुख्ख : मुक्ख ।
मुख्य : वि० (सं.) दे० मुखिआ। प्रमुख, श्रेष्ठ। मा० १.६२
मुग्ध : मूढ़ (सं०) । 'मुग्ध मधु मथन ।' विन० ५६.६
मुचत : वकृ०० (सं० मुच्यमान>प्रा. मुच्चंत)। छटते, बरसते । 'अति मुचत समकन मुख नि ।' गी० ७.१८.५
मुठभेरी : सं०स्त्री० । मुष्टिकाओं का संघर्ष, मष्टिप्रहार | 'चुकइ न घात मार मुठभेरी ।' मा० २.१३३.४
मुठि : मूठि। टोना टोटका । डिठि मुठि निठर नसाइहौं।' गी० १.२१.२
मुठिकन्ह : मठिका+संब० । मुक्कों (से) । मा० ६.५३.५
मुठिकाँ : मुष्टिका से । 'सो हनुमान हन्यो मुठिकां ।' कवि० ६.३८
मुठिका : सं०स्त्री० (सं० मुष्टिका) । मुक्का, मुट्ठी। 'मुठिका मारि महा धुनि गर्जा ।' मा० ४.८.२
मुड़ाइ : पूकृ० (सं० मुण्डापयित्वा>प्रा० मडाविअ>अ० मुडावि) । मुडा कर, केशरहित करवा कर । 'मूड़ मुड़ाइ होहिं संन्यासी।' मा० ७.१००.६
मुड़ायो : भूक००कए० । के शरहित करवाया। 'म ड़ मुड़ायो बादिही ।' दो० ६३
मुद : संस्त्री० (सं० मुद्) । हर्ष, प्रमोद । मा० १.२.७
मुदभग : मोद के मार्ग, आमोद के उपाय । 'जग मुद मग नहिं थोरे।' विन० १६४.३
मुदमय : (दे० मय) हर्षोल्लासपूर्ण । विन० १६१.३
मुदरी : संस्त्री० (सं० मुद्रिका>प्रा० मुद्दिआ>अ० मुद्दड़ी)। अंगूठी । 'मनि मुदरी मन मुदित उतारी।' मा० २.१०२.३
मुदा : (सं०) । प्रसन्नता से । 'देहु कृपालु कपिन्ह कहुं मुदा !' मा० ६.११६.६
मुदित : भक०वि० (सं.) । प्रसन्न । मा० २.१०२.३ ।।
मुदिता : मुदिता से । 'मुदिता मथै बिचार मथानी ।' मा० ७.११७.१५
मुदिता : सं० स्त्री० (सं.)। पुण्यात्माओं के प्रति हर्ष की अनभूति (जो योग में एक सम्पत्ति मानी गयी है) । मा० ३.४६.४
मुदितायन : मुदिता नामक सात्त्विक हर्ष से सम्पन्न । मा० ७.३८.५
_______________________________________________
881
मुद्गर : सं०० (सं०) । गदा के आकार का आयुधविशेष जो मूठ में पतला और उत्तरोत्तर मोटा होता है । मा० ६.४०.८
मुद्रिक : मुद्रिका । विन० ६३.५
मुद्रिका : मुदरी । मा० ५.१२
मुधा : अव्यय (सं.) । मिथ्या । 'होइ न मुधा देवरिषि भाषा ।' मा० २.२८५.८
मुनि : सं० (सं.)। मननशील महात्मा-अगस्त्य, ब्यास आदि । मा० १.४५
मुनिंद, मुनिंदा : (सं० मुनीन्द्र>प्रा० मुणिद)। श्रेष्ठ मुनि । मा० १.६४.१
मुनिंदु : मुनिंद+कए । एक मुनि (वाल्मीकि) । कवि० ७.१३८
मुनिकुल : मुनि-समूह । मा० १.२१६.१
मुनिगन : मुनि-समूह । मा० २.४१
मुनिचीर, मुनिचीरा : मुनियों का परिधान-बल्कल वस्त्र । मा० ३.११.३
मुनिजन : मुनिगन । मा० २.३०२
मुनितिय : मुनि पत्नी । मा० १.३५७.३
मुनितियन्ह : मुनितिय+संब० । मनि पत्नियों । मा० २.२४६.२
मुनिन : मुनिन्ह ।
मुनिनाथ, नायक : मुनि-मुख्य । मा० २.१७१, ३.१
मुनिन्ह : मुनि+संब० । मुनियों । 'भंजी सकल मुनिन्ह के त्रासा।' मा० ७.६६.२
मुनिपट : मुनिचीर । मा० १.१४३.८
मुनिपतिनी : (सं० मुनि-पत्नी) अहल्या (आदि) । मा० ७.१३ छं. ४
मुनिबधू : मुनि-पत्नी । मा० १.२२१
मुनिबनिता : मुनि-पत्नी । मा० १.३२४ छं० २
मुनिबर : श्रेष्ठ मुनि । मा० १.१८.५
मुनिबरन्ह : मुनिबर+संब० । मुनिवरों (ने) । 'समउ जानि मुनिबरन्ह बोलाई ।' __मा० १.३२४.३
मुनिबरु : मुनिबर+कए । 'बोले मुनिबरु ।' मा० २.२५४.१
मुनिबर्य : (सं० मुनिवर्य) । मनिबर । मा० १.४३ ख
मुनिबसन : मुनिचीर । मा० १.२६८.८
मुनिबाल : मुनियों के बालक । गी० ३.६.३
मुनिराई : मुनिराय । मा० १.३२३.७
मुनिराउ, मुनिराऊ : मुनिराय+कए । मा० २.२४३; २६१.५
मनिराज, मनिराजा : (सं० मुनिराज श्रेष्ठ मनि । वसिष्ठ (आदि) । मा० २.५
मुनिराय, मुनिराया : मुनिराज (प्रा० मुणिराय) । मा० २.१२६.१; १.४६.५
मुनिहि : मुनि को । 'मुनिहि हरिअरइ सूझ ।' मा० १.२७५
882
_______________________________________________
मुनिहु : मुनि के भी । 'मुनिहु कहें जलु काहु न लीन्हा ।' मा० २.२४०.८
मुनी : मुनि । कवि० ७.७२
मुनींद्र : मुनिंद । मा० ३.४ छं०
मुनीस, मुनीसा : मुनींद्र (सं० मुनीश) । मा० १.४५.३; १८.६
मुनीसन्ह : मुनीस+संब० । बड़े मुनियों (ने) । भांति अनेक मुनीसन्ह गाए।' मा० १.३३.७
मुनीसु : मुनीस+कए । 'देत असीस मुनीसु ।' मा० १.३५२
मुनीस्वर : मुनीस (सं० मुनीश्वर) । मा० ७.११०.१०
मुरछा : मुरुछा । मा० ६.७५.१
मुरछित : मुरुछित । गी० २.५.३
मुरति : मूरति । गी० १.५.३
मुरलि : सं०स्त्री० (सं० मुरली) । वंशी, सुषिर वाद्य विशेष =बाँसुरी । कृ० ३३
मुरा : भूकृ.पु. (सं० मुटित>प्रा० मुडिअ) । मुड़ा, पिछड़ा (शङिकत हुआ) । ___गयउ सभी मन नेकु न मुरा ।' मा० ६.१६.७
मुरारी : सं०० (सं० मुरारि)। मुर दैत्य के विनाशक =विष्णु (कृष्ण) । क० २२
मुरारे : मुरारि+संबोधन (सं.) । हे मुरारि । विन० ११०.४
मुरि : पू० (सं० मुटित्वा>प्रा० मुडिअ>अ० मुडि) । मुड़ कर, पीछे घूमकर । 'मुरि चले निसिचर बीर ।' मा० ३.२०.३ ।
मुरुखाई : सं०स्त्री० (सं० मूर्खता>प्रा० मुरुक्खया)। नासमझी, अविवेक । पा०म० छं०६
मुरुछा : सं०स्त्री० (सं० मूर्जा) । संज्ञा शून्यता, बेहोशी । मा० २.४३
मुरुछि : पू० । मूछित होकर । 'मुरुछि परा महि राऊ ।' मा० २.८२.८
मुरुछित : भूकृ०वि० (सं० मूछित) । संज्ञा शून्य, बेहोश । मा० २.७६.७
मुरे : भूकृ००० । मुड़े, पीछे घूम चले। 'मुरे सुभट सब फिरहिं न फेरे । मा० ६.६७.६
मुर् यो : भूकृपु०कए । मुड़ा, पीछे घूमा, पिछड़ा। 'मुर्यो न मनु ।' मा० ६.६५.६
मुष्टि : सं०स्त्री० (सं०) । मुक्का, बद्धाङ्ग लिहस्त । मा० ४.८.३
मुसलधार : क्रि०वि० (सं०) । मूसलाधार, मुसलतुल्य मोटी धाराओं से। 'बरर्षे मुसलधार बार-बार घोरि के।' कवि० ५.१६
मुसुका, मुसुकाइ : आ.प्रए । अप्रकट-दन्तपंक्तिपूर्वक ह्रास करता है, स्मित करता है, मुसकुराता है । मन मुसुकाइ भानुकुल भानू ।' मा० २.४१.५
_______________________________________________
883
मुसुकाइ : पू० । मुसकुरा कर; स्मित करके । 'कह कृपाल मुसुकाइ।' मा० ५.५६
मसुकाई : (१) मसुकाइ। स्मित करता है। 'अवलोकि मातु मुख प्रभु मन में मुसुकाई ।' गी० १.१६.५ (२) मुसुकाइ । स्मित करके। 'कृपासिंधु बोले मुपुकाई ।' मा० २.१०१.१ (३) भक०स्त्री० । स्मितपूर्वक हंसी, मुसकुरायी। कृ०८
मुसुकात, मुसुकाता : वक०० । मसकुराते हुए, स्मित करते हुए । 'चोरत चितहि सहज मुसुकात ।' गी० २.१५.२ 'भगिनीं मिली बहुत मुसुकाता।' मा० १.६३.२
मुसुकान, मुसुकाना : भूक०पू० । स्मितपूर्वक ओष्ठ विकास किया, मुसुकुराया । मा० ६ १३.८, ६.८६.७
मुसुकानि, मुसुकानो : (१) भूकृ.स्त्री० । हँसी, मुसकुरायी। 'भरत मातु मुसुकानि ।' मा० २.१४ 'उमा मुसुकानी।' मा० १.१४१.७ (२) सं०स्त्री० । मुस्कुराहट, स्मित-क्रिया । 'प्रभु हँसि दीन्ह मधुर मुसुकानी ।' मा० १.२०१.८
मसुकाने : भूक.पुं०ब० । मुसकुराए । 'मुनि मुसुकानं ।' मा० ३.१३
मुसुकाहिं, मुसुकाही : आ०प्रब० । स्मित करते हैं, मुसकुराते हैं। 'जननि जनक मुसुकाहिं ।' मा० १.६५, ६१.६
मुहँ : (१) मुह में । 'मुहं परेउ न कीरा ।' मा० २.१६२.२ (२) मुह पर । 'लागि मुह लाटी ।' मा० २.१४५.४ (३) मुह से।
मुह : मुख (प्रा०) । मा० २.१७
मुहु : मुह+कए । अकेला (अपना) मुख । 'बैछु मुहु गोई ।' मा० २.३६.६
मूँड़ : मुंड । सिर । कवि० ६.५०
मूँदरी : मुंदरी । गी० ५.३.१
मूँदे : भूदे । 'मूदे कान जातुधान मानों गाजे गाज के।' कवि० ६.६
मूक : सं० (सं०) । गगा, वाक्शक्ति हीन । मा० २.५४
मूकनि : मूक+संब० । गूगों (को)। 'मनि बचन लाहु ।' गी० १.६०.५
मूकिये : आकवा०प्रए० (सं० मुक्त+नाम धातु>प्रा. मुक्कीअइ) । छोडिए । 'परेहू चूक मूकिये न ।' हनु० ३४
मूकी : भूक०स्त्री. (सं० मुक्ता>प्रा० मुक्की)। छोड़ी। 'मन मानि गलानि कुबानि न मूकी।' कवि० ७.८८
मूठि : सं०स्त्री० (सं० मुष्टि>प्रा० मुट्ठि) । तलवार आदि का पकड़ा जाने वाला भाग । मा० २.३१.२ (२) एक प्रकार का मारण प्रयोग जो इसी नाम से जाना जाता है । (३) मुष्टि प्रहार । 'काहूं देवतनि मिलि मोटी मूठ मार दी।' कवि० ७.१०३
884

मूठी : मूठि । बन्द हाथ की मात्रा (नाप) । 'तिन आखिन में धूरि भरि भरि मूठी मेलिये ।' दो० ४५
मूड़ : मूंड़ । 'मूड़ मुड़ाइ होहिं संन्यासी।' मा० ७.१००.६
मूंड मारि : सिर पीट कर =अतिशय प्रयास करके । विन० २७६.५
मूढ़ : वि० (सं.)। मोहग्रस्त, तमोलीन, मुर्ख । मा० १.२८.६; १.२५०
मूढ़ता : संस्त्री० (सं०) । मढ़ दशा, अज्ञता, मूर्खता । मा० ६.५६.७
मूढ़मति : वि० (सं.)। मोहग्रस्त बुद्धि वाला, तमोगुणी बुद्धि वाला, अज्ञानी । विन० २१४.५
मूढ़ा : मूढ़ । मा० १.४७.४
मूत्र : सं०० (सं.)। विन० १३६.३
मूदहिं : आप्रब० (सं० मुद्रयन्ति>प्रा० मुदंति>अ० मुद्दहि) । बंद करते हैं, ढक लेते हैं । 'ते मूदहिं काना।' मा० १.२६३.८
मूदहु : आ० मब० । (१) ढक लो । 'मूदहु नयन ।' मा० ४.२५.५ (२) ढकते-ती हो । 'का घूघट मुख मूदहु ।' बर० १७
मूदि : पू० । ढक कर । 'नयन मूदि पुनि देखहिं बीरा ।' मा० ४.२५.६
मूदें : ढक लेने पर । 'मूदें आँखि कतहुं कोउ नाहीं।' मा० १.२८०.८
मूदे : भूक००ब० । ढके । 'मूदे सजल नयन पुलके तन ।' मा० २.२८८.२
मूदेउँ : आ०-भूक००+उए० । मैंने ढक लिये। 'मदेउ नयन त्रसित जब भयऊँ।' मा० ७.८०.१
मूर : सं०० (सं० मूल)। पूजी, मूलधन । 'फिरेउ बनिक जिमि मूर गाई ।' मा० २६६.८
मूरख : मूरुख । मा० ३.१
मूरति : (१) संस्त्री० (सं० मूर्ति) । विग्रह, शरीर, आयामबद्ध आकार । 'सुकृत सुमंगल मूरति मानी।' मा० १.१६.६ (२) बिम्ब, प्रतिबिम्बित आकृति । 'संकर सोइ मूरति उर राखी ।' मा० १.७७.७ (३) प्रतिमा । 'खसी माल मरति मुसुकानी ।' मा० १.२३६.५ (४) रूपाकार । 'मूरति मधुर मनोहर देखी ।' मा० १.२१५.८
मूरतिमंत : वि. (सं० मूर्तिमत्)। मूर्त, साकार । 'मूरतिमंत तपस्या।' मा० १.७८.१
मूरि, मूरी : सं०स्त्री० (सं० मूल) । (१) जड़। 'मोर-सिखा बिनु मूरिहूँ पलुहत गरजत मेह ।' दो० ३१६ (२) जड़ी-बूटी । 'जिअ मूरि जिमि जोगवत रहऊँ ।' मा० २.५६.६
मूरिमय : (दे० मय) बूटी से निर्मित । 'अमिअ-मूरिमय चूरन चारू ।' मा० १.१.२.
_______________________________________________
885
मूरी : मूरि । 'संसति रोग सजीवनि मूरी।' मा० ७.१२६.२
मूरुख : वि० (सं० मूर्ख>प्रा० मूरुक्ख)। मूढ़, विवेक हीन, दुर्बुद्धि । मा० ६.१६ ख
मूल : सं०० (सं०) । (१) जड़ । 'कंद मूल फल ।' मा० २.१३५.२ (२) मुख्य कारण । 'कलि केवल मलमूल मलीना ।' मा० १.२७.४ (३) नक्षत्र विशेष । गी० १.१६.३
मूलक : सं०० (सं०) । मूली, कन्दविशेष । 'सकौं मेरु मूलक इव तोरी।' मा० १.२५३.५
मूलभूत : कारणस्वरूप । विन० ४६.५
मूलमिदमेव : (सं० - मूलम् + इदम् +एवं इदमेव मूलम्) यही मूल है। विन. ४६.७
मूला : मूल । मा० १.३.८
मूलिका : (१) सं० स्त्री० (सं०) । जड़ी । गी० १.६.३ (२) संजीवनी बूटी । 'जिये कुवँर निसि मिल मूलिका ।' गी० ६.६.३
मूलु : मूल+कए । एकमात्र मूल, मुख्य जड़ । 'मानहुं कमल मूल परिहरेऊ ।' मा० २.३८.७
मूषक : (१) सं०० (सं०) । चूहा, मूसा । मा० ७.१२१.१८ (२) चोर ।
मूसर : सं०० (सं० मुसल, मूसल) । 'कलपद्रुमु काटत मूसर को । कवि० ७.१०३
मृग : सं०० (सं०) । (१) खुरों वाला वन्य जीव (बराह आदि) । 'प्रगटत दुरत जाइ मृग भागा।' मा० १.१५७.४ (२) हरिण । 'होहु कपट मृग तुम्ह छलकारी।' मा० ३.२५.२ (३) चन्द्रमा का कलङक । 'देह सुधागेह ताहि मगहूं मलीन कियो ।' कवि० २.४ (४) मृगशिरा नक्षत्र । दो० ४५६
मृगछाल, मृगछाला : मृग चर्म । 'लखन ललित कर लिये मगछाल ।' गी० ३.६.१; मा० ६.११.४
मृगजलु : सं०० (सं.)। चमचमाती धूप में जलतरङ्ग की भ्रान्ति जो मृग को हो जाती है (ऐसी अनुश्रुति है); मृगमरीचिका, मृगतृष्णा । मिथ्या आशा, असत् वासना । मा० ७.१२२.५ 'मति मटुकी मृगजल भरि घृत हित मन ही मन . महिबे ही ।' क० ४०
मृगजल : मृगजल+कए । मृगतृष्णा, व्यर्थ आशा-वासना । 'मृगजलु निरखि मरहु  कत धाई ।' मा० १.२४६.५
मृगजूथ : (दे० जूथ) मृगसमूह । मा० ७.३०.६
मृगनयनी : वि०स्त्री० (सं.)। मृग के समान चकित-मुग्ध नेत्रों वाली। मा० मा० ७.११५ ख
886
_______________________________________________
मृगनायक : वन जीवों का राजा=सिंह । मा० ६.६६.२
मृगनि : मृगन्ह । मृगों (को)। 'तुलसी मुनि खग मृगनि सराहत ।' गी० ३.१.३
मृगनैनि, मृगनैनी : मृगनयनी । मा० ३.३०.६
मृगन्ह : मृग+संब० । मगों (वन जन्तुओं) । 'बिबिध मगन्ह कर आमिष राधा । मा० १.१७३.३
मृगपति : मगनायक । मा० ६.११ ख
मृगबारि : मृगजल । विन० ७३.२
मुगभ्रमबारि : मृगबारि । विन० १३६.२
मृगमद : सं०० (सं०) । कस्तूरी । मा० १.१६४.८
मृगमाला : मृग-श्रेणी, हरिणसमूह । मा० १.३०३.६
मृगया : सं०स्त्री० (सं०) । आखेट, शिकार । मा० ३.१६.६
मृगराउ, मृगराऊ : मगराजु (अ०)। सिंह । 'कलुष पुज कुंजर मगराऊ ।' मा २.१०६.१
मृगराज : मृगनायक । मा० १.१२५
मृगराजु, मृगराजू : मृगराज+कए० । अकेला सिंह। जिमि करि निकर दलइ मृगराजू ।" मा० २.२३०.६
मृगरूपा : (सं० मृगरूप) मृगरूपधारी (चन्द्रमा के भीतर बसने वाले मृग के समान)। 'कीरति बिधु तुम्ह कीन्ह अनूपा । जहँ बस राम-प्रेम मृगरूपा ।' मा० २.२१०.१
मृगलोचनि, मृगलोचनी : मृगनयनी । मा० २.६३.४
मृगव्रात : मृगसमूह । विन० ५६.५
मृगसावकानयनी : मगशावक (हरिणशिशु) के समान भोले सुन्दर नेत्रों वाली। मा० २.८.७
मृगा : मृग । कवि ० ३.१
मृगांक : (१) सं०० (सं.)। एक प्रकार का रसायन = चन्द्रोदय रस जो क्षय रोग की उत्तम औषध है। उसे रत्नों और सुवर्ण की भस्म से बनाया जाता है । कवि० ५.२५ (२) चन्द्र मा।
मृगिन्ह : मृगी+संब० । मृगियों (को)। 'मगिन्ह चितव जन बाधिनि भूखी।' मा० २.५१.१
मुगीं : मृगी+ब० । हरिणियाँ । 'मगीं कहहिं तुम्ह कहुं भय नाहीं।' मा० ३.३७.५
मृगी : सं०स्त्री० (सं०) । हरिणी । मा० ३.२६.२४
मृगु : मृग+कए । कोई हरिण । 'मन हुं भाग मृगे भाग बस ।' मा० २.७५
मृतक : सं.पु. (सं०) । मरा हुआ, शव । मा० १.३०८.४ ।
मृतककर्म : प्रेतकर्म; दाह-संस्कार आदि और्वदेहिक कृत्य । मा० ४.११.८.
_______________________________________________
887
मृत्यु : मीचु । मा० ३.२.६
मृदंग : सं०० (सं०)। वाद्यविशेष । मा० १.३०२
मृदु : वि० (सं०) । कोमल, सुकुमार । मा० १.२.१
मृदुगात : (दे० गात) कोमलाङ्ग, सुकुमार । मा० १.२२३.२
मृदुचित : कोमल चित्त वाला, सहृदय, दयालु । मा० ६.४५.४
मृदुता : सं०स्त्री० (सं०) । कोमलता । 'बिटप फूलि फलि तृन मृदुताहीं (मृदुता से ही) ।' मा० २.२११.७
मृदल : मृदु (सं०) । मा० १.१६०
मृदुलाई : मृदुता (सं० मृदुलता) । 'मो पर कृपा परम मृदुलाई ।' मा० ७.१२४.३
मृनाल : सं०० (सं० मृगाल) । कमलनाल । मा० १.२५५.८
मृषा : अव्यव (सं.)। मिथ्या, मुधा । “संभु गिरा पुनि मृष्टा न होई ।' मा० १.५१.३
में : परसर्ग- अधिक रणसूचक (सं० स्मिन् >प्रा० म्मि)। 'न मूहू में बारु है।' कवि० ७ ६७
मेंढक : मेड़ क । विन० ३२.२
मे : (१) (सं०) मम । मेरे लिए, मुझे । 'प्रसीद में नमामि ते ।' मा० ३.४.२२ (२) मेरा-मेरी-मेरे । 'न अन्यथा वचांसि मे ।' मा० ७.१२२ ग
मेकल : सं०० (सं.)। पर्वतविशेष (जिससे नर्मदा निकली है) । मा० १.३१.१३
मेकलसुता : रेवा, नर्मदा नदी । मा० २.१३८.४
मेखल : मेखला । विन० ६३.३
मेखला : (१) संस्त्री० (सं.)। करधनी, कटिभूषण । विन० ६१.६ (२) घेरा । _ 'भूमि सप्त सागर मेखला।' मा० ७.२२.१ (मूल अर्थ कटिभूषण का यहाँ भी
मेखु : मेषु । मेष राशि (जिसका पूर्ण चन्द्र आश्विन पूर्णिमा को होता है) । 'ससि सुपूरन मेखु ।' गी० ७.६.२
मेघ : सं०पू० (सं०) । बादल । मा० २.१.२
मेघ-डंबर : मेघ-घटाओं का घेरा । मा० ६.१३.५
मेघनाद : सं०पू० (सं०) । रावण पुत्र-इन्द्रजित् (जन्म समय में मेघवत् नाद करने से नाम पड़ा ।' मा० १.१८२.१
मेघनाद : मेघनाद+कए० । अकेला मेघनाथ । कवि० ५.१२
मेघमाल : मेघों की श्रेणी, मेघसमूह । कवि० ५.२
मेघहि : मेघ में । 'गगनु मगन मकु मेघहिं मिलई ।' मा० २.२३२.१
मेचक : वि० (सं०) । काला, नीला, नील-कृष्ण । 'मेचक कुंचित केस ।' मा० १.२१६
888
_______________________________________________
मेचकताई : संस्त्री० (सं० मेचकता)। लालिमा या नीलिमा । मा० ६.१२.४
मेट, मेटइ : आ०प्रए० (सं० म्लेटति>प्रा० मेट्टइ-म्लेट उन्मादे)। मिटाता है, मिटाये, मिटा सके। 'राम रजाइ मेट मन माहीं। देखा सुना कतहुं कोउ नाहीं ।' मा० २.२६८.७
मेटत : वकृ०० । मिटाता-ते । 'मेटत कठिन कुअंक भाल के।' मा० १.३२
मेटति : वकृ०स्त्री० । मिटाती । 'छांह जेहि कर की मेटति पाप ।' विन० १३८.५
मेटनिहार : वि.पु । मिटाने वाला । मा० १.६८
मेटब : भकृ०० । मिटाना (होगा, चाहिए)। 'बेगि प्रजा दुख मेटब आई।' मा० २.६८.६
मेटहि : मा०मए० । तू मिटा दे। 'अमिय बचन सुनाइ मेटहि बिरह ज्वाला जालु ।' गी० ५.३.१
मेटहु : आ०मब० । मिटाओ, दूर करो। 'मेटहु तात जनक परितापा।' मा० १.२५४.६
मेटा : भूक पुं० । मिटाया । मा० २.२१७.२
मेटाई : प्रकृ० । मिटा कर । 'चले धरम मरजाद मेटाई।' मा० २.२८८
मेटि : पू० । मिटा कर । 'बिदा कीन्ह 'सोच सब मेटि ।' मा० २.३१
मेटे : भूकृ००ब० । मिटाये। मा० ७.६.१
मेट् यो : भूक००कए । मिटाया। 'मैं-तें मेट्यो मोह तम ।' वैरा० ३३
मेड़ुक : सं०० (सं० मण्डूक) । मेढक ।
मेड़ुकन्हि : मेड़ क+संब० । मेढकों (को) । 'जौं मृगपति बध मेड़ कन्हि ।' मा० ६.२३ ग
मेढ़ी : सं० स्त्री० (सं० मेढी--स्तम्भ>प्रा० मेढी) । (१) करधनी में दण्डाकार आभूषण विशेष । (२) बालों की दण्डाकार चोटी । 'मेढ़ी लटकन मनि कनक रचित ।' गी० १.११.२
मेढ़ुक : मेड़ क । दो० ३९८
मेदिनि : सं०स्त्री० (सं० मेदिनी) । (मधुकैटभ की मेदा-चर्बी से बनी हुई) पृथ्वी । मा० २.१६२.२
मेधा : सं०स्त्री० (सं.)। स्मरण शक्ति; धारणावती बुद्धि (जो एक विषय पर एकाग्र होती है) । मा० १.३६.८
मेरवनि : सं० स्त्री० (सं० मेलना>प्रा. मेलवणा)। मिलाना, संगत करना (बांधना) । 'कटि निषंग परिकर मेरवनि ।' गी० ३.५.२
मेरिओ : मेरी भी । 'मेरिऔ टेव कुटेव महा है।' कवि० ७.१०१
मेरियै : मेरी ही । 'कलिहं जो सीखि लई मेरिट मलीनता।' कवि० ७.६२
मेरियौ : मेरिओ। विन० २७१.२
_______________________________________________
889
मेरी : वि० सर्वनाम-स्त्री० । 'मेरी बार' 'ढील की। कवि० ७.१८
मेरु, मेरू : सं०पू० (सं.)। (पुराण प्रसिद्ध) सुमेरु पर्वत (जो सोने का कहा जाता है) । मा० २.७२.३ ।।
मेरू : मेरु । 'सकइ उठाइ सरासुर मेरू।' मा० १.२६२.७
मेरें: (१) मेरे अधीन, मेरे पास । 'जस कछु बुधि बिबेक बल मेरें।' मा० १.३१.३ (२) मेरे से । 'मेरे ही अभागनाथ ढील की।' कवि० ७.१८
मेरे : सार्वनामिक विशेषण पु. । मा० १.१४.३
मेरो : मैरा+कए । मा० ७.४४.७
मेरोइ, मेरोई : मेरा ही । 'मेरोइ फोरिबे जोगु कपारु ।' कवि० ७.१५७
मेलत : वकृ०० (सं० मुञ्चत् =प्रा० मेल्लंत) । डालता-ते । 'मेलत पावक हाथ ।' दो० १४७
मेलहिं, मेलहीं : मा०प्रब० (प्रा० मेल्लति>अ० मेल्लाहि =सं० मुजन्ति) डालते हैं। 'गल अंतावरि मेलहीं।' मा० ६.८१ छं०
मेला : भूकृ००। डाला, छोड़ा। 'सो उचाटु सब के सिर मेला ।' मा० २.३०२.३
मेलि : पूर्व० । (१) डालकर (पहनकर)। 'मेलि जनेऊ लेहिं कुदाना ।' मा० ७.६६.२ (२) ऊपर फेंक कर । 'नाउनि मन हरषाइ सुगंधन मेलि हो।' रा०न० १८ (३) आ०-प्रार्थना-मए । तू डाल ले। 'के खरिया मोहि मेलि ।' दो० २५५
मेलिए, मेलिये : आ०कवा०प्रए० । डालिए, छोड़िए । 'तिन आखिन में धूरि 'मेलिये।' दो० ४५
मेलिहि : आ.भ.प्रए । डालेगा-गी। 'मेलिहि सीय राम उर माला ।' मा० १.२४५.३
मेली : भूक स्त्री० । डाली। 'सुता बोलि मेली मुनि चरना।' मा० १.६६.८
मेले : भूक०० ब० । डाले । 'पुनि चरननि मेले सुत चारी ।' मा० १.२०७.५
मेलेउ : भूक ००कए० । डाला । 'कुरि हरषि मेलेउ जयमाला ।' मा० १.१३५.३
मेलैं : मेलहिं । मिलाते हैं। 'मेले गरे छुराधार सों।' कवि० ५.११
मेलै : आ०प्रए । डाले । 'तब मेलै जयमाल ।' मा० १.१३१
मेषा : सं०० (फा० मेवः) । फल । मा० १.३३३.४
मेष : सं०० (सं.)। (१) भेड़ा । 'वकु बिलोकि जिमि मेष बरूथा।' मा. ६.७०.१ (२) मेष राशि (एक नक्षत्र समूह) ।
मेषादिक : मेष इत्यादि १२ नक्षत्र राशियाँ-मेष, वृष, मिथुन, कर्क, सिंह, कन्या; तुला, वृश्चिक, धनु, मकर, कुम्भ और मीन । दो० ४५६
मेषु : मेष+कए । मेष राशि ।
890
_______________________________________________
मेह : मेघ (प्रा.) । दो० २६४
मैं : सर्वनाम-उत्तम पुरुष-कर्ताकारक (सं० मया>प्रा० मइ>अ० मई)। (१) मैंने । 'मैं अपनी दिसि कीन्ह निहोरा ।' मा० १.५.१ (२) मुझ से, मेरे द्वारा । 'सो सब हेतु कहब मैं गाई।' मा० १.३३.२ (३) मैं-हौं (सं० अहम् >प्रा० मं) । 'तो मैं जाउँ कृपायतन ।' मा० १.६१ (४) अहन्ता, अहंकार । 'मैं अरु मोर तोर ते माया ।' मा० ३.१५.२
मैं - तैं : अहन्ता का वह रूप जिसमें मनुष्य अपने को केन्द्र बना कर शेष को पृथक मानता है-यही द्वैत है। मा० ३.१५.२ "मैं-तै मेट्यो मोहत ऊगो आतम भानु ।' वरा० ३३
मैंमोर : मायाकृत अहंता और ममता-अपने को भोक्ता मानकर विषयों के प्रति भोग्य भावना लेकर अपनापन । मा० ३.१५.२ 'तुलसिदास मैंमोर गये बिन जिउ सुख सांति न पावै ।' विन० १२०.५
मैं : मय । व्याप्त, पूर्ण । 'मनो रासि महातम तारक में ।' कवि० २.१३
मैआ : सं० स्त्री. (सं० मातका>प्रा० माइआ माइया) । माता । मा० २.५३
मैथिलो : संस्त्री० (सं०) । मिथिला नरेश की पुत्री सीता । मा० ६.१०६.१
मैथुन : सं०स्त्री० (सं०) । मिथुनभाव+मिथुनकर्म । स्त्री पुरुष के मिलन का सुख । विन० २०१.४
मैन : मयन । (१) कामदेव । मा० १.१२६ (२) मोम, मधुमल । 'तुलसी ताहि कठोर मन सुनत मैन होइ जाइ।' वैरा० १६ 'मैन के दसन कुलिस के मोदक कहत सुन बौराई।' कृ० ५१ (३) काम+मोम | विथकी है ग्वालि मैन मन मोए ।' कृ० ११
मैनहिं : (१) मेना को । 'सोचु भयउ मन मनहिं ।' पा०म० १०८ (२) मैना से । __'अरुंधती मिलि मैनहिं बात चलाइहि ।' पा०म० ७६
मैना : मेना ने । 'मैना सुभ आरती सारी।' मा० १.९६.२
मैनहिं : सं०स्त्री० (सं० मेना)। हिमाचल-पत्नी-पार्वती की माता । मा०
मैनाक : सं०० (सं०) । हिमाचल-पुत्र पर्वतविशेष जो सागर में स्थित बताया गया है। मा० ५.१.६
मैनु : मैन+कए । कामदेव । 'मनोहरता जिति मैनु लियो है।' कवि० २.१६
मैया : मैआ । 'याहि कहा मैया मुह लावति ।' कृ० १२
मैला : वि.पु.० (सं० मलिन>प्रा० मइल्ल ) । कलुष, क्षुब्ध । 'पठए बालि होहिं मन मला ।' मा० ४.१.५
मैले : वि०पु० ब० । कलुष, क्षोभयुक्त, कुंभलाये हुए । 'अबुध असैले मन मैले महिपाल भये ।' गी० १.७३.५
_______________________________________________
891
मैलो : मैला+कए० । कलुष, खिन्न । 'तुम जनि मन मैलो करो।' विन० २७२.१
मो : (१) सर्वनाम । मुझ । 'मोतें' (मझ से)। मा० ३.३६.३ 'मो सो (मझ सा) । मा० १.२८.४ आदि (२) परसर्ग। में। 'रुचिर रूप जल मो रसेस व मिलि न फिरन की बात चलाई।' क० २५
मोई : भूकृस्त्री० (सं० मोदिता-मुद स्नेहने) । चिकनाई हुई, भावित की हुई, सिक्त । कछुक देव मायाँ मति मोई ।' मा० २.८५.६
मोए : भूकृ.पुब० । (सं० मोदित-मुद स्नेहने>प्रा० मोइय)। मोवन लगाये हए, चिकनाये हुए, सिक्त-आर्द्र किये हुए । 'बिथकी है ग्वालि मैन मन मोए ।' कृ० ११
मोको : मझको । 'तुम्हही बलि ही मोको ठाहरु हेरें।' कवि० ७.६२
मोखे : संपु०व० । मुखाकार गवाक्ष, झरोखे । 'नयन बीस मंदिर केसे मोखे ।' गी० ५.१२.५
मोचत : वकृ०० । छोड़ता-ते । बारिज लोचन मोचत बारी।' मा० २.३१७.६
मोचति : वक०स्त्री० । छोड़ती । 'लोचन मोचति बारि ।' मा० २.१६४
मोचन : वि०पू० । छुड़ाने वाला । 'बदन मयंक तापत्रय मोचन ।' मा० १.२२१.५
मोचनि : वि०स्त्री० । छुड़ाने वाली । 'कथा सुनी भव मोचनि। मा० ७.५६.१
मोचहिं : आ० प्रब० । छोड़ते हैं । 'मोहिं लोचन बारि।' मा० २.१४२
मोचिनि : संस्त्री० (प्रा. मोच-फा० मोज:-सं० मोचिनी)। मोजा (या जूता) बनाने वाली जाति की स्त्री । मोची स्त्री । रा०न० ७
मोच्छ : सं०० (सं०) । मुक्ति । मा० ३.१५
मोच्छप्रद : मोक्षदायक । मा० ३.१६.१
मोट : (१) वि०० । मोटा-झोटा, खुरदुरा । 'भूमि सयन पटु मोट पुराना।' मा० २.२५.६ (२) सं०स्त्री० । गठरी (धन की ग्रन्थि) । “चोट बिनु मोट पाइ भयो न निहाल को ।' कवि० ७.१७
मोटरी : मोट । गठरी । 'निज निज मरजाद मोटरी सी डार दी।' कवि० ७.१८३
मोटी : वि०स्त्री० । स्थूल, बड़ी, भारी ! 'काहं देवतनि मिलि मोटी मठि मार दी।' कवि० ७.१८३
मोटे : वि००ब० । बड़े, स्थूल (भद्दे) । 'बोल न मोटे मारिऐ।' दो० ४२६
मोटेऊ : स्थूल भी । 'मोटेऊ दूबरे ।' विन० २४६.१
मोति : मोती । गी० ७.२१.८
मोतिन : मोती+संब० । मोतियों । 'मोतिन माल अमोलन की ।' कवि० १.५
मोती : सं०पू० (सं० मोक्तिक>प्रा० मोत्तिअ) । मुक्ता । मा० १.१६६.२
मोतें: मुझसे । 'मोते कोन अभागी।' गी० २.४.३
मोद : सं०० (सं०)। हर्ष, उल्लास, आनन्द-विनोद । मा० १.१.३
892
_______________________________________________
मोदक : सं०० (सं० ) । लड्डू (खाद्यविशेष) । 'दुहूं हाथ मद मोदक मोरें।' मा० २.१६०.६
मोदकन्हि : मोदक+संब० । मोदकों (से) । 'मन मोदकन्हि कि भूख बुताई ।' मा० १.२४६.१
मोदकप्रिय : जिन्हें मोदक प्रिय है गणेश जी । विन० १.३
मोदमय : (दे० मय) हर्षोल्लास से निर्मित तथा व्याप्त । 'मंजुल मंगल मोदमय मूरति मारुतपूत ।' दो० २२८
मोदाकर : मोद की खानि, मोदमय । रा०प्र० २.७.४
मोदु : मोद+कए । एकमात्र (अमिश्र) हर्षोल्लास । 'किमि कहि जात मोदु मन जेता।' मा० १.३३०.३
मोपै : (१) मुझसे । 'सहि न जात मोपै परिहास एते ।' विन० २४१.५ (२) मेरे पास । 'मोपै सुतबधू न आई।' गी० २.५१.२ (दे० पै)
मोर : (१) सं०० (सं.)। मयूरपक्षी । मा० ४.१३ (२) सार्वनामिक विशेषण । मेरा । 'मोर भाग्य राउर गुन गाथा।' मा० १.३४२.३ (३) ममत्व-बुद्धि; माया द्वैत जनित आत्मबोध । 'मैं अरु मोर तोर ते माया।' मा० ३.१५.२
मोरचंद : मोरपंख का चंदवा, मोर चन्द्रक । 'तन दुति मोरचंद जिमि झलक ।' गी० १.३१.२
मोर-तोर : द्वैतजनित स्वता-परता का भाव । मा० ३.१५.२
मोरप्रंख : मयूर पक्ष । मा० १.११३.३
मोरसिखा : मोरचंद । 'मोरसिखा बिनु मूरिहूं पलुहत गरजत मेह ।' दो० ३१६
मोरा : मोर । (१) मेरा। 'होइ हित मोरा ।' मा० १.६.१ (२) मयूर पक्षी । 'नटत कल मोरा ।' मा० १.२२७.६
मोरि : (१) सार्वनामिक विशेषण । मेरी । 'छमिहहिं सज्जन मोरि ढिठाई।' मा० १.८.५ (२) पू० (सं० मोटयित्वा>प्रा० मोडिअ>अ. मोडि) । मोड़ कर, घुमाकर । 'मेघ भागे मुख मोरि के।' कवि० ५.१६
मोरी : मोरि । मेरी । थोरि मति मोरी ।' मा० १.१.४
मोरें : (१) मेरे। मेरे पास । 'कबित बिबेक एक नहिं मोरें ।' मा० १.६.११ (२) मेरे.. में । 'हुलसै तुलसी छबि सो मन मोरें।' कवि० २.२६ (३) मोड़ने से, फेर लेने से (विमुख होने से) । 'न अकाज कछू जिनके मुख मोरें।' कवि० ७.४६ मोरे (१) मेरे । 'तुम्हरी कृपा सुलभ सोउ मोरे।' मा० १.१४.११ (२) मोरें। मोड़ने से । कृ० ४४ 'ते करनी मुख मोरे ।' कवि० ७.४८
मोरेहुं, मोरेहु : मेरे भी । 'मोरेहुं मन भावा । मा० १.६२.१ 'मोरेहु कहें न संसय जाहीं।' मा० १.५२.६
_______________________________________________
893
मोल, मोला : (१) सं०पू० (सं० मूल्य>प्रा० मोल्ल)। निष्क्रय । 'सोउ प्रगटत जिमि मोल रतन तें।' मा० १.२३.८ (२) मूल्य से, मूल्य देकर। 'आनेहु मोल बेसाहि कि मोही।' मा० २.३०.२ (३) मूल्य से क्रीत । 'हास बिलास लेत मन मोला ।' मा० १.२३३.५
मोसी : मेरे जैसी । गी० ६.१८.३
मोसे : मुझ जैसे । कवि० ७.२३
मोसों : मुझसे । कवि० ७.१३७
मोसो : मुझ जैसा । 'राम सुस्वामि कुसेवकू मोसो।' मा० १.२८.४
मोहँ : मोह से, अविवेकवश, अनिश्चय के कारण। 'भूप बिकल मति मोह भुलानी।" मा० १.१७३.८
मोह : सं०० (सं०) । अज्ञान, तमोगुणी चित्तदशा। (१) योग में अस्मिता जो अहंकार का सूक्ष्मरूप है, सांख्य में मोह कहा जाता है । 'मैं-तें मेट्यो मोह तम ऊगो आतम भानु ।' वैरा० ३३ (२) भावातिरेक में अविवेक-षड्वर्ग का अन्यतम ।' मा० १.३८.६ (३) संज्ञा शून्यता, मर्छ। 'भए मोह बस सकल भुलाना ।' मा० १.२४८.७ (४) आसक्ति, लगाव । 'सपनेहुँ उन्ह के मोह न माया ।' मा० १.६७.३ (५) मोहइ। 'माया-जेहि न मोह अस को जग जाया ।' मा० १.१२८.८
मोह मोहइ, ई : आ०ए० (सं० मोहयति >प्रा० मोहइ)। (१) मग्ध करता ती है; बेसुध करता-ती है। 'सिव बिरंचि कहुं मोहइ। मा० ७.६२ ख (२) मोहित होता-ती है (मूछित होता है)। 'अहिपति बार बारहिं मोहई।' मा० ५.३५ छं० २
मोहत : वकृ.पु । मुग्ध करता-ते । 'मोहत कोटि मयन ।' गी० १.५१.३
मोहति : वकृस्त्री० । मुग्ध करती । 'मूरति जनु जग मोहति ।' पा०म० १२४
मोहन : (१) वि०पू० । मोहने वाला, मुग्धकारी। 'सब भांति मनोहर मोहन रूप।' कवि० २.१८ (२) श्रीकृष्ण । कृ० २८
मोहनिहारु : वि०कए । मुग्ध करने वाला । गी० ७.८.४
मोहनी : (१) वि०स्त्री० । मुग्ध करने वाली। 'बिलोकनि मोहनी मनहरनि ।' गी० १.२८.३ (२) मुग्ध करने की क्रिया। (३) मोहित करने की यन्त्रमन्त्र युक्त क्रिया। (४) अभिमन्त्रित बूटी आदि । जिन्ह निज रूप मोहनी डारी।' मा० १.२२६.५ (५) वशीकरण-बूटी 'एतेहुं पर भावत तुलसी प्रभु गये मोहनी मेलि ।' कृ० २६ (सर्वत्र अर्थों का गुम्फल विद्यमान है ।)
मोहनीमनि : ऐसी मणि जो दूसरे को मुग्ध करने का उपकरण होती है। 'मनहु मनसिज मोहनीमनि गयो भोरे भूलि ।' गी० ५.२.२
894
_______________________________________________
मोहपर : मोह से परे, अज्ञान सीमातीत, अविद्या-विकारों से मुक्त। मा० १.१६६
मोहमय : मोह (अज्ञान, बेसुधी) से ओतप्रोत; विमूढतापूर्ण । 'मिटी मोहमय सूल ।' मा० १.२८५
मोहमूल : (१) वि० (सं.)। मोहमूलक जिसका कारण अज्ञान है । 'मोहमूल परमारथु नाहीं।' मा० २.६२.८ (२) मोह का कारण । 'मोहमूल बहुसूलप्रद त्यागहु तम अभिमान ।' मा० ५.२३ ।
मोहहिं, मोहहीं : आ०प्रब०। (१) मोहित हो जाते हैं। 'हरि मायाँ मोहहिं मुनि ग्यानी।' मा० १.१४०.७ (२) मोहित करते-ती हैं। गंधर्ब कन्या रूप मुनि मन मोहहीं।' मा० ५.३ छं० २
मोहा : (१) भूक०० । मोहित, मोह में डाला। 'नाथ जीव तव मायां मोहा ।' मा० ४.३.२ (२) मोह । 'उमा रामबिषइक अस मोहा ।' मा० १.११७.४ (३) मोहइ । मोहित करता है। 'छत्रु अखयबटु मुनि मन मोहा।' मा० २.१०५.७ (४) मोहित होता है । 'बरनि न जाइ देखि मन मोहा ।' मा० १.२२८.४
मोहापह : वि०० (सं.)। मोहनाशक । विन० ४६.५
मोहिं : मोहि । मुझे । 'कीजे मोहिं आपनो।' विन० १८०.१
मोहि : (१) मझ । 'मोहि तें अधिक ते जडमति रंका ।' मा० १.१२.८ (२) मुझे। 'समुझि सहम मोहि अपडर अपनें ।' मा० १.२६.२ (३) मेरे पास । 'मोहि मति बल अति थोर ।' मा० १.१४ ख (४) पूकृ० (सं० मोहयित्वा>प्रा० मोहिअ>अ० मोहि) । मुग्ध करके । 'मोहि मानो मदन मोहनी मूड़ नाई है।' गी० १.७१.३
मोहित : भूकृ०वि० (सं.)। मूछित, मोहग्रस्त । विन० २४६.१
मोही : (१) मोहि । मुझको। 'कहिअ बुझाइ कृपानिधि मोही। मा० १.४६.६ (२) भक०स्त्री० । मग्ध की, मोह ली। जेहिं जग जवती हसि मोही।' कृ० ४१ (३) मुग्ध हुई । 'निरखि हौं मोही।' गी० २.१८.१
मोहु, मोहू : (१) मोह+कए० । मा० १.६८.८ ‘भएँ ग्यानु बरु मिट न मोहू ।' मा० २.१६६.३ (२) मुझे भी । 'जानि कृपाकर किंकर मोहू ।' मा० १.८.३
मोहे : भूकृ०० ब० (सं० मोहित>प्रा० मोहिय) । (१) मोहित (मुग्ध) हुए। 'नपुर धुनि सुनि मुनि मन मोहे ।' मा० १.१६६.३ (२) मुग्ध कर लिये। 'रूप की मोहनी मेलि मोहे अग जग हैं।' गी० २.२७.३
मोहेउ : भकृ.पु.कए० । मुग्ध हुआ, मुग्ध किया । 'रूप मन मोहेउ ।' जा०म० १८
मोहेहु : आ०-भूकृ००+मब० । तुमने मोहग्रस्त किया था। मोहेहु मोहि सुनहु रघुराया।' मा० ३.४३.२
_______________________________________________
895
मोहैं : मोहहिं । (१) मोहित करते हैं । 'चित तुम्ह त्यों हमरो मन मोहैं।' कवि० २.२१ (२) मोहित होते हैं । 'कौतुक कला देखि सुनि मुनि मोहैं।' गी० १.६.१५ ।
मौंगी : वि स्त्री० । चुप, मौन (मूक) । 'अंब मौंगी रहि, समुझि प्रेमपथ न्यारो।' गी० २.६६.५
मौन : (१) वि. (सं.)। चुप , अवाक् । मा० २.१५.४ (२) सं०पुं० । चुप्पी ।
मौनता : चुप्पी । 'मानो मौनता गही।' कवि० १.१६
मोनु : मौन+कए । चुप्पी । थकित रहे धरि मौनु ।' मा० २.१६० ।।
मोने : मौन ही, चप ही। 'बिथकि रही है मति मोने ।' गी० १.१०७.२
मौर : (१) सं०० (सं० मकुट>प्रा० मउड)। शिरोभूषणविशेष (जो वर को _ विवाह में पहनाया जाता है। मा० १.३२७ छं० (२) वि००। (लक्षणा से) श्रेष्ठ । दे० सुर मौर ।
मौरु : मोर+कए । विलक्षण मौर । 'जटा मुकुट अहि मौरु सँवारा।' मा. १.६२.१
मौलि : सं० (सं०) । सिर, मस्तक । मा० १.१६७.८
मोलिमनि : शिरोमणि, श्रेष्ठ । 'मंद जन-मौलिमनि ।' विन० २११.४
मौसी : सं०स्त्री० (सं० मातृष्वसा>प्रा० माउसिआ>अ० माउसी) । माता की बहन । गी० ७.३४.४
म्हाको : सार्वनामिक वि० । (१) (सं० आस्माक>प्रा० अम्हाक) कए । (२) (सं० अस्म>प्रा० अम्हा=म्हा+को)। मेरा; हमारा । 'मंदमति कंत सुनु मंतु म्हाको ।' कवि० ६.२१
# य
यंता : वि०+सं०पू० (सं० यन्त) । (१) सारथि (२) नियन्त्रणकर्ता। विन० २६.७
यंत्र : (१) सं०० (सं.)। नियन्त्रण, बन्धन (२) तान्त्रिक लेखविशेष । 'जयति पर-यंत्र-मंत्राभिचार-प्रसन ।' विन० २६.७ (३) कोल्हू, जांत आदि । 'समर तैलिक यंत्र, तिल तमीचर निकर ।' विन० २५.७
