पूँछेउ : पूछेउ । पूछा। पूछेउ मग लोगन्ह मदु बानी ।' मा० २.११८.५
पूँछेहु : पूछेहु । (१) भूक००+मब० । तुमने पूछा। पूछेहु रघुपति कथा प्रसंगा।' मा० १.११२.७ (२) भ+आज्ञा+मब० । तुम पूछना । 'सीता सुधि पूछेहु सब काहू ।' मा० ४.२३.२
पूँजी : सं०स्त्री० । मूलधन । 'पूजी बिनु बाढ़ी सई ।' मा० ५.३७.४
पूग : (१) सं०० (स.)। पुञ्ज, गुच्छा, समूह। 'नाम अखिल अघ पूग नसावन ।' ____ मा० ७.६२.२ (२) सुपाड़ी (संभवत: गुच्छों में फल लगने से ।)
पूगफल : सं०० (सं०) । गुच्छेदार फल वाला । (१) सुपाड़ी। (२) सुपाड़ी का वृक्ष । 'पान पूगफल मंगल मूला।' मा० १.३४६.४ 'सफल रसाल पूगफल केश रोपहु ।' मा० २.६.६
पूछ : संस्त्री० (सं० पुच्छ) । पूछ । 'पूछ सों प्रेम बिरोध सींग सों।' कृ० ४६
पूछ,  पूछइ : (सं० पृच्छति>प्रा० पुच्छइ) आ.प्रए । पूछता है । 'संकट बात न पछ कोऊ।' विन० १३६.३
पूछउँ : आ० उए० (सं० पृच्छामि>प्रा० पुच्छमि>अ० पुच्छउँ) । पूछता-ती हूं।  'रामु कवन प्रभु पूछउँ तोही ।' मा० १.४६.६
पूछत : वकृ०० (सं० पृच्छत् >प्रा० पुच्छंत)। पूछता-ते। 'मैं पूछत सकुचाउँ ।' मा० २.१२७
पूछति : पूछत+स्त्री० । पूछति प्रेम मगन मृदु बानी ।' गी० ६.१६.३
पूछन : भकृ० अव्यय (सं० प्रष्टुम्>प्रा० पुच्छिउं>अ० पुच्छण)। पूछने । 'जी बहोरि कोउ पूछन आवा ।' मा० १.३६.४ ।।
पूछहिं : आ०प्रब० (सं० पृच्छन्ति >प्रा० पुच्छति>अ० पुच्छहिं) । पूछते हैं । 'पूछहिं सकल देखि मनु मारें ।' मा० २.३६.४
पूछहु : आ०मब० (सं० पृच्छथ-त>प्रा० पुच्छह>अ० पुच्छह) । (१) पूछते हो। 'बार बार प्रभु पूछहु काहा ।' मा० ६.८.८ (२) पूछो। 'तात अनत पूछहु जमि काहू ।' मा० ७.६०.८
पूछा : भूक पु० (सं० पृष्ट>प्रा० पृच्चिअ)। मा० १.५७.८
पूछि : पू० (सं० पृष्ट्वा>प्रा० पुच्छिअ>अ० पुच्छि)। पूछकर : मा० १.३१३.८
पूछिअ : आoकवा०प्रए० (सं० पृच्छ्यते>प्रा० पुच्छो अइ)। पूछिए; पूछा जाय, __ पूछा जाता है । 'जानत हूं पूछिअ कस स्वामी।' मा० ३.६.७
पूछिहि : आ०भ प्रए० (सं० प्रक्ष्यति>प्रा. पुच्छिहिइ) । पूछेगा-पूछेगी। पूछिहि जहिं लखन महतारी।' मा० २.१४६.२
पूछिहै : पूछिहि । हमें पूछिहै कौन ।' दो० ५६४
पूछी : पूछा+स्त्री० । 'कहि असीस पूछी कुसलाई ।' मा० १.३०८२
पूछें : क्रि०वि० । पूछने से-पर, पूछते हुए। पूछ कोउ न ऊतरु देई ।' मा० २.३८.५
पूछे : भूक०० ब० (सं० पृष्ट>प्रा. पच्छिय) । 'कहउँ कथा निज पूछे तोरें।' मा० १.१६४.४
पूछेउ : भूक००कए० । पूछा । 'पूछेउ तब सिर्व कहा बखानी ।' मा० १.६१.५
पूछेसि : आo -भूकृ००+प्रए । उसने पूछा। 'पूछेसि लोगन्ह काह उछाहू ।' मा० २.१३.२
पूछेहु : (१) आ०-भूकृ००+मब० । तुमने पूछा । 'पूछेहु नाथ मोहि का जानी ।' मा० ३.१३.४ (२) भ०+आज्ञा-मब० । तुम पूछना । 'समाचार तब पूछेहु जाई ।' मा० २.३६.१
पूछ : पूछ।।
पूछै : पूछह । 'मधुकर कछु जनि पूछो।' कृ० ४३
पूज, पूजइ : आ०ए० (१) (सं० पूजयति>प्रा. पुज्जइ) । पूजन करता-करती है। 'पूजइ सिवहि समय तिहुं ।' पा०म० ३६ (२) (सं० पूर्यते>प्रा. पुज्जइ) भरता है-पुरता है। पूरा होता है या पूरा पड़ता है। 'करनिहूं न पूजे क्वै।' कवि० ७.१६३
पूजक : वि० (सं०) । पुजारी, पूजा करने वाला। दो० ३६३
पूजत : वकृ.पु । पूजा करता-ते । 'जेहि पूजत अज ।' मा० १.२११.७ छं०
पूजति : वकृ०स्त्री० । पूजा करती । आदर करती। 'पूजति त्रिजटा नीके।' गी० ५.१८.३
पूजन : (१) संपु० (सं.)। पूजा। 'पूजे पूजन जोग ।' रा०प्र० ४.६.६ (२) भकृ० अव्यय । पूजने, पूजा करने । 'गिरिजा पूजन जननि पठाई।' मा० १.२२८.२
पूजनीय : वि० (सं०) । पूजा योग्य, सम्मान्य । मा० २.७४.७
पूजहिं : आ०प्रब० (१) (सं० पूजयन्ति>प्रा० पुज्जति>अ० पुजहि) पूजा करते हैं । 'पूर्जाहं माधव पद जलजाता।' मा० १.४४.५ (२) (सं० पूर्यन्ते> प्रा० पुज्जेति>अ० पुज्जहि) पूर्ण होते हैं । 'पूजहिं सब मन काम ।' दो० १२१
पूजहु : आ०मब० (सं० पूजयत>प्रा० पुज्जह>अ० पुज्जहु) । पूजा करो, पूजो। ___'पूजहु गनपति गुरुकुल देवा ।' मा० २.६.८
पूजा : सं०स्त्री० (सं.)। अर्चा, सम्मान । 'करेहु सदा संकर पद पूजा।' मा० १.१०२.३ (२) षोडशोपचार देवपूजन = अर्घ्य, पाद्य, स्नान, वस्त्र, यज्ञोपवीत, गन्ध, अक्षत, पुष्प, धूप, दीप, नैवेद्य, आचमनीय, ताम्बूल, फल, दक्षिणा और पुष्पाञ्जलि । दे० पूजि । (३) भूकृ०० । पूजित किया । 'करि प्रनाम पूजा कर जोरी।' मा० १.३३०.५
पूजि : पू० (१) (सं. पूजयित्त्वा>प्रा. पुज्जिअ>अ० पुज्जि)। पूज कर । 'सोरह भांति पूजि सनमाने ।' मा० २.६.३ दे० पूजा । (२) पूर्ण होकर । 'ताकी पैज पूजि आई ।' विन० ३०.१
पूजिअ : आ०कवा०प्रए० (सं० पूज्यते>प्रा० पुज्जीअइ)। पूजिए, पूजा जाय, पूजना चाहिए । 'पूजिअ बिप्र सील गुन हीना।' मा० ३.३४.२
पूजिअत : वकृ० कवा०प० (सं० पूज्यमान >प्रा० पज्जीअंत) । पूजे जाते । 'प्रथम पूजिअत नाम प्रभाऊ ।' मा० १.१६.४
पूजिअहि : आ०कवा०प्रब० (सं० पूज्यन्ते>प्रा० पुज्जिअंति>अ० पुज्जिअहिं) पूजे जाते हैं, सम्मान पाते हैं । 'बैष प्रताप पूजिअहि तेऊ ।' मा० १.७.५
पूजिऐ : पूजिअ । दो० ३६२
पूजित : वि० (सं.)। सम्मानित, आहत । गी० ३.१७.२
पूजिबे : भकृ०० (सं० पूजयितव्य>प्रा० पुज्जिअन्वय)। पूजने, पूजा करने । 'बहुत प्रीति पुजाइबे पर पूजिबे पर थोरि ।' विन० १५८.२
पूजिबो, पूजिबौ : भक००कए० (सं० पूजयितव्यम् >प्रा० पुज्जिअव्वं>अ० पुज्जिव्वउ) । पूजन करना । 'सेवा सुमिरन, पूजिबो पात आखत थोरे ।' विन० ८.२
पूजियत : पूजिअत । विन० २४७.२
पूजिये : पूजिऐ । 'देव पितर ग्रह पूजिये ।' गी० १.१२ २
पूजिहिं : आ०भ०प्रब० (प्रा० पृज्जिहिति>अ० पुजिजहिहिं)। पूर्ण होंगे। 'पूजहिं सब मन काम ।' रा०प्र० ४.३.२
पूजिहि : आ० भ०प्रए० (सं० पूरयिष्यते>प्रा० पुज्जिहिइ)। पूर्ण होगा-होगी। 'तो हमार पूजिहि अभिलाषा ।' मा० १.१४४.८ 'पूजिहि सब मन कामना ।' मा० २.१०३
पूजिहैं : पूजिहि । पूरे पड़ेंगे । 'मेरे पासंगहु न पूजिहैं।' विन० २४१.४
पूजिहै : पूजिहि । 'दास आस पूजिहै ।' विन० २७८.१
पूजिहौं : आ०भ० उए । पूजंगा-गी। ब्रह्मादि संकर गोरि पूजित पूजिहौं अब जाइ के ।' गी० ३.१७.२
पूजीं : भूकृ० स्त्री०ब० । (१) पूजित की। 'पूजी ग्राम देबि ।' मा० २.८.६ (२) पूरी हुई । 'पूजी सकल बासना जी की।' मा० १.३५१.१
पूजी : भूक स्त्री० । (१) पूजित की । 'तब सीतां पूजी सुरसरी ।' मा० ६.१२१.८ (२) पूरी हुई । “एकहिं बार आस सब पूजी।' मा० २.१६.१
पूजें : पूजन करने से । 'द्वापर परितोषत प्रभु पूजें ।' मा० १.२७.३
पूजे : भकृ००ब०। पूजित किये। 'पजे रिषि अखिलेस्वर जानी।' मा० १.४८.२
पूजेउँ : आ० - भूक.पु+उए । मैंने पूजा। 'पूजे उँ अमित बार त्रिपुरारी।' मा० ६.२५.३
पूजेउ : भूकृ००कए । पूजित किया। पूजेउ संभु भवानि ।' मा० ११००
पूजेहु : आ०-भूक.पु+मब० । तुमने पूजित किये । 'सिव बिरंचि पूजे हु बहु भाँती।' मा० ६.२०.३
पूजै : पूजहिं । (१) पूजा करते हैं । कवि० ५.३० (२) पूरे पड़ते हैं, समानता में आते हैं। 'जद्यपि मीन पतंग हीन मति, मोहि न पूजें ओऊ ।' विन० ६२.१
पूजै : पूजइ। (१) पूजा करे । 'को करि कोटिक कामना पूजे बहुदेव ।' विन० १०७.६ (२) पूरा पड़े।
पूजो : पूज्यो (पूजित) । 'जो कर न पूजो।' कवि० ७.५ ( यदि पूजा किया करे)।
पूजोपहार : (पूजा+उपहार) पूजन में समर्पित पुष्पादि-सामग्री।' विन० १७.२
पूज्य : वि० (स.) । पूजा योग्य, सम्मान्य । 'विप्र पूज्य अस गावहिं संता।' मा० ३.३४.१
पूज्यो : पूजेउ । पूर्ण हुआ। 'ट्यो धनुष मनोरथ पूज्यो ।' गी० १.६८.१
पूत : (१) सं०पू० (सं० पुत्र>प्रा० पुत्त)। ‘होहिं राम सिय पूत पुतोहू ।' मा० २.१५.७ (२) वि० (सं.)। पवित्र । 'तटिनि बर बारि हरि चरन पूत । विन० १०.३
पूत,  पूतउ : पुत्र भी। 'मेरे पूतऊ अमेरे सब ।' कवि० ५.११
पूतना : सं०स्त्री० (सं.)। (१) बालभक्षिणी डाकिनी। (२) एक विशेष डाइन जिसे कृष्ण ने मारा था । दो० ४०८ ।
पूतरि : पुतरि । 'करउँ ताहि चख पूतरि आली ।' मा० २.२३.३
पूतरो : संपु०कए० (सं० पुत्तल कम्>प्रा० पुत्तलअं>अ० पुत्तलउ)। तण आदि का पुतला, कृत्रिम मानवादि आकृति विशेष । अब तुलसी पूतरो बाँधिहै ।' विन० २४१.५ (नट लोग जिससे पैसा आदि नहीं पाते उसका तृण-पुत्तल बनाकर घुमाते हैं।)
पूतु : पूत+कए० । इकलौता पुत्र । 'पूत बिदेस न सोचु तुम्हारे ।' मा० २.१४.५
पुनु : सं००कए० (सं. पुण्यम् >प्रा० पुण्णं>अ० पुण्णु) । पुण्य । 'गहहिं न __ पाप पून गुन दोषू ।' मा० २.२१६.३
पूनों : सं-स्त्री० (सं० पूर्णिमा>प्रा. पुण्णिमा>अ० पणि वै) । पौर्णमासी तिथि। विन० २०३.१६
पूप : सं०० (सं.)। अपूप, पुआ, एक प्रकार की मीठी पूड़ी । मा० ७.७७.१०
पूय : सं०पू० (सं.)। पीब =फोड़ें आदि से निकला रुधिर विकार । मा० ६.५२.३
पूर : (१) सं०पू० (सं०) । पूर्ति, सफलता । 'नाथ न पूर आव एहि भांती ।' मा० ६.६.१ (२) विराम । 'अजहुं पूर प्रिय देहु ।' मा० ६.३७ (३) प्रवाह । 'प्रेमाम्बु-पूरं शुभम् ।' मा० ७.१३० श्लोक २ (४) दे०/पूर । (५) वि.पु. (सं० पूर्ण) । सकल, सम्पूर्ण । 'देखि पूर बिधु बाढ़इ जोई।' मा० १.८.१४
पूर, पूरइ : (सं० पूरयति>प्रा० पूरइ>आ०प्रए० पूर्ण करता है, भर देता है। 'बिधु महि पूर मयूखन्हि ।' मा० ७.२३
पूरत : वकृ०० । पूर्ण करता-ते । 'सुमिरे त्रिविध घाम हरत, पूरत काम ।' विन० २५५.१
पूरति : वकु०स्त्री० । पूर्ण करती । 'पुलक तन पूरति ।' पा०म० ६८
पूरन : वि० (सं० पूर्ण) । समस्त, सकल । 'जनु चकोर पूरन ससि लोभा।' मा० १.२०७.६ (२) तृप्त । 'पूरन किए दान सनमाना।' मा० १.३५१.८ (३) ओत-प्रोत । 'पूरन राम सुप्रेम पियूष ।' मा० २.२०६.५ (४) लबालब भरा हुआ । 'आश्रम सागर सांतरस पूरन ।' मा० २.२७५ (५) व्याप्त, व्यापक । 'देसकाल पूरन सदा ।' विन० १०७.५
पूरनकाजा : वि० (सं० पूर्ण कार्य) । कृतकृत्य, कृतार्थ । मा० १.३३०.६
पूरनकाम, पूरनकामा : वि० (सं० पूर्ण काम)। सफल-मनोरथ-जिसे कुछ अपेक्षा न हो। 'पूरनकाम रामु परितोषे ।' मा० १.३४२.६, मा० ३.३१.१०
पूरनिहारु : वि०प०कए । पूर्ण करने वाला । 'जन मन काम पूरनिहारु ।' गी० ७.८.२
पूरब : पूरुब । (१) दिशा विशेष । 'पुर पूरब दिसि गे दोउ भाई ।' मा० १.२२४.१ (२) क्रि०वि० । पहले, अतीत में । 'तिन्ह कहुं मैं पूरब बर दीन्हा ।' मा० १.१८७.३ (३) पूर्व जन्म, अतीत काल । 'पुरुषारथ पूरब करम ।' दो० ४६८
पूरहिं : आ०प्रब० (सं० पूरयन्ति>प्रा० पूरंति>म० पूरहिं)। भर दें, पाट दें। 'परहिं न भरि कुधर बिसाला ।' मा० ५.५५.६
पूरा : पूर । (१) प्रवाह । (२) पूर्ण । 'मम भुज सागर बल जल पूस ।' मा० ६.२८.३ (३) पूर्ति, सफलता। 'तिन्हहि बिरोधि न आइहि पूरा।' मा० ३.२५.८ (४) विराम । 'सुनु मतिमंद देहि अब पूरा ।' मा० ६.२६९
पूरि : पूक० । पूर कर, व्याप्त होकर । 'पूरि प्रकास रहेउ तिहुँ लोका।' मा० ७.३१.२
पूरित : भूकृ०वि० (सं०)। भरा हुआ, व्याप्त । 'पूरित पुलक सरीर ।' मा० १.३००
पूरी: (१) पूरि। 'रहा कनक मनि मंडप पूरी।' मा० १.३२६.२ (२) भूक०स्त्री० । भरी, पूर्ण की। 'चोके चारु सुमित्रा पूरी ।' मा० २.८.३ (३) सम्पन्न, सफल । 'बैर रघुबीर के न पूरी काह की परी।' कवि० ६.२७
पूरब : सं०+वि० (सं० पूर्व>प्रा० पूरुव) । (१) दिशा विशेष । (२) अतीत काल । 'पूरुब कथा प्रसंगु सुनावा ।' मा० १.६८.१ (३) प्रथम । इससे पहला । 'पूरब जन्म कथा चित आई।' मा० १.१०७.४
पूरें : पूरने पर (बजाने हेतु फूंक कर वायुपूरित करने पर)। 'रूरे हँगी पूरे काल कंटक हरत हैं।' कवि० ७.१५६
पूरे : भूक पुब० (सं० पूरित>प्रा० पूरिय) । (१) भरे हुए । 'सुचि सुगंध मंगल जल पूरे ।' मा० १.३२४.५ (२) पूर्ण काम, तृप्त । 'भरहिं निरन्तर होहिं न पूरे ।' मा० २.१२८.५ (३) भर दिये । 'पूरे पट बिबिध बरन ।' विन० २१३.३ .
पूरो : पूरा+कए० । प्रा=सफलता । 'सब दिन रूरो पर पूरो जहां तहां ताहि । हनु० १२
पूर्ण : वि० (सं०) । मा० ३ श्लो० १
पूर्व : (सं०) पुराकाल (दे० पूरुब) । मा० ७.१३० श्लो० १
पूषन : सं०० (सं० पुषण) । सूर्य । मा० १.२०.६
पूषनु : पूषन+कए । 'पूषन सो भव भूषनु भो।' कवि० ७.४२
पृथक : अव्यय (सं० पृथक) । अलग । मा० १.८८.६
पृथुराज : राजा पृथु जो बेन के पुत्र थे । उन्होंने दस हजार कान वरदान में पाये थे कि भगवान् का यश सुन सकें। मा० १.४.६
पृथुल : वि० (सं.)। विस्तृत, दीर्घ, अतिमात्र । “पंथि की कथा पृथुल ।' गी० २.३७.३
पृष्ट : सं०० (सं० पृष्ठ>प्राo-मागधी-पस्ट>अ० पृस्ट) पीठ । 'कमठ पृष्ट ___ कठोर ।' मा० ५.३५ छं० २ ।
पृष्ठोपरी : (सं० पृष्ठोपरि) पीठ के ऊपर । विन० ५२.३
पेखक : वि० (सं० प्रेक्षक) । दर्शक, खेल आदि देखने वाला-ले । गी० १.४५.३
पेखत : वकृ०० (सं० प्रेक्षमाण>प्रा० पेक्खंत) । देखता-ते । 'पारथ पेखत सेतु । दो० ४४०
पेखन : (१) भकृ० अव्यय (सं० प्रेक्षितुम् >प्रा० पेक्खि उ>अ० पेक्खण) । देखने । 'स्वयंबर पेखन आए ।' गी० १.६८.४ (२) सं०० (सं० प्रेक्षण-प्रेक्षणक> प्रा० पेक्खण) । कौतुक-दृश्य । खेल, अभिनय आदि । 'जगु पेखन तुम्ह देख निहारे।' मा० २.१२७.१
पेखनो : सं०प०कए० (सं० प्रेक्षणकम् >प्रा० पेक्खण>अ० पेक्खणउ) । अद्भुत दृश्य, कौतुक आदि । 'पेखनो सो पेखन चले हैं पुर नर नारि ।' गी० १.७३.१
पेखहु : आ०मब० (सं० प्रेक्षध्वम् >प्रा० पेक्खह>अ० पेक्खहु)। देखो। 'पेखहु पनस रसाल ।' दो० ३५४
पेखा : भूकृ०० (सं० प्रेक्षित>प्रा० पेखिअ) । देखा। भूमि बिबर एक कौतुक पेखा ।' मा० ४.२४.५
पेखि : पू० (सं० प्रेक्ष्य>प्रा० पेखिअ>अ० पेक्खि) । देखकर । 'प्रभु पद पेखि मिटा सो पापा।' ३.३३.७
पेखिअ : आ०कवा०प्रए० (सं० प्रेक्ष्यते-ताम् >प्रा० पेक्खीअइ-उ) (आश्चर्य) देखिए । 'पज्जन फलु पेखिअ ततकाला ।' मा० १.३.१
पेखिअत : वकृ.पुकवा. (सं० प्रेक्ष्यमाण>प्रा० पेक्खीअंत)। देखे जाते। 'जापक पजक देखि अत सहत निरादर भार ।' दो० ३६३
पेखिए : पेखिअ । 'राम प्रेम पथ पेखिए।' दो० ८२
पेखी : पेखि । देखकर। 'चक्रवाक मन दुख निसि पेखी ।' मा० ४.१७.४
पेखु : आ०--आज्ञा--मए० (सं० प्रेक्षस्व>प्रा० पेक्ख>अ० पेक्खु) तू (आश्चर्य तो) देख । 'सुदर केकिहि पेखु ।' मा० १.१६१ ख
पेखें : देखने से । 'कहें दुख समउ प्रानपति पेखें ।' मा० २.६७.४
पेखे : भक०० (सं० प्रेक्षित>प्रा० पेक्खिअ) । देखे। 'गुन पेखे पारस के पंकरुह पाय के ।' गी० १.६७.३
पेखेउ : भकृ.पु.कए० (सं० प्रेक्षितम् >प्रा० पेक्खि>अ० पेक्खिअउ) । देखा। ____ 'जनम फल पेखेउ ।' पा०म० १३२ ।।
पेच : सं०स्त्री० (फा०) । साँप की लपेट, गांठ, फन्दा, उलझन, संकट । 'सोचत जनक पोच पेच परि गई है।' गी० १.८६.१
पेट : सं०पू० (सं० पेट=पेटारा>प्रा० पेट्ट)। उदर । मा० २.२५१.५
पेटक : सं०० (सं०) । पेटारा, पेटारे, खाँचे । 'सब भुवन पटु पेटक भरे।' ___ जा०म०ई० १३
पेटागि : (पेट+आगि) जठराग्नि, भूख की ज्वाला । 'पेटागि बस खाए टूक सबके।' ___कवि० ७.७२
पेटारी : संस्त्री० (सं० पेटिका>प्रा० पेट्टालिआ>अ० पेट्टाली)। बांस या बेत आदि की मञ्जूषा ।' मा० २.१२
पेटारे : पेटक (प्रा० पेट्टालय) । कवि० ५.२३
पेटु : पेट+कए । उदर । 'प्रभु सों कह्यो बारक पेट खलाई।' कवि० ७.५७
पेटौ : पेट भी। फिरत पेटी खलाय ।' कवि० ७.१२५
पेड़ : सं०पू० (सं० पेट= वक्षस्थल>प्रा० पेड)। वक्ष का स्थूल भाग-पेड़ी, तना। पेड़ काटि तै पालउ सींचा।' मा० २.१६१.८
पेडु़ : पेड़+कए । वृक्ष का मुख्य तना । 'पालव बैठि पेड़, एहिं काटा।' मा० २.४७.५
पेन्हा,  पेन्हाइ : (सं० प्रस्नोति >प्रा० पण्हवइ) आ०प्रए । पल्हाती है, स्तनों में दूध लाती है, प्रस्नत होती है । 'धरनि धेनु पेन्हाइ ।' दो० ५१२
पेन्हाइ : पूकृ० । प्रस्तुत होकर, पल्हाकर । 'धावत धेनु पेन्हाइ लवाई ज्यों ।' कवि.. ७.१२६
पेन्हाई : पेन्हाइ । पल्हाती है। ‘भाव बच्छ सिसु पाइ पेन्हाई ।' मा० ७.११७.११
पेम : प्रेम । मा० २.२०८.३
पेमप्रिय : वि० । जिसे प्रेम ही प्रिय हो । मा० २.२१२
पेममय : प्रेममय । मा० २.२६४.८
पेमु : प्रेम । मा० २.२६३
पेरत : वक०प० । (कोल्हू में) पेरता-ते । 'पेरत कोल्हू मेलि तिल ।' दो० ४०३
पेरो : भूक०कए । पेरा गया, पीडित किया गया। तिल ज्यों बह बारनि पेरो।' विन० १४३.२
पेलि : पक० । दबा कर, धकेल कर, निरस्त कर। 'राजमराल के बालक पेलि के पालत लालत खूसरो को।' कवि० ७.१०३
पेलिहहिं : आ०भ०प्रब० (सं० पेलयिष्यन्ति>प्रा० पेल्लिहिति>अ० पेल्लि हिहिं)। अवज्ञा करेंगे, अमान्य करेंगे । 'भोरेहुं भरत न पेलिहहिं मनसहं राम रजाइ ।' मा० २.२८१
पेली : पेलि । अवज्ञा कर, उपेक्षित कर । 'आयहु तात बचन मम पेली ।' मा० ३.३०.२
पेद : पेम (अ० पेव) । 'गिरिजहि पिआरी पेव की।' पा०म०ई० १५
पेषियत : पेखिअत । हनु० ४१
पेषु : पेख । गी० ७.६.४
पैंजनि, पैंजनी : संस्त्री० । पादाभरणविशेष । 'कटि किकिनि पग पैजनि बाजै ।' गी.. १.३१.३ 'पैजनी पायर्यान बाजति ।' गी० १.३२.२
पैंजनियाँ : पैजनी+ब० । पादाङ्गद । 'रुनु झुनु करति पायें पैजनियाँ।' गी० १.३४.२
पैंत : सं०० । दाँव (जुए आदि का अनुकूल प्राप्य)। 'मागें पैत पावत पचारि पातकी प्रचंड ।' कवि० ७.८१
पै : अव्यय (सं० प्रति>प्रा० पइ) । (१) से, को। 'मो पै परति न बरनि ।' कृ० ३० । (२) पर, ऊपर । 'बारि धारै सिर पै पुरारि ।' कवि० २.६ (३) भला कि । 'जों 4 प्रभु प्रभाउ कछु जाना।' मा० १.२७७.२ (४) परन्तु । 'दुराराध्य पै अहहिं महेसू ।' मा० १.७०.४ (५) केवल । 'यह सुभ चरित जान पं सोई ।' मा० १.१६६.६ (६) में। 'भलो भलाइहि पै लहइ ।' मा० १.५
पैअत : वकृ०कवा० (सं० प्राप्यमाण>प्रा० पावीअंत>अ० पाइअत) । पाया जाता, पायी जाती, पाये जाते । पैअत न छत्री खोज खोजत खलक मैं ।' कवि० ६.२५
पैज : पइज । (१) प्रतिज्ञा । 'रोप्यो पाउ पैज के ।' कवि० ७.१६ (२) प्रतिज्ञा पूति का संकट । 'पैज परे प्रहलादह को प्रगटे प्रभु पाहन तें न हिए तें।' कवि० ७.१२६
पैजनी : जनी । गी० १.३३.१
पैजपूरो : (दे० पूरो) प्रतिज्ञापूर्ण, दृढ प्रतिज्ञ । ,बेद बंदी बदत पैजपूरो।' हन ० ३
पैठ : भूकृ०० (सं० प्रविष्ट>प्रा० पइट) । धुसा, प्रवेश किया। पंठ भवन रथ राखि दुआरें।' मा० २.१४७.५
पैठत : पंठ+ वकृ०० । प्रवेश करता-करते। 'सर पैठत कपिपद गहा मकरौं।' ___मा० ६.५७
पैठहिं : पैठ+ प्रब० । प्रविष्ट होते-ती हैं। 'गावत पैठहिं भूप दुआरा।' मा० १.१६४.४
पैठा : पैठ । घुसा । 'पैठा नगर सुमिरि भगवाना।' मा० ५.५.४
पैठारा : सं०० (सं० प्रविष्ट-कार>प्रा० पइटार) । प्रवेश किया। 'असगुन होहिं नगर पैठारा ।' मा० २.१५८.४
पैठि : पैठ+पूक० । प्रविष्ट होकर । रा०प्र० ३.७.३
पैठिहउँ : पैठ+भ. उए । प्रवेश करूंगा। तब तुअ बदन पैठिहउँ आई ।' मा० ५.२.५
पैठीं : पैठा+स्त्री०ब० । प्रविष्ट हुई, घुस गईं। 'भागि भवन पैठौं अति त्रासा।' मा० १.६६.५
पैठे : पैठा +ब० । प्रविष्ट हुए । 'पैठे बिबर बिलंब न कीन्हा ।' मा० ४.२४.८
पैठेउ, पैठेठो : पठा+कए । प्रविष्ट हुआ। 'चलेउ नाइ सिरु पैठेउ बागा।' मा० ५.१०.१
पैठो : पैठेउ । 'पैठो बाटिका बजाइ ।' कवि० ५.२
पैत : पंत । 'भले पंत पासे सुढर ढरे री।' गी० १.७६.३
पैन : वि०पू० (सं० प्रण>प्रा० पइण) । तीखा, तीखी धार वाला-ले । 'सनमुख सहे बिरह सर पैन ।' गी० ५.२१.३
पैना : पैन । 'सनमुख हतै गिरा सर पैना।' वैरा० ४६
पैनी : पैना+स्त्री० । तीखी। जनक जबति मति पैनी ।' गी० १.८१.३
पैयत : पैअत । विन० १६२.२
पैरत : वकृ०० (सं० प्रतरत्>प्रा० पयरंत) । तैरते हुए । 'पैरत थके थाह जन पाई।' मा० १.२६३.४
पैरि : पू० (सं० प्रतीयं>प्रा० पयरिअ>अ० पयरि) । तर कर। 'परि पार ___चाहहिं जड़ करनी।' मा० ७.११५.४
पैरिबो : भकृ००कए । तैरना । 'लरिकाई को परिबो।' दो० १४०
पैहउँ : पाइहौं । मा० ७.४८
पैहहिं : पाइहैं । 'पहहिं सुख सुनि सजन सब।' मा० १.८
पैहहि : आ०भ० मए । (सं० प्राप्स्यति>प्रा० पाविहिसि>अ० पाविहिहि) । तू पाएगा । 'पैहहि सजाय, नत कहत बजाय तोहि ।' हनु० २६
पैहहु : पाइहहु । 'पैहहु सीतहि जनि पछिताहू।' मा० ४.२५.५
पैहैं : पाइहैं । “पैहैं मांगने जो जेहि भैहै।' गी० ५.५०.६
पैहै : (१) पाइहै। (वह) पायेगा। 'रावन कियो आपनो पैहै।' गी० ५.५०.२ (२) म०पू०ए० । तू पायेगा । 'फलु पैहै तू कुचालि को।' कवि० ६.११
पैहौं : पाइहौं । विन० १०४.२
पैहौ : पाइहो । 'जीवत परिजनहि न पही।' गी० २.७६.४
पौंछि : पूक० । (सं० प्रोक्ष्य, प्रोञ्छ्य>प्रा० पोंछिअ>अ० पोछि)। माजित कर, पोंछ कर । 'आंसु पोंछि मदु बचन उचारे ।' मा० २.१६५.४
पोऊ : आ०-आज्ञा-मए० (सं० प्रोतय>प्रा० पोअ>अ० पोउ) । तू पोह ले, ___ गंथ ले । 'दिनकर फलमनि''अनुराग ताग पोऊ ।' गी० २.१६.३
पोख : पोष । पोषक । 'प्रेम परिहास पोख बचन ।' गी० १.६७.४
पोखरिन : पोखरी+संब० । तलयों का। 'पिअत पोखरिन बारि।' दो० २६५
पोखरी : सं०स्त्री० (सं० पुष्करिणी>प्रा० पोक्खरिणी)। छोटा जलाशय, तलैया ।  हनु० २२
पोखि : पोषि । गी० २.८७.२
पोखे : पोषे । गी० १.६५.३
पोच : वि० (फा० पोच=बेहूदः, नालायक) (सं० प्रवाच्य>प्रा० पवच्च निन्दनीय)। बुरा । भलेउ पोच सब बिधि उपजाए।' मा० १.६.३
पोचा : पोच । मा० ६.७७.८
पोची : पोच+स्त्री० दूषित । निज हित चहइ तासु मति पोची।' मा ०. २.२६८.३
पोचु, पोचू : पोच+कए । 'भल परिनाम न पोचु ।' मा० २.२८२ 'जगु भल भलेहि पोच कहुं पोचू ।' मा० २.२१७.७
पोत : सं०पु० (सं.)। (१) नाव, जहाज । मा० ७.१ क (२) बालक । 'रे कपि पोत बोल संभारी।' मा० ६.२१.१
पोतक : सं०० (सं.)। बालक । 'जो सब पातक-पोतक डाकिनि ।' मा० २.१३२.६
पोतो : पोत+कए० । बच्चा । 'चित चातक सो पोतो।' विन० १६१.२
पोथिन : पोथी+संब० । पोथियो (में) । दो० ५५७
पोथिही : पोथी (में) ही। 'पैयत पोथिही पुरान ।' विन० १६२.२
पोथी : सं०स्त्री० (सं० पुस्तिका>प्रा० पोत्थिा >अ० पोत्थी)। ग्रन्थ । रा०प्र० ७.७.१
पोली : वि०स्त्री० । अन्तःसारशन्य, भीतर सार-रहित, खोखली। ‘राम प्रीति प्रतीति पोली, कपट करतब ठोसु ।' विन० १५६.२
पोष : पोषइ । पोषण देता है। दो० ५२५
पोष, पोषइ : (सं० पोषयति>प्रा० पोसइ) आ०प्रए । अनुग्रह करता है, पुष्टि देता है । 'पालइ पोषइ सकल अंग ।' भा० २.३१५
पोषक : वि० (सं.)। पुष्ट करने वाला-वाले । 'तनु पोषक नारि नरा सगरे ।' मा० ७.१०२.१०
पोषण : सं०० (सं०) । पुष्टि (सारसँभाल), अनुग्रह । विन० ५५.६
पोषत : वक०० (सं० पोषयत्>प्रा० पोसंत)। पुष्ट करता। 'राम सुप्रेमहि पोषत पानी ।' मा० १.४३.३
पोषन : पोषण । मा० १.१६७.७
पोषनिहारा : वि०० । पुष्ट करने वाला । 'भानु कमल कुल पोषनिहारा । मा० २.१७.७
पोषि : पूक० (सं० पोषयित्वा>प्रा० पोसिअ>म० पोसि) । पोषण = अनुग्रह देकर, सन्तुष्ट-अनुग्रहीत करके । 'प्रेम पोषि ठाढ़े सब कीन्हे।' मा० १.३४०.२
पोषिबे : भक०० (सं० पोषयितव्य>प्रा० पोसिअव्वय) । पुष्ट करने । 'सोषिबे को भानु पोषिबे को हिममानु भो।' हनु० ११
पोषिये : आ०कवा०प्रए० (सं० पोष्यते>प्रा० पोसीअइ)। पुष्ट करिए, अनुग्रहीत कीजिए । 'अब गरीब जन पोषिये ।' विन० १४६.४
पोषिहैं : आ०म०प्रब० (सं० पोषयिष्यन्ति>प्रा० पोसिहिति>अ० पोसिहिहिं)। ___अनुग्रहीत होंगे, पुष्ट किये जायेंगे। 'बिबुध प्रेम पोषिहैं।' कवि० ६.२ ।।
पोषी : भूकृ०स्त्री०ब० । पुष्ट की, अनुग्रहीत की गईं। 'जनु कुमुदिनी कौमुदी पोषों।' मा० २.११०.४
पोषे : भूकृ.पु.ब. (सं० पोषित>प्रा० पोसिय) । अनुग्रहीत किये, पुष्ट किये। 'सुनि बर बचन प्रेम जनु पोषे ।' मा० १.३४२.६
पोषेउ : भूकृ००कए । पुष्ट सम्पन्न किया, बढ़ाया। 'जानकी तोषि पोषेउ प्रताप ।' गी० ५.१६.१०
पोसात : पोषत । पोषक होता, पुष्टि देता। 'हुतो पोसात दान दिन दोबो।' कृ०६
पोसु : (समासान्त में) वि०प०कए. (सं० पोष:>प्रा० पोसो>अ० पोसु)। पोषण-अनुग्रह देने वाला । 'नाथ अनाथ आरत-पोसु ।' विन० १५६.१
पोसें : क्रि०वि० (सं० पोषेण>प्रा० पोसेण>अ० पोसें) । अनुग्रह करने से, पोसने से । 'बनइ प्रभु पोसें।' मा० ४.३.४
पोसे : पोषे । 'मोसे दोस-कोस पोसे ।' विन० १७९.३
पोसों : आ० उए० (सं० पोषयामि>प्रा० पोसमि>अ० पोसउँ)। पुष्ट कर रहा हूं। 'पातकी पावर प्राननि पोसों।' कवि० ७.१३७
पोसो : पोसेउ-पोषेउ । अनग्रहीत किया। निज दिसि देखि दयानिधि पोसो।' मा० १.२८.४
पोहत : वकृ०० । गूंथते, गुम्फित करते। 'तुलसी प्रभु जोहत पोहत चित ।' गी० १.५१.३
पोहनी : दे० सिल पोहनी। जा०म०छं०८
पोहहीं : आ०प्रब० । गुहते हैं, गुम्फित करते हैं, छेद कर प्रथित कर रहे हैं । 'जनु कोपि दिनकर कर निकर जहँ तहँ बिधुतुद पोहहीं।' मा० ६.६२ छं०
पोहिअहिं : आ०कवा०प्रब० । पोहे जाते हैं, पोहे जायँ. मालाबद्ध किये जायें। ___ 'पोहिअहिं राम चरित बर ताग । मा० १.११
पोही : पू० । पोह कर, गंथ कर । छेद कर गुम्फित कर । 'चारु चितवनि चतुर लेति चित पोही।' गी० १.१८.३
पौरि : पौरि । गी० ७.१८.१
पौ : पउ । जैसे, अपनपौ । विन० १०१.३
पौढ़ाए : भूक ०.०ब० । लिटाए, सुलाए । 'करि सिंगार पलना पौढ़ाए ।' मा० १.२०१.१
पौढि : पूकृ० । लेट (कर), शयन कर । 'नयन मीचि रहे पौढ़ि कन्हाई ।' क० १३
पौढ़िये : आ०भावा० । शयन कीजिए। 'पोढ़िये लालन पालने हौं झुलावौं ।' गी० १.१८.१
पौढ़े : भूक००ब० । शय्यासीन हुए, लेटे । पौढ़े धरि उर पद जलजाता।' मा० १.२२६.८
पौन : पवन । हनु० ८
पौरि : सं०स्त्री० (सं० प्रतोली>प्रा० पोली) । मार्ग, द्वार । 'परत पराई पौरि।' दो०६६
पौरुष : सं. (सं०) । (१) पुरुषत्व । 'धिग धिग तव पौरुष बल भ्राता।' मा० ३.१८.२ (२) पुरुषकार, पराक्रम । 'देखि राम पौरुष बल भारी ।' मा० ५.६०.७
प्याइ : पूकृ० । पिला कर । 'जे पय प्याइ पोखि कर-पंकज बार-बार चुचुकारे ।' गी० २.८७.२
प्याइहौं : आ०भ० उए । पिलाऊँगा-गी। 'चंद्रसुधा छबि नयन चकोरनि प्याइहौं ।' गी० १.४८.२
प्यारीं : प्यारी+ब० । 'बिन पहिचानि प्रानहुंते प्यारी ।' मा० १.३२२.६
प्यारी : पिआरी। 'प्रश्न तुम्हारि मोहि अति प्यारी ।' मा० ७.६५.२
प्यारे : पिआरे । 'कृपानिधान प्रान ते प्यारे।' मा० ७.४७.२
प्यारो : पिआरो। विन० १७४.४
प्यास : पिआस । मा० ६.३३ ख
प्यासे : पिआसे । कवि० ७.१४८
प्रकट : वि० (सं०) । स्पष्ट, व्यक्त । हनु० ८
प्रकार : सं०० (सं.)। (१) रोति, ढंग : 'एहि प्रकार बल मनहि देखाई ।' मा० १.१४.१ (२) शैली, वर्ग भेद । 'रचना बिबिध प्रकार ।' मा० १.१२६ (३) उपाय । 'जेहि प्रकार मोहि बरै कुमारी ।' मा० १.१३१.७
प्रकारा : प्रकार । मा० १.६.१०
प्रकाश : सं०पू० (सं.)। तेज, ज्योति । मा० ७.१०८.६
प्रकास : प्रकाश । (१) तेज+प्रभाव । 'पूरि प्रकास रहेउ तिहुँ लोका।' मा० ७.३१.२ (२) ब्यापक बोध । 'पुरुष प्रसिद्ध प्रकास निधि ।' मा० १.११६
प्रकासक : वि०पु० (सं० प्रकाशक) । (१) प्रकाशित करने वाला । (२) प्रपञ्च को प्रकट करने वाला (जिसके प्रकाश से सब प्रकाशित हैं)। 'जगत प्रकास्य प्रकासक रामू ।' मा० १.११७.७
प्रकासति : वकृ०स्त्री० । प्रकाशित करती। 'मुकुट प्रभा सब भवन प्रकासित ।' गी० ७.१७.१५
प्रकासनिधि : ज्ञान तथा प्रकाश का अधिष्ठान=सर्व प्रकाशक । 'पुरुष प्रसिद्ध प्रकास निधि ।' मा० १.११६
प्रकासरूप : प्रकाशात्मा, ज्ञानस्वरूप, सूर्यवत् जगत् का प्रकाशक । मा० १.११६.६
प्रकासा : (१) प्रकास। 'हृदयँ अनुग्रह इंदु प्रकासा ।' मा० १.१६८.७ (२) भूकृ.पुं० । प्रकट हुआ । 'अवधपुरी यह चरित प्रकासा ।' मा० १.३४.५ (३) प्रकासह । प्रकट होता है । मा० १.२०६.८
प्रकासी : भूकृ०स्त्री० । दीप्त हुई, प्रकट हुई। 'बचन नखत अवली न प्रकासी ।' मा० १.२५५.१
प्रकासु, प्रकासू : प्रकास+कए । अद्वितीय प्रकाश । मा० १.२३१.२, २.२६५.७
प्रकासे : भूकृ००। प्रकाशित होने पर । 'जिमि जल निघटत सरद प्रकासे ।' मा० २.३२५.३
प्रकास्य : वि.पु. (सं० प्रकाश्य) । प्रकाशित किया जाने वाला, अन्य के प्रकाश से प्रकाश पाने वाला । 'जगत प्रकास्य प्रकासक राम ।' मा० १.११७.७
प्रकृति : सं०स्त्री० (सं.)। (१) सांख्यदर्शन की मूल प्रकृति जो २३ तत्त्वों के परिणाम का आदिकारण है। विन० ५४.२ (२) (वैष्णव दर्शन में) माया; त्रिगुणाश्रय प्रधान तत्त्व । 'प्रकृति पार प्रभु सब उर बासी ।' मा० ७.७२.७ (३) स्वभाव । 'समुझहु छाडि प्रकति अभिमानी।' मा० ५.५७.३ ।।
प्रकृतिपर : माया से परे, त्रिगुणातीत । 'प्रकृतिपर निरबिकार श्रीराम ।' विन० २०३.६
प्रकृष्ट : वि० (सं०) । उत्तम, उत्कृष्ट, सर्वोपरि । मा० ७.१०८.६
प्रगट : (१) प्रकट । मा० २.५०.६ (२) प्रगटइ । 'कबहुंक प्रगट पतंग।' मा० ४.१५ ख
प्रगट, प्रगटइ : (सं० प्रकटति>प्रा० प्रगटइ) आ०प्रए । प्रकट होता है, प्रकाश __ में आता है। 'कबहुंक प्रगटइ कबहुं छपाई ।' मा० ३.२७.१२ (२) (सं० प्रकटयति>प्रा० पगटइ) प्रकट करता है।
प्रगटउँ : आ० उए । प्रकट करता हूं। 'अस बिचारि प्रगटउँ निज मोह।' मा० १.४६.१
प्रगटत : वक००। प्रकट होता-होते । 'सोउ प्रगटत जिमि मोल रतन तें।' मा० १.२३.८
प्रगटसि : आ०मए । तू प्रकट होती है। 'प्रिया बेगि प्रगटसि कस नाहीं।' मा० ३.३०.१५
प्रगटहिं : आ० प्रब० । प्रकट होते-ती हैं । 'प्रगटहिं दुरहिं अटन्ह पर भामिनि ।' मा०. १.३४७.४
प्रगटि : पक। (१) प्रकट होकर । 'निज तन प्रगटि प्रीति उर छाई।' मा० ४.३.५ (२) प्रकट करके । 'कछु निज महिमा प्रगटि जनाई ।' मा० १.३०६.७
प्रगटीं : भक०स्त्री०ब० । प्रकाश में आई। 'प्रगटीं.. मनि आकर बह भाँति ।' मा० १.६५
प्रगटी : भूक स्त्री० । प्रकाश में आई। 'प्रगटी धन विघटन परिपाटी।' मा० १.२३६.६
प्रगटें : प्रकट होने से । 'यह प्रगटें..'नास तुम्हार ।' मा० १.१६६.३
प्रगटे : भूकृ.पु० ब० । प्रकट हुए, आविर्भूत हुए । 'प्रगटे खल बिष बारुनी।' मा० १.१४ च
प्रगटेउ : भूक०पू०कए । प्रकट हुआ, व्यक्त रूप में आया। 'राम बिलोकत प्रगटेउ सोई ।' मा० १.१७.२
प्रगटेसि : आ०-भकृ००+प्रए० । उसने प्रकट किया=किए । 'प्रगटेसि तुरत रुचिर रितुराजा।' मा० १.८६.६
प्रगटेहु : आ०- भूक००+मब० । तुमने प्रकट किया । 'अननि, जगत जस प्रगटेहु ___ मातु पिता कर ।' पा०म०४४
प्रगटै : प्रगटहिं । प्रकाशित करते हैं, उजागर करते हैं। 'प्रगटै उपासना, दुरावै दुरबासनाहि ।' कवि० ७.११६
प्रगटै : प्रगटइ। (१) प्रकट हो जाय । 'बरु पावक पगटै ससि माहीं।' मा० १.७१.८ (२) प्रकट करे। 'गुन प्रगट अवगुनन्हि दुरावा ।' मा० ४.७.४
प्रगट् यो : प्रगटेउ । 'प्रगट्यो बिसिख प्रतापु । गी० ६.१.२
प्रगल्भ : वि० (सं०) । अवष्य; दूसरे से प्रभावित न होकर प्रभावित करने वाला। मा० ७.१०८.६
प्रघोर : वि० (सं०) । अतिधोर, अत्यन्त प्रचण्ड । 'मुष्टि प्रहार प्रघोर ।' मा०
प्रचंड : वि० (पुं०) । (१) तीव्र, असह्य या दुःसह । 'उपजा हृदये प्रचंड बिषादा।' मा० ७.५८.५ (२) अनभिभूत, दुरन्त, अदम्य । 'प्रचंड प्रकष्टं प्रगल्भं परोश ।' मा० ७.१०८.६
प्रचंडा : प्रचंड । मा० ६.४०.८
प्रचार : सं०० (सं.)। प्रसिद्धि, फैलाव, विस्तार, प्रसार । मा० १.३५ (२) संचार, प्रवेश । (३) गति, पहुँच।
प्रचारा : प्रचार। (१) प्रसार । 'सरसइ ब्रह्म बिचार प्रचारा।' मा० १.२.८ (२) संचार, प्रवेश । 'होइ न हृदय प्रबोध प्रचारा।' मा० १.५१.४
प्रचारि : पूक० । (१) पचारि । ललकार कर । 'तमके घननाद से बीर प्रचारि के।' कवि० ६.१५ (२) घोषित करके । 'सुमिरत कहत प्रचारि के बल्लभ गिरिजा को।' विन० १५२.११
प्रचारु, प्रचारू : प्रचार-+कए० । (१) फैलाव । 'दलित दसन मुख रुधिर प्रचारू ।' मा० २.१६३.५ (२) गति । 'इहाँ जथामति मोर प्रचारू।' मा० २.२८६.४
प्रचारे : भूकृ००ब० । ललकारे । 'जामवंत हनुमंत.. प्रचारे ।' गी० ६.७.४
प्रचार् यो : भूक००कए । ललकारा। 'फिरत न बारहिबार प्रचार्यो।' गी० ३.८.१
प्रचुर : वि० (सं०) । प्रभूत, पुष्कल, अधिक, अतिशय । विन० १२.५
प्रजंत : क्रि०वि० (सं० पर्यन्त>प्रा० पज्जंत)। तक । 'जोजन एक प्रजंत ।' मा० ७.११३ ख
प्रजंता : प्रजंत । मा० ७.६१.५
प्रजउ : प्रजा भी । 'परिजन प्रजउ चहिअ जस राजा।' मा० २.२५०.८
प्रजहि : प्रजा को । 'पालेहु प्रजहि करम मन बानी ।' मा० २.१५२.४
प्रजा : सं० स्त्री० [सं०) । (१) सन्तति, भूत-सृष्टि । जैसे, प्रजापति । (२) जनता । 'प्रजा पालि परिजन दुख हरहू ।' मा० २.१७६.६ (राजा के सन्दर्भ में रिाया का अर्थ है)।
प्रजापति : सृष्टि का स्वामी। (१) ब्रह्मा । (२) कोई भी उस पदवी को धारण करने वाला ! 'दच्छहि भीन्ह प्रजापति नायक ।' मा० १.६०.६
प्रजारि,  प्रजारो, प्रजारिहै, प्रजारीहै : आ०भ०प्रए । जला डालेगा। ‘काननु उजार्यो अब नगरु प्रजारिहै (प्रजारीहै)।' कवि० ५.५
प्रजारी : भूक०स्त्री० । जला दी । 'नगर फेरि पुनि पूंछ प्रजारी।' मा० ५.२५.७
प्रजार् यो : भूक०पु०कए । जला डाला । 'नगरु प्रजार्यो।' कवि० ६.२२
प्रजासन : वि० (सं० प्रजाशन) । प्रजा-भक्षक । 'द्विज श्रुति बेचक, भूप प्रजासन ।' मा०७.६८.२
प्रजेस : प्रजापति (सं० प्रजेश)। मा० १.६०.५
प्रजेस कुमारी : प्रजापति दक्ष की पुत्री-सती । मा० १.६०.१
प्रणत : वि०० (सं०) । नत, प्रणाम युक्त, शरणागत, प्रपन्न । विन० १२.५
प्रणामी : वि० (सं० प्रणामिन्) । प्रणतिशील । विन० ४०.२
प्रतच्छ : वि०+क्रि०वि० (सं० प्रत्यक्ष) । दृष्टिगोचर, आँखों के समक्ष (इन्द्रिय वेद्य) । कवि० ६.५४
प्रताप : सं०० (सं.)। (१) ऊष्मा-+तेज । 'प्रताप दिनेस से ।' कवि० ७.४३ (२) ताप+ज्योति । 'जिन्ह के जस प्रताप के आगे । ससि मलीन रबि सीतल लागे।' मा० १.२६२.२ (३) प्रभाव, गरिमा। 'राम प्रताप प्रगट एहि माहीं।' मा० १.१०.७ (४) महिमा, मान्यता । 'बेष प्रताप पूजिअहिं तेऊ ।' मा० १.७.५ (५) उत्साह, शौर्य, साहस । 'भुज प्रताप ।' मा० १.८२.५ (६) शक्ति । 'देखहु काम प्रताप ।' मा० २.२५.३ (७) कृपा, शरण । 'राम प्रताप नाथ बल तोरें।' मा० २.२६२.७
प्रतापदिनेसा : प्रतापभानु । मा० १.१६४.१
प्रतापभानु : (१) प्रतापरूपी सूर्य । (२) प्रताप में सूर्य-तुल्य । (३) एक राजा का नाम जो जन्मान्तर में रावण हुआ । मा० १.१५३.५
प्रतापरबि : प्रतापभानु । मा० १.१५३
प्रतापा : प्रताप । मा० ६.७६.१५
प्रतापी : वि०० (सं० प्रतापिन्) । (१) सन्तापदायक, तपनशील (२) प्रताप शाली (दे० प्रताप) । 'सोइ रावन जग बिदित प्रतापी ।' मा० ६.२५.८
प्रतापु, प्रतापू : प्रताप+कए । अद्वितीय प्रताप । 'जान आदि कबि नाम प्रतापू ।' मा० १.१६.५
प्रति : अव्यय (सं.)। (१) के सम्मुख, को लक्ष्य करके । तिन्ह पुनि भरद्वाज प्रति गावा।' मा० १.३०.५ (२) व्याप्त करके । 'रोम रोम प्रति राहि कोटि कोटि ब्रह्मड ।' मा० १.२०१ (३) प्रत्येक । 'प्रति संबत अस होइ अनंदा।' मा० १.४५.२ (४) पृथक्, विभक्त करके । 'प्रति अवतार कथा प्रभु केरी।' मा० १.१२४.४
प्रति उत्तर : उत्तर के बदले में उत्तर । मा० ६.२३ ङ
प्रतिफल, प्रतिफला : वि० (सं० प्रतिकूल)। (१) हिंसा या दुर्व्यवहार से पूर्ण । 'चरहिं बिस्व प्रतिकूल ।' मा० १.२७७ (२) शत्रु । 'सुवा सो लँगूल, बलमूल प्रतिकूल हबि ।' कवि० ५.७ (३) विरुद्ध । 'सो सब करहिं बेद प्रतिकूला।' मा० १.१८३.५ (४) विपक्ष, शत्रुतापूर्ण । 'सो किमि करिहि मातु प्रतिकूला।' मा० २.३८.८
प्रतिकूले : प्रतिकूला । गी० ७.१२.५
प्रतिग्या : सं०स्त्री० (सं० प्रतिज्ञा)। पंज, व्रत (प्रतिष्ठा, निष्ठा, पण)। 'प्रहलाद _प्रतिग्या राखी।' विन. ६३.३
प्रतिछाँह : प्रतिछाहीं । गी० ७.१८.१
प्रतिछाहीं : (दे० छाहीं) । प्रतिच्छाया, प्रतिबिम्ब । मा० १.३२५.३
प्रतिपच्छिन्ह : प्रतिपच्छी (सं० प्रतिपक्षिन् ) संब०। प्रतिपक्षियों, विपक्षियों+ शत्रुओं (ने) । 'सपनेहुं नहिं प्रतिपच्छिन्ह पावा।' मा० २.१०५
प्रतिपाद्य : वि० (सं०) । ग्रन्थ का प्रमुख वर्ण्य (विषय) । 'प्रभु प्रतिपाद्य राम भगवाना ।' मा० ७.६१.६
प्रतिपाल, प्रतिपालइ : (सं० प्रतिपालयति>प्रा० पडिपालइ) आप्रए.। रक्षा तथा पोषण देता है-भरण पोषण करता है (पालतू बनाता है)। 'जो प्रतिपालइ तासु हित करइ उपाय अनेक ।' मा० ६.२३ च
प्रतिपालउँ : आ०उए । भरणपोषण करता हूं। 'एहिं प्रतिपालउँ सब परिवारू । मा० २.१००.७
प्रतिपालक : वि.पु० (सं०) । सर्वथा-सर्वत्र-सर्वदा भरण पोषण करने वाला।  'भजहु प्रनत प्रतिपालक रामहि ।' मा० ७.३०.२
प्रतिपालन : सं०० (सं.)। भरण-पोषण । 'बहु बिधि प्रतिपालन प्रभु कीन्हो ।' विन० १३६.४
प्रतिपालहिं : आप्रब० । पालन करते हैं । मा० ७.१००.३
प्रतिपाला : भुकृ००। (१) पालन किया। 'प्रभु आयसु सब बिधि प्रतिपाला ।' मा० १.१४२.८ (२) सुरक्षा दिया हुआ । 'मैं सिसु प्रभु सनेहं प्रतिपाला।' मा० २.७२.३
प्रतिपालि : प्रकृ० । पालन करके। 'प्रतिपालि आयसु..... आइहौं ।' मा० २.१५१ छं०
प्रतिपाली : भक० स्त्री० । पालकर बढ़ायी, संवधित की। 'सींचि सनेह सलिल प्रति पाली।' मा० २.५६.३
प्रतिपाल्यो : भूकृ००कए । प्रतिपालन किया । 'दसरथ सौं न प्रेम प्रतिपाल्यो।' गी० ३.१२.२
प्रतिबिंब : सं०० (सं.)। (१) छाया । 'नाहिं निज प्रतिबिंब निहारी।' मा० ७.७७.८ (२) प्रतिकृति, प्रतिमूर्ति । 'निज प्रतिबिंब राखि तहँ सीता ।' मा० ३.२४.४
प्रतिबिंबनि : प्रतिबिंब+संब० । छायओं (को)। 'किलकत झुकि झांकत प्रति बिबनि ।' गी० १.३१.६
प्रतिबिंबु : प्रतिबिंब+कए। छाया। 'निज प्रतिबिंबु बरुकु गहि जाई । मा० २.४७.८
प्रतिभट : तुल्य-बल-भट, समान विपक्षी योद्धा । मा० १.१८०.३
प्रतिमा : सं०स्त्री० (सं.)। मूर्ति, कलानुकृति (प्रस्तरादिकृत)। 'सुर प्रतिमा खंभनि गढ़ि काढ़ीं । मा० १.२८८.६
प्रतिलाभ : क्रि०वि० (सं०) । प्रत्येक लाभ में, लाभ के प्रत्येक अवसर पर (उत्तरोत्तर) । जिमि प्रति लाभ लोभ अधिकाई ।' मा० १.१८०.२
प्रतिष्ठा : सं०स्त्री० (सं०) । (१) सुस्थिरता (२) दृढता (३) आधार (४) समर्थन महिमा (६) उच्च पदाधिकार (७) ख्याति, यश (८) सम्मान, समादर (8) स्थापना (१०) सीमा। पाप प्रतिष्ठा बढि परी।' दो० ४६४
प्रतीति, प्रतीती : संस्त्री० (सं० प्रतीति)। (१) विश्वास । 'असि प्रतीति तिन्ह के मन माहीं।' मा० १.३३.५ (२) प्रत्यय, प्रामाणिक बोध । 'सगुन प्रतीति भेंट प्रिय केरी ।' मा० २.७.६ (३) भ्रम । 'निबुकि गयउ तेहि मृतक प्रतीती।' मा० ६.६६.५
प्रतोषीं : भूक०स्त्री०ब० । सर्वथा सन्तुष्ट की। 'राम प्रतोषी मातु सब।' मा० १.३५७
प्रत्यूह : सं०पु० (सं०) । विघ्न । मा० ७.११८ ख
प्रथम : वि०+क्रि०वि० (सं०) । (१) पहले । 'प्रथम बसीठ पठउ। मा० ६.६.१० (२) पहला । 'दादुर मोर पीन भए पावस प्रथम ।' मा० २.२५१
प्रथमहि : (१) प्रथम स्थान पर । 'प्रथमहिं बिप्र चरन अति प्रीती।' मा० ३.१६.६ (२) पहले ही, पूर्व ही। 'प्रथमहिं देवन्ह गिरिगुहा राखेउ रुचिर बनाइ।' मा० ४.१२
प्रद : (समासान्त में) वि०पू० (सं.)। देने वाला । 'सकल काम प्रद तीरथराऊ।' मा० २.२०४.६
प्रदच्छिन : (१) परदखिना। मा० ४.२६ (२) क्रि०वि० । दक्षिणावर्त परिक्रमा करके । 'कीन्ह प्रनामु प्रदच्छिन जाई ।' मा० २.१६६.१
प्रदच्छिना : परदखिना (सं० प्रदक्षिणा) । 'दै दै प्रदच्छिना करति प्रनाम ।' गी० ३.१७.८
प्रदा : प्रद+स्त्री० (सं०) । देने वाली । मा० २ श्लोक २
प्रदेश : सं०० (सं०) । (१) स्थल, भू-भाग, क्षेत्र। (२) शरीर भाग, अङ्ग। __मणि मेखल कटि-प्रदेशं ।' विन० ६१६
प्रवेस : प्रदेश । मा० २.१०५.४
प्रदोष : सं०+वि०० (सं.)। (१) सायंकाल, निशामुख (रात्रि का प्रथम प्रहर)। (२) अतिशय-दोष-युक्त । 'जातुधान प्रदोष बल पाई ।' मा० ६.४६.४
प्रधान : (१) वि०० (सं.)। मुख्य प्रभावक । 'करम प्रधान सत्य कह लोग ।' मा० २.६१.८ (२) माया, प्रकृति-दे० परधान ।
प्रधाना : प्रधान । मा० २.१३३.६
प्रध्वंसन : वि०० (सं.) । पूर्णतया विनाशकारी । मा० ४ श्लोक २
प्रनत : प्रणत । 'सोइ रघुबीर प्रनव अनुरागी।' मा० ६.७.५
प्रनतनि : प्रनत+संब० । प्रणतजनों। 'सरनागत आरत प्रनतनि को दै दै अभयपद ओर निबाहैं ।' गी० ७.१३.६
प्रनतपाल : वि०पू० । प्रणत जनों का रक्षक । मा० ६.१०२.४
प्रनतपालु : प्रनतपाल+कए० । एकमात्र प्रणत रक्षक । 'प्रनतपाल पालि हि सब काहू ।' मा० २.३१४.४
प्रनतारति : (प्रनत+आरति)। प्रणत जनों के क्लेश। 'सब बिधि तुम्ह प्रनतारति हारी।' मा० ७.४७.३
प्रनति : सं० स्त्री० (सं० प्रणति) । प्रणाम, प्रार्थना । गी० ३.१७.८
प्रनमामि : आ० उए. (सं० प्रणमामि) । प्रणाम करता हूं। मा० ७.१४ छं, १०
प्रनय : सं०० (सं० प्रणय)। (१) आत्मीयता, ममत्व (२) परस्पर आसक्ति (३) प्रार्थना (४) विश्वासपूर्वक अनुराग (५) कृपाभाव । 'प्रीति प्रनय बिनु... नासहिं ।' मा० ३.२१.११
प्रनवउँ : प्रनमामि (अ० प्रणवउँ) । 'पुनि प्रनवउँ पृथुराज समाना।' मा० १.४.६
प्रनाम, प्रनामा : सं०पू० (सं० प्रणाम) नमस्कार । मा० १.२.४
प्रनामु, प्रनामू : प्रनाम---कए । नमस्कारमात्र । 'कोन्ह प्रनाम तुम्हारिहिं नाई।' मा० १.५६.२
प्रपंच : सं०० (सं०) । (१) विस्तार-छल प्रपंच । 'कीन्हेसि पुनि प्रपंच बिधि नाना ।' मा० १.१२६.६ (२) उलझाने वाला आडम्बर या वारजाल । मोहि न बहुत प्रपंच सोहाहीं।' मा० २.३३.६ (३) सृष्टि विस्तार । 'बिधि प्रपंच महं सुना न दीसा ।' मा० २.२३०.८ (४) माया, सम्पूर्ण प्राकृत तत्त्वमय विश्व । 'परमारथी प्रपंच बियोगी।' मा० २.६३.३ (५) जगत् की सृष्टि के आधारभूत पंच महाभूतों की रचना पञ्चीकृत सूक्ष्मभूतों से होती है जिसमें प्रत्येक भत का अपना आधा और शेष चार का आठवां-आठवाँ भाग मिश्रित रहता है। इस प्रकार प्रपञ्च पञ्चभूतों का मिश्रण होने से जटिल है। इसी प्रकार की जटिल प्रक्रिया, छलना या आडम्बर को प्रपञ्च कहा गया है। उक्त दोनों अर्थ एक साथ द्रष्टव्य हैं-रचहु प्रपंचहि पंच मिलि ।' मा० २.२९४ अर्थात् जिस प्रकार पाँच तत्त्वों से प्रपञ्च की सृष्टि होती है उसी प्रकार पाँच मखिया मिल कर छल प्रपञ्च की रचना करो।
प्रपंचमय : विश्व सृष्टि का विस्तार +छलनापूर्ण । 'पारद प्रगट प्रपंचमय ।' दो० २६०
प्रपंची : वि०पू० (सं० प्रपञ्चिन्) । जालिया, छलिया (प्रपञ्च के कर्ता-धर्ता)। ___ 'हरिहि कहहिं प्रपंची लोग ।' दो० ४१८
प्रपंचु : प्रपंच+कए । (१) एकीभूत (पञ्चीकृत) सृष्टि प्रसार । 'बिधि प्रपंचु गुन अवगुन साना ।' मा० १.६.४ (२) छद्म-जाल+मायाजाल । 'रचि प्रपंच भूपहि अपनाई ।' मा० २.१८.६
प्रपुंज : (दे० पुंज) । झुण्ड के झुण्ड । 'चले प्रपुच चंचरीकीग०।' १.३८.४
प्रफुलित : प्रफुल्लित । बर० २६
प्रफुल्ल : वि० भूकृ० (सं.)। पूर्ण-विकसित । 'प्रफुल्ल कंज लोचनं ।' मा० ३.४.४
प्रफुल्लित : प्रफुल्ल । 'पुलक प्रफुल्लित गात ।' मा० १.१४५
प्रबंध : सं०० (सं.)। (१) बन्धान, शैली, रीति । 'छंद प्रबंध अनेक बिधाना।' मा० १.६.६ (२) प्रबन्ध काव्य । 'जो प्रबंध बुध नहिं आदरहीं।' मा० १.१४.८ (३) जलाशय का बांध+प्रकरण, काण्ड । 'सप्त प्रबंध सुभग सोपाना।' मा० १.३७.१
प्रबरषन : सं.पुं० (सं० प्रवर्षण)। दण्डकवन में एक पर्वत। मा० ७.६६ ख
प्रबल : वि० (सं०) । अति बलशाली, दुर्दम, दुन्ति, दुरतिक्रम, समर्थ । मा० १.१४०
प्रबलता : सं०स्त्री० (सं.)। शक्तिमत्ता । मा० १.१३७
प्रबाहँ : प्रवाह में । 'भव प्रबाहें संतत हम परे।' मा० ६.११०.१२
प्रबाह : सं०० (सं० प्रवाह) । धारा का बहाव । मा० १.३४०.६
प्रबाहू : प्रबाह+कए । एकीभूत धारा । 'उमगेउ प्रेम प्रमोद प्रबाहू ।' मा० १.३६.१०
प्रविसति : वकृ०स्त्री० (सं० प्रविशन्ती) । प्रवेश करती। केहि मग प्रबिसति छाहँ।' दो० २४४
प्रबिसहिं : आ०प्रब० (सं० प्रविशन्ति>प्रा० पविसंति>अ० प्रविसहिं)। प्रवेश करते हैं; भीतर जाते हैं, घुसते हैं । 'एक प्रबिसहिं एक निर्गमहिं।' मा० २.२३
प्रबिसि : पक० । प्रवेश करके । 'प्रबिसि नगर कीजे सब काजा।' मा० ५.५.१
प्रबिसे : भूकृ.पुब० । प्रविष्ट हुए, घुसे । 'पुनि रघुबीर निषंग महुं प्रबिसे सब नाराच ।' मा० ६.६८
प्रबिसेउ : भूकृ००कए० । प्रविष्ट हुआ। 'राम सर प्रबिसे उ आइ निषंग।' मा० ६.१३ ख
प्रवीन, प्रवीना : वि० (सं० प्रवीण)। कुशल, दक्ष, विदग्ध, निपुण । 'जे असिकला प्रबीन ।' मा० १.२६८ १.५४.६
प्रबीनता : सं०स्त्री० (सं० प्रवीणता) । दक्षता, कौशल । पा०म०छं० १
प्रबीनू : प्रबीन+कए । जरा भी प्रवीण । कबि न होउँ नहिं बचन प्रबीन ।' मा० १.६.८
प्रबेस : (१) सं०० (सं० प्रवेश) । अन्तर्गमन, घुसना, भीतर जाना। ‘करत प्रबेस __ मिटे दुख दावा ।' मा० २.२३६.३ (२) आरम्भ । 'निसि प्रबेस मुनि आयसु दीन्हा ।' मा० १.२२६.१ (३) पहुंच, पैठ, अवगति । 'परमारथ न प्रबेस ।' दो० १७
प्रबेसा : प्रबेस । मा० ६.४५.७
प्रबेसु : प्रबेस+कए । 'निज पुर कीन्ह प्रबेसु ।' मा० १.१५४
प्रबोध : सं०० (सं.)। (१) जागरण (२) उद्भव (३) सजगता (४) ज्ञान, प्रतीति (५) मानसिक स्थिरता, धृति । 'मोरें मन प्रबोध जेहिं होई ।' मा० १.३१.२ (६) आश्वासन । 'होइ न हृदय प्रबोध प्रचारा।' मा० १.५१.४ (७) प्रबोध ।
प्रबोध,  प्रबोधइ : आ०ए० (सं० प्रबोधपति)। प्रबोध =ज्ञान या जागरण देता है; समझाता है । गुर नित मोहि प्रबोध ।' मा० ७.१०५ ख
प्रबोधक : वि० (सं.)। (१) जगाने वाला (२) ज्ञान देने वाला= समझाने वाला । 'उभय प्रबोधक चतुर दुभाषी ।' मा० १.२१.८
प्रबोधन : भक० अव्यय । प्रबोध देने, समझाने । 'लगे प्रबोधन जानकिहि ।' मा० २.६० .
प्रबोधहि : प्रबोध को, आश्वासन को। ‘रहे प्रबोधहि पाइ।' मा० १.७३
प्रबोधा : (१) प्रगेध । 'बहु बिधि जननीं कीन्ह प्रबोधा।' मा० १.६३.८ (२) भूकृ०० । प्रबोध दिया, आश्वस्त किया, समझाया। 'प्रभु तब मोहि बहु भाति प्रबोधा।' मा० १.१०६.६
प्रबोधि : पूक० । प्रबोध देकर, समझाकर । 'ताहि प्रबोधि बहुत सुख दीन्हा ।' मा० ७.१०.२
प्रबोधिसि : आo-भूक स्त्री०+प्रए। उसने आश्वस्त की। 'धीरजु धरहु प्रबोधिसि रानी ।' मा० २.२०.३
प्रबोधीं : भूक स्त्री०ब० । समझायौं, आश्वस्त की। 'कहि गुन राम प्रबोधी रानी।' मा० २.३०६.७
प्रबोधी : (१) प्रबोधि । सजग करके । 'रावनहि प्रबोधी 'नाघेउ।' मा० ७.६७.५ (२) भूकृ०स्त्री० । समझाई (हुई)। 'कुटिल प्रबोधी कबरी।' मा० २.५०
प्रबोधु, प्रबोधू : प्रबोध-+कए । (१) विवेक, सूझबूझ, सजगता । 'बैर अंध, प्रेमहि न प्रबोधू ।' मा० २.२६३.८ (२) आश्वासन, शमन । 'करसि हमार प्रबोध ।' मा० १.२८० (३) प्रत्यय । कीन्हेसि कपट प्रबोधु ।' मा० २.१८
प्रबोधे : भूकृ००ब० । समझाए । “सचिव सुसेवक भरत प्रबोधे ।' मा० २.३२३.१
प्रभंजन : सं०० (सं.)। वायु । मा० ६.११५.२
प्रभंजनजाया : (दे० जाया) वायुपुत्र हनुमान् । मा० ५.१६.६
प्रभंजनसुत : हनुमान् । मा० ६.५६.१
प्रभा : संस्त्री० [सं०) । कान्ति, दीप्ति, चमक । मा० २.६७.६ .
प्रभाउ, प्रभाऊ : प्रभाव+कए० । 'तब आपन प्रभाउ बिस्तारा।' मा० १.८४.५ :
प्रभाकर : सं०० (सं.)। सूर्य । गी० १.६७.१
प्रभात : सं०० (सं.)। सबेरा, सूर्योदय-काल ।
प्रभाता : प्रभात । मा० ६.६०.५
प्रभाय : प्रभाव । प्रताप । 'सील सोभा सागर प्रभाकर प्रभाय के ।' गी० १.६७.१
प्रभावँ : प्रभाव से । 'तव प्रभाव बड़वानल हि जारि सकइ खलु तूल ।' मा० ५.३३
प्रभाव : सं०० (सं.)। (१) प्रताप-दे० प्रभाय । (२) शक्ति, योग्यता । प्रतिष्ठा, महिमा । 'राम प्रभाव बिचारि बहोरी।' मा० ६.६०.८ (३) प्रभुता, ऐश्वर्य । 'देखेउँ सो प्रभाव कछ नाहीं।' मा० ७.५८.८
प्रभावा : प्रभाव । मा० १.४६.२
प्रभु : सं+वि० (सं.)। (१) सर्वेश्वर, परमात्मा (राम)। 'सब जानत प्रभु प्रभुता सोई ।' मा० १.१३.१ (२) समर्थ, सर्वशक्तिमान् । 'मसकहि करह बिरंचि प्रभु, अजहि मसकते हीन ।' मा० ७.१२२ ख (३) सम्मान्य, श्रेष्ठ । 'मोरें मन प्रभु अस बिस्वासा।' मा० ७.१२०.१६ (४) स्वामी, सेव्य (राजा, आराध्य आदि) । 'सेवक प्रभुहि परै जनि भोरें ।' मा० ४.३.१
प्रभुता : सं०स्त्री० (सं.) । प्रभाव, महिमा, ऐश्वर्य, शक्ति । मा० १.१३.१
प्रभुताई : प्रभुता। मा० ७.६०.६
प्रभुनि, प्रभुन्ह : प्रभु+संब० । प्रभुओं-बड़ों, शक्तिमानों। 'नाथ प्रभुन्ह कर सहज सुभाऊ ।' मा० १.८६.३
प्रभुमय : वि० (सं०) । (१) प्रभु से व्याप्त (२) ईश्वर स्वरूप । 'निज प्रभुमय देहि जगत ।' मा० ७.११२ ख
प्रभू : प्रभु । विन० ६५.२
प्रभो : प्रभु+संबोधन (सं०) । हे प्रभु । मा० ६.१०३ छं० १
प्रमथ : सं.पु० (सं०) । शिवगण-विशेष । मा० ६.८८.१
प्रमथनाथ : शिव । 'प्रमथनाथ के साथ प्रमथ गन राजहिं ।' पा०म०६८
प्रमथराज : शिव । विन० १३.५ प्रमथाधिप
प्रमथाधिपति : शिव । विन० ११.१
प्रमदा : सं० स्त्री० (सं०) । यौवनमद से पूर्ण स्त्री युवती । मा० ३.४४
प्रमादू : प्रमाद+कए । असावधानी। 'तात किएँ प्रिय प्रेम प्रमादू। जसु जग जाइ होइ अपबाद।' मा० २.७७.४ ।
प्रमान, प्रमाना : सं०पू०+वि० (सं० प्रमाण)। (१) प्रामाणिक सत्यापन । तासु श्राप हरि दीन्ह प्रमाना।' मा० १.१२४.१ (२) परिमाण, नाप । 'सत जोजन प्रमान ले धावौं ।' मा० १.२५३.८ (३) यथार्थ, संगत, उचित । 'बोले गिरा प्रमान ।' मा० १.२५२ (४) सत्यापित, प्रमाणित । 'करि पितु बचन प्रमान ।' मा० २.५३ (५) मात्रानुसार, अनुपात के अनुसार। होइ सुफल....."प्रीति प्रतीति प्रमान ।' रा०प्र० ७.५.३ (६) बोध के साधनों को प्रमाण कहते हैं जिनकी सर्वमान्य संख्या तीन है- (क) प्रत्यक्ष प्रमाण = इन्द्रिय (ख) अनुमान (ग) शब्द प्रमाण = आगम ।
प्रमानिक : वि० (सं० प्रमाणिक) । अधिकारी जिसकी बात प्रमाण हो, आप्त । ____ 'बूढो बड़ो प्रमानिक ब्राह्मण ।' गी० १.१७.२
प्रमुख : वि० (सं०) । (१) मुख्य, श्रेष्ठ । (२) (समासान्त में) इत्यादि । 'नारद प्रमुख ब्रह्मचारी ।' विन० ११.६
प्रमुदित : वि० (सं०) । प्रसन्न । मा० १.३१२.४
प्रमोद : सं०० (सं.)। प्रसन्नता, विनोद, हर्ष । मा० १.३६.१०
प्रमोदु : प्रमोद+कए । 'प्रेम प्रमोदु न कछु कहि जाई।' मा० १.३२१
प्रयच्छ : आ०-प्रार्थना-मए० (सं.)। तू प्रदान कर । मा० ५ श्लो० २
प्रयांति : आ० प्रब० (सं० प्रयान्ति)। प्राप्त करते हैं । मा० ३.४ छं०
प्रयाग : सं०० (सं.)। उत्कृष्ट यज्ञों का तीर्थ =गङ्गा-यमुना संगमतीर्थ= तीर्थराज । मा० १.२
प्रयागा : प्रयाग । मा० १.४४.१
प्रयागु : प्रयाग+कए० । 'बिधि बस सुलभ प्रयागु ।' मा० २.२२३
प्रयान : सं०पू० (सं० प्रयाण) । अभियान, आक्रमण हेत यात्रा या चढ़ाई । मा० ५.३५ छं० २
प्रयास : सं०० (सं.)। श्रमयुक्त प्रयत्न । मा० ६.१०६ छं०
प्रयासा : प्रयास | मा० ७.४.६
प्रयोजन : सं०० (सं०) । साध्य (फल), प्राप्य । 'हरि तजि किमपि प्रयोजन नाहीं।' मा० १.१६२.१
प्रलंब : वि० (सं०) । अतिदीर्घ, विशाल । 'भज प्रलंब ।' मा० १.१०६.६
प्रलय : सं०० (सं.)। (१) संहार (२) सष्टि की मलकारण में विलय की अवस्था । मा० १.१६३.६
प्रलाप : सं०० (सं.)। असंगत आलाप, निरर्थक वार्ता, भावावेश की बकवास । 'एहि बिधि करत प्रलाप कलापा।' मा० २.८६.७
प्रलापी : वि.पुं० (सं० प्रलापिन्) । बकवादी, बकवास करने वाला। 'अलीक प्रलापी।' मा० ६.२५.८
प्रवर : वि० (सं०) । श्रेष्ठ, उत्तम । विन० १०.५
प्रवान, प्रवाना : प्रमान । (१) शब्दप्रमाण। 'कहा जो प्रभु प्रवान पुनि सोई।' मा० १.१५०.७ (२) सत्यापित, प्रमाणित (पालित) | 'करि प्रवान पितु बानी।' मा० २.६२.१ (३) सत्यापना (यथार्थ) । 'सुनि सपथ प्रवान ।' मा० २.२३० (४) मात्रा, परिमाण, नाप । 'तिल प्रवान करि काटि निवारे ।' मा० ६.८३.४ (५) मान्य । 'कीन्ह आपु प्रिय प्रेम प्रवाना ।' मा० २.२६२.३
प्रवृत्ति : संस्त्री० (सं.)। कर्म, विषयानुरक्ति (निवृत्ति का विलोम) । विन० ५८.२
प्रसंग : सं०० (सं०)। (१) साहचर्य, साथ, सहयोग । 'अगरु प्रसंग सुगंध बसाई।' मा० १.१०.६ (२) सन्दर्भ, प्रकरण । 'अब सोइ कहउँ प्रसंग सब ।' मा० १.३५ (३) कथ्य विषय । 'यह प्रसंग मोहि कहहु पुरारी।' मा० १.१२४.८ (४) अवसर । तेहिं प्रसंग सहजेहिं बस देवा ।' मा० १.१६६.२ (५) वार्तालाप । 'चलेहु प्रसंग दुराएहु ।' मा० १.१२७.८
प्रसंगा : प्रसंग । मा० १.७.६
प्रसंगु, प्रसंगू : प्रसंग+कए । मा० १.८७, २.२११.७
प्रसंन : प्रसन्न । कवि० ५.२८
प्रसंस, प्रसंसह : (सं० प्रशंसते>प्रा० पसंसइ>अ० प्रसंसइ) आ०प्रए । प्रशंसा करता है, गुणकीर्तन करता है । 'मुनि रघुबरहि प्रसंस ।' मा० २.६
प्रसंसक : वि. (सं० प्रशंसक)। प्रशंसाकारी, प्रशस्तिपर्ण । 'बंस प्रसंसक बिरद सुनावहिं ।' मा० १.३१६.६
प्रसंसत : वकृ० । प्रशंसा करता-ते । पल कि प्रसंसत राउ विदेह' मा० २.३०६.३
प्रसंसन : भकृ० अव्यय (सं० प्रशंसितम् >प्रा० पसंसिउं>अ. प्रसंसण)। प्रशंसा करने । 'बरषि प्रसून प्रसंसन लागे ।' मा० २.२४१.८
प्रसंसहि, प्रसंसहीं : आ०प्रब० (सं० प्रशंसन्ते>प्रा० पसंसंति>अ० प्रसंसहिं) । प्रशस्ति करते हैं । 'संतत संत प्रसंसहिं तेही।' मा० १.८४.२ ।।
प्रसंसा : (१) संस्त्री० (सं० प्रशंसा>प्रा० पसंसा>अ० प्रसंसा)। प्रशस्ति, स्तुति (निन्दा का विलोम), गुण-कीर्तन । मा० १.८८.६ (२) व्याज निन्दा या ध्याजस्तृति । 'जब न उठइ तब करहिं प्रसंसा ।' मा० ६.७६.२ (३) प्रसंसइ। स्तुति करता है । 'सगुन अगुन जोह निगम प्रसंसा।' मा० १.१४६.५
प्रसंति : प्रकृ० । प्रशंसा करके । 'मुनिहि प्रसंसि हरिहि सिरु नावा ।' मा० १.१२७.४
प्रसंसिहैं : आ०भ०प्रब० । स्तुति करेगे। 'प्रसंसिहैं मुनिगन ।' गी० ५.५०.३
प्रसंसी : (१) प्रसंसि । 'कहउँ सुभाउ न कुलहि प्रसंसी।' मा० १.२८४.४ (२) भूक०स्त्री० । प्रशस्य कही। 'भरत बिनय सुनि सबहिं प्रसंसी।' मा० २.३१४.८
प्रसंसेउ : भकृ००कए । प्रशंसित किया। 'नप बहु भांति प्रसंसेउ ताही।' मा० १.१६०.२
