_______________________________________________
311 
in 

Vछ, छअइ : (सं० छुपति-छुप स्पर्श>प्रा० छुअइ छुवइ) आ०प्रए० । छूता  है, छुती है। दे० छुऐ ।
छअत : वक०० (सं० छुपत्>प्रा० छुअंत)। छूता, छूतेः छूते ही । 'छुमत टूट  रघुपतिहि न दोषू ।' मा० १.२७२.३
छुप्रतहि : छूते ही। 'छुअतहिं टूट पिनाक पुराना।' मा० १.२८३.८
छअति : वक०स्त्री० । स्पर्श करती। 'कहै काह, छलि छुअति न छांही।' मा०  २.२८८.५. . . .
छुप्रा : भूकृ०० (सं० छुप्त>प्रा० छुविअछुइअ)। स्पर्श किया। रावन बान  छुआ नहिं चापा।' मा० १.२५६.३
छइ : पूकृ० छकर । 'जासु छाँह छुइ लेइस सींचा।' मा० २.१६४.३
छएँ : छू जाने से । 'जा की छाँह छुएं सहमत व्याध बाधको।' कवि ७.६८ छु
ए : भूक०० ब० । स्पर्श किए हुए । 'जनक बचन छुए बिरवा लजारू कैसे बीर ____रहे सकल सकुचि सिर नाइ के ।' गी० १.८४.६
छऐ : छु अइ । रा०न० १३
छौ : आ०मब० (सं० छुपत>प्रा० छुअह> अ० छुअहु) स्पर्श करो। 'छुओ माथे  हाथ अमी के ।' गी० १.१२.३ 
/छट, छटइ : (सं० छुटति-छुटछेदे>प्रा. छुट्टइ-छूटना, मुक्त होना, बन्धन  हटना) आप्रए ० । छुटता-ती है । 'छुट न बिपति भजे बिनु रघुपति ।' विन०  ८७.४
छटकाये : छडाने से । 'डरपति जननि पानि छटकाये।' गी० १.३२.५
छटि : पू०० । विच्छिन्न हो (कर) । 'छ टि जाइहि तव ध्यान ।' मा० ६.६६
छटिहहिं : आ०भ०प्रब० । छूटेंगे, मुक्त हो चलेंगे। 'छ टिहहिं अति कराल बहु  सायक ।' मा० ६.२७.६
छुटिहि : आ०म०ए० ! छूटेगा-गी। 'मोह शृंखला छुटिहि तुम्हारे छोरे ।' विन०  ११४.५
छुड़ाई : पूकृ० (सं० छोटयित्वा>प्रा० छुड़ाविअ>अ० छुड़ावि) । छुड़ा कर । . 'लियो छुड़ाइ चले कर मी जत ।' विन० २४१.२
छद्धित : छुधित । मा० १.१५७
छद् : वि० (सं० क्षुद्र) । तुच्छ, निःसार, अल्प, लघु, अधम । मा० ३.२८.१५
छत्रा : सं०स्त्री० (सं० क्षुध) । बुभुक्षा, भूख । मा० ७.१०२ ई०
छुधावंत : वि.पु । भूखा, भूखे । मा० ६.४०.३
छधित : भूकृ.पु (सं० क्षुधित) । बुभुक्षित, भूखे । मा० २.२३५.२  " 
312 
_______________________________________________
छुभित : भूकृ०वि० (सं० क्षुभित) । विचलित उत्तरङ्गित । 'छुभित पयोधि कुधर __ डगमगहीं।' मा० ६.७९.६
छुरा : सं०० (सं० छुर, क्षुर)। चाकू, कटार । 'मेल गरे छुरा धार सों।' कवि० 
छुरी : सं०स्त्री (सं० क्षुरिका, छुरिका) । कटार, कतरनी, चाकू । 'कपट छरी उर  पाहन टेई ।' मा० २.२२.१
छुवत : छुअत । 'सिला छोर छुवत अहल्या भई दिब्य देह ।' गी० १.६७.३
छुवन : भकृ० (सं० छोटतुम् >प्रा० छुविउं>अ० छुवण) । छूने (को)। 'मन के  करन चाहैं चरन छुवन ।' गी० ५.४८.२
छुहे : वि०पू० (सं० सुधित= सुधालिप्त>प्रा० छुहिम लिप्त) ब० । रोचना __ आदि के लेप से युक्त । 'छुहे पुरट घर सहज सुहाए।' मा० १.३४६.६
छूछा : छूछा । वि.पु०ए० (सं० तुच्छ>प्रा० छुच्छ) । सार शून्य, सूना, रिक्त ।  'प्रेम भरा मन निज गति छछा।' मा० २.२४२.७
छछी : छूछा-+स्त्री० । 'बोली असुभ भरी सुभ छुछी।' मा० २.३८.८
छूछे : रिक्त में, अभाव में, शून्य में । 'परेउ मनोरथु छूछे ।' मा० २.३२.२
छूछे : छूछा+ब० । रिक्त, सार शून्य । 'सब छूछे के के छोडि गो।' कवि० ६.२४  छूछा+कए । निस्सार । 'कह्यो है पछोरन छूछो ।' कृ० ४३
ट : (१) छूटइ । 'हठ न छूट छूट बरु देहा ।' मा० १.८०.५  (२) भूकृ.पु । छूटा हुआ, मुक्त । 'छूट जानि बन गवनु सुनि उर अनंदु  आंधकान ।' मा० १.५१ 
Vछट, छुटइ : (१) सं० छुटति ~छुट छेदे>प्रा० छुट्टइ-विच्छिन्न होना;  (२) सं० क्षोटति-क्षोट क्षये>प्रा० छुट्टइ-क्षीण या समाप्त होना) आ० प्रए० । (१) समाप्त होता है । 'छूटइ मल किमलहि के धोएँ ।' मा० ७.४६.३ (२) विछिन्न होता-ती-है। 'छुटइ राम करहु जब दाया।' मा० ४.२१.२४  (३) मुक्त तीव्र गति लेता है । 'छूटइ पबि परबत कहुं जैसें ।' मा० ३.२६.८
छुटउ : आ०-- आशंसा, कामना--प्रए० (सं० छुटतु>छुट्टउ) । छूटे, समाप्त हो ।  'छुट उ बेगि देह यह मोरी।' मा० १.५६.७
छटत : वकृ००। (१) छूटत, छूटते । 'अति मचत छूटत कुटिल कच।' गी०  ७.१६.४ (२) छूटते हुए (छूटने में) । 'जदपि मृषा छूटत कठिनई ।' मा०  ७.११७.४
छूटति : छुटत+स्त्री० । छूटती । 'छूटति छोड़ाए तें।' विन ० २४६.३
छटहिं : आ०प्रब० । (१) भङ्ग हो जाते हैं । छूटहि मुनि ध्याना।' मा० १.६१.४  (२) त्यक्त या समाप्त होते हैं। 'जासु कृपा छूटहिं मद मोहा ।' मा०  तुलसा शब्द-कोश 
313 
४.१८.६ (३) मुक्त होते हैं । 'भव बंधन ते छूटहिं ।' मा० ७.५८ (४) खुलतें 
हैं । 'छूटहिं भव पासा।' मा० ७.१२६.१
छुटि : (१) छूटी । भङ्ग हुई। 'छुटि समाधि संभु तब जागे।' मा० १.८७.३  (२) खुल गयी। 'मनि गिरि गई छूटि जनु गांठी ।' मा० १.१३५.५ (३) पूक । मुक्त होकर, छूट कर । 'चलि हैं छूटि पुज पापिन के ।' विन०  छू
टिबे : भ००० । छूटने । 'छुटिबे के जतन बिसेष बांधो जाय गो।' विन  ६८.४
छटी : छूटी+ब० । छोड़ी गयीं । 'कुसुमांजलि छूटी।' मा० १.२६५.५
छुटी : भूक०स्त्री०ए० । (१) समाप्त हुई । 'छूटी त्रिबिधि ईषना गाढ़ी।' मा  ७.११०.१३ (२) बच रही । 'रत्यो रची बिधि जो छोलत छबि छूटी।' गी०  २.२१.१
छटे : भूक पुब०। (१) खुले। 'मुक्त भए छुटे भव बंधन ।' मा० ६.११४.७  (२) बन्धन से विमुक्त हुए । 'छूटे कच नहिं देह संभारा।' मा० ६ १०४.३ (३) मुक्त होकर तीव्रता से चले। 'छुटे तीर सरीर समाने ।' मा० ६.७०.७ (४) छूटइ। समाप्त हो जाती है। जैसें दिवस दीप छबि छूटे।' मा०  १.२६३.५
छूट : छूट इ । (१) समाप्त हो सकता है, व्यक्त हो जाय । 'हठ न छूट छूट बरु  देहा ।' मा० १.८०.५ (२) खुल मकता-ती-है । 'अभ्यंतर ग्रंथि न छूट ।' विन०  ११५.१
छट्यो : भूकृ.पु०प्रए । छूट गया, समाप्त हो गया । 'सतु सब को छुट्यो।' कवि० 
छति : सं०स्त्री० (सं० छुप्ति>प्रा० छुत्ति) । अस्पृश्यता, अशुद्धि । 'करतब छल  छुति ।' दो० ४११
छेका : भूक०० । घेर लिया । ‘गुढ़ पुनि छेका आइ ।' मा० ६.४६
छेकी : भकृ. स्त्री०। (१) रुद्ध कर दी, रोक दी। 'सो गोसाइँ बिधि गति जेहिं  छेकी ।' मा० २.२५५.८ (२) रोकी हुई । 'तनु तजि रहति छांह किपि छेको।'  मा० २.६७.५
छेत्र : संपु०कए० (सं० क्षेत्रम्>प्रा० छेत्तं>अ० छेत्र)। (१) रक्ष क्षेत्र  (२) तीर्थ स्थल (३) भू-भाग । 'छेत्रु अगम गढ़ गाढ़ सुहावा।' मा० २.१०५.५
छेदन : सं० पु. (सं.)। काटना । 'भव खेद छेदन दच्छ ।' मा० ७.१३ छं० २
छेदनिहारा : वि०पू०। काटने वाला। 'सहसबाहु भुज छेदनिहारा।' मा०  १.२७२.८ 
314 
सुलसी शब्दकोश 
छेदे : भूक००ब० (सं० छेदित) । काट डाले । 'एक एक सर सिर निकर छेदे ।'  मा० ६.६२ छं०
छम : सं०पु० (सं० क्षेम)। (१) शुभ, कल्याण । 'छेमकरी कह छेय बिसेषो।' . मा० १.३०३.७ (२) योग-क्षेम' के युग्म में क्षेम का अर्थ 'प्राप्त वस्तु की रक्षा'  होता है । 'जोग जाय बिनु छेम ।' दो० १०३
छेमकरी : संस्त्री० (सं० क्षेमकरी) । मङ्गल सचक लाल रङ्ग की, चमकीली चील  (जिसका उत्तम वर्णन कवि० ७.१८० में हुआ है)। 'छेमकरी कह छेम  बिसेषी।' मा० १.३०३.७
छेमा : छेम । मा० ७.६५.६
छेरी : सं०स्त्री० (सं छेली, छेलिका, छगली)। बकरी । कवि० ५.६
छया : सं० । छौना, दुलारा शिशु । 'छगन छबीले छोटे छया।' गी० १.२०.२
छल : छ्यल । कवि० ६३२
छहै : आ०भ०प्रए । छा जाएगा, व्याप्त होगा । 'नभ तल बिमल बिमाननि छहै ।'  गी० ५.५०.३
छोट : वि.पु । छोटा, ह्रस्व, लघु । मा० १.२१.३
छोटाई : सं०स्त्री० । छुटपना, लघुता । विन० २६२.१
छोटि : छोटी । 'आपु छोटि महिमा बड़ि जानी ।' मा० २.३०३.७
छोटिए : छोटी ही । 'छोटिऐक छोटी कटि, छोटिए तरकसी।' गी० १.४४.१
छोटी : वि०स्त्री० । कवि० ७.१८
छोटे : 'छोट' का रूपान्तर । 'छोटे बदन कहउँ बडि बाता।' मा० २.२६३.६
छोटेउ : छोटे भी। 'छोटे उ बाढ़े।' कवि० ७.१२७
छोटो : छोट+कए० । एकमात्र छोटा । 'राम सों बड़ो है कोन, मो सों कौन  छोटो!' विन० ७२.२
छोड़ : आ० उए । छोड़ता हूं। बचा देता हूं। 'उतर देत छोड़उं बिनु मारें।'  मा० १.२७५७
छोड़ति : वक०स्त्री० । छोड़ती, मुक्त करती। 'छोड़ति छोड़ाये तें गहाये तें गहति ।'  विन० २४६.३
छोड़ाई : छड़ाई । छुड़ा, मुक्त करा। 'दया लागि बलि दीन्ह छोड़ाई ।' मा०  ६.२३.१४
छोड़ाए : भूक००० । मुक्त कराये । 'दया लागि हसि तुरत छोड़ाए।' मा०  ५.५२.७
छोड़ाये : छोड़ाए। विन० २४६.३  •nch 
_______________________________________________
315 
छोड़ावा : भुक००ए० । मुक्त करा दिया। 'सो पुलस्ति मुनि जाइ छोड़ावा ।' मा० ' ६.२४.१६ 
छोडिए : आ०कवा०प्रए । 'दोष
दु:ख दारिद दरिद्र के के छोड़िए।' कवि० ७.२५
छोड़ी : सं-स्त्री० । छोटी लड़की छलिन की छोड़ी सो निगोड़ी भोंड़े भील की।'  कवि० ७.१८
छोड़ो : भूकृ००कए । छोड़ दिया। 'आपन छोड़ो साथ जब ।' दो० ५३४
छोना : छोना । कवि० १.१८
छोनिप : सं०० (सं० क्षोणीप)। राजा । मा० १.२४१.७
छोनी : संस्त्री० (सं० क्षोणी) । पृथ्वी । मा० २.२३२.२
छोनीपति : छोनिप (सं० क्षोणीपति)। कवि० १.८
छोभ : सं०पु० (सं० क्षोभ) । खलबली, हलचल, अशान्ति, आवेग । 'मुनि बिग्यान  धाम मन करहिं निमिष महुं छोभ ।' मा० ३.३८
छोभा : भू००० । क्षुब्ध हुआ, अशान्त हो गया। 'सहज पुनीत मोर मनु छोभा।'  मा० १.२३१.३
छोभु : छोभ+कए । 'संकर उर अति छोभु ।' मा० १.४८ ख
छोर : (१) (समासान्त में) वि०० । छोड़ने वाला, मुक्त करने वाला । 'बिबुध  बन्दी छोर ।' हनु० ६ (२) सं०० । अन्तिम भाग, सिरा । 'सिला छोर छुअत  अहल्या भई दिब्य देह ।' गी० १.६७.३ 
Vछोर, छोरइ : (सं० क्षोरयति-क्षर छेदे; छोरति-छर छ दे>प्रा० छोरइ--  काटना, बन्धन उच्छिन्न करना) आ०प्रए० ! बन्धन मुक्त करता है। 'देखी  भगति जो छोरइ ताही ।' मा० १.२०२.४
छोरत : वकृ०० । छोड़ते, खोलते, काटते । 'छोरत ग्रंथि जानि खगराया.....।'  मा० ७.११८.६
छोरन : भकृ. अव्यय । खोलने, काटने । 'छोरन ग्रंथि पाव जौं सोई ।' मा०  ७.११८.५
छोरि : (१) पूकृ० । खोलकर, निकाल कर । 'दीन्ही है असीस चारु चूड़ामनि छोरि  के।' कवि० ५.२६ (२) आ० -- आज्ञा-मए० । तू काट, खोल । 'दुसह  दावरी छोरि बावरी ।' क० १५
छोरिबे : भक००। छोड़ने, मुक्त करने । 'छोरिबे को महाराज, बाँधिबे को कोटि  भट ।' विन० २६०.२
छोरी : (१) छोरि । 'कवन सकइ भव बंधन छोरी।' मा० १.१००३ (२) भकृ.  स्त्री० । खोली, काट दी। गांठि बिन गुन की कठिन जड़ चेतन की छोरी  अनायास ।' गी० १.८८.३ 
316 
_______________________________________________
छोरे : भू.कृ.पु । (१) खोले, आवरण मुक्त किये । 'प्रान कृपान बीर सी छोरे ।'  गी० २.११.२ (२) अलग किये। 'सुदिनु सोधि कल कंकन छोरे ।' मा० १.३६०.१ (३) काटे (काटने या खोलने से)। 'मोह शृंखला छुटिहि तुम्हारे छोरे ।' विन० ११४.५ (४) छीने (छीनकर) । 'लेत सरद ससि की छबि छोरे।'  गी० ३.२.३
छोरै : छोरइ । खोल सकता है । 'जेहिं बाँध्यो सोइ छोरे ।' विन० १०२.५
छोरौ : आ०मब० । खोलो, बन्धनरहित करो। 'हाथी छोरो, घोरा छोरो, महिष  बृषभ छोरौ ।' कवि० ५.६
छोलत : वपु । छोलते हुए, छोलते समय । 'रत्यो रची बिधि जो छोलत छबि  छूटी।' गी० २.२१.१
छोलि : पूक० । छोलकर । 'गढ़ि गुढ़ि छोलि छालि कुंद कीसी भाई बातें ।' कवि०  ७.६३
छोली : छोलि । गढि छोली । अवध साढ़साती तब बोली।' मा० २.१७.४
छोह : सं०पु० । कृपापूर्ण ममत्व, दयाभाव, वात्सत्य । 'प्रभु छाड़ेउ करि छोह ।'  मा० ३.२
छोहरा : संपुं० । लड़का, छोकरा, छोरा । कवि० ५.७
छोहा : छोह । मा० ४.३.२ 
छोह, छोहू : छोह+कए। 'करहिं छोहु सब ।' मा० २.३.४
छौना : सं०० (सं० सवन) । शावक, शिशु । 'मनहुं बिनोद लस छबि छोना ।' 
__ गी० १.२४.५ छ
वै : छुइ । छू कर । 'सकुचाति मही पद पंकज छवै ।' कवि० २.१८ 
जजोर : सं०स्त्री० (फ्रा० जन्जीर)। लौह-शृखला । कवि० ७.४४
जमात : वकृ०पु० (सं० जृम्भमाण+प्रा० जंभंत) । जंभाई लेते। 'हौ जंभात 
__ अलसात तात।' गी० १.१६.४
ज: सर्वनाम (सं० यद्>प्रा. ज)। जो, जा, जिन आदि का मूल शब्द । 
_______________________________________________
317 
जं : सर्वनाम (सं० यम्>प्रा. जं) । जिसे, जिसको । मा० ३.३२ छं. ४
जंगम : वि०५० (सं0) स्थावर का विलोम । (१) गतिशील, चलता-फिरता । 'जो . जग जंगम तीरथराजू ।' मा० १.२.७ (२) परिव्राजक साधु जो चलते रहते हैं।  'जागें जोगी जंगम ।' कवि ७.१०६ 
जंघ, घा : सं०स्त्री० (सं०) । पैरों के टखने और घुटने के मध्य का मांसल अंङ्ग। ___'चरन सरोज, चारु जंघा, जानु, अरु, कटि ।' गी० ७.७३.३  
जंजाल, ला : सं० । पाश, जाल, बन्धन, झंझट । मा० १.२११ . .
मंतु : सं०० (सं०) । (१) प्राणी। 'खग मग जीव जंतु जहें नाहीं।' मा  १.११०.११ (२) छुद्र कीट-पतङ्ग । 'गूलरि फल समान तव लंका । बसहु  मध्य तुम्ह जंत असंका।' मा० ६.३६.३ .
जंत्र : सं०पू० (सं० यन्त्र) । (१) बन्धन, श्रृंखला। (२) बांधने का स्तम्भ  आदि । (३),शल्य आदि उपकरण । (४) ज्योतिष के चक्र आदि । (५) तन्त्र शास्त्र के रहस्यलेख । 'जंत्र मंत्र' हनु० २६ (६) कोल्हू । 'सुकृत सुमन तिल  मोद बासि बिधि जतन जंत्र भरि घानी।' गी० १.४.१३
जंत्रित : भूकृ० (सं० यन्त्रित)। आबद्ध, नियन्त्रित, संसक्त । 'लोचन निज पद  जंत्रित ।' मा० ५३०
जंत्री : भूक०स्त्री० (सं० यन्त्रिता>प्रा० जतिआ>अ० जंत्री) । बांध दी, कील दी,  नियन्त्रित कर दी । 'भरत भगति सब के मति जंत्री।' मा० २.३०३.२  २०३०३.२  ..  ,
जंबु : सं०० (सं०) । जामुन का वृक्ष, फरेंद वृक्ष । मा० २.२३७.२ .
जंबुक : सं०० (सं०) । सियार । मा० ३.२० छं० १ (२) नीच मनुष्य ।
जंबुकनि : जंबुक + संब० । (१) सियारों (ने) । (२) नीच लुरेरों (ने)। 'हार्ट  सी उठति जंबुकनि लूट्यो।' कवि० ६.४६
जंबुकादि : सियार इत्यादि । कवि०६.२
जइहैं : आ०भ० प्रब० (सं० यास्यन्ति>प्रा० जाइहिति>अ० जाइहिहिं) । जायंगे  (नष्ट होंगे)। 'जइहैं सहित समाज ।' दो० ४१६
जए : (१) जय । 'सुर बिकल बोलहिं जय जए।' मा० ६.१०२ छं० .  (२) भूक पुब० । जीत गये । 'रिपु जनु रन जए।' जा०म०/०१७ .
जग : सं०पू० (सं० जगत)। (१) विश्वप्रपञ्च । 'जग जस भाजन चातक मीना।  मा० २.२३४.३ (२) जंगम (स्थावर का विलोम) । 'अगजगमय सब रहित विरागी।' मा० १.१८५.७ (३) दोनों का एकत्र
प्रयोग : 'अगजगमय जंग  मम उपराजा।' मा० ७.६०.५ जग
जगइ : (सं० जागति>प्रा० जग्गइ-प्रबुद्ध होना, सोकर संचेतन होना, सावधान होना, जगमगाना) आ०ए०। जगमगाती है । 'जग छबि मोतिन माल अमोलन की।' कवि० १.५ 
318 
_______________________________________________
मगजननि : सं०स्त्री० (सं० जगज्जननी)। जगदम्बा, परमात्मा की मूल शक्ति ।  मा० १.४८.२
नगजानी : वि.स्त्री० । विश्व में विदित । कृ० ४६
जगजाल : विश्वप्रपञ्च, विश्वविस्तार । को है जगजाल जो न मानत इताति है।' 
जगजोनी : (सं० जगद्योनि) विश्व की उत्पत्ति का मूल कारण । मा० २.२६७३
जगत् : सं०० (सं०) । विश्व । मा० ५ श्लो० १
जगत : जगत्, जग । मा० १.३ ख ।
जगतपति : (१) जगत्पति (२) (सं० जाग्रत्पति) जागने वालों में श्रेष्ठ । 'गुर तें  पहिले हि जगतपति जागे राम सुजान ।' मा० १.२२६
जगतबंध : विश्व भर के प्रणम्य । मा० १.५०.६
जगतमनि : जगत में शिरोमणि, विश्व में सर्वोत्तम । कवि ७.११३
जगती : संस्त्री० (सं०) । पृथ्वी । 'जगती जामति बिन बई ।' गी० ५.३८.५
जगतीतल : भूतल । पृथ्वीमण्डल । मा० २.४६.१
जगतु : जगत+कए । मा० २.२६२.१
जगत्पति : परमेश्वर । कवि० ७.२७
जगद् : जगत् । विन० १८.१
जगदंब : जगदंबा ।
जगदंबा : (सं.) जगन्माता। दुर्ग, महालक्ष्मी, सीता। 'जगदम्बा जानहु जिय  सीता ।' मा० १.२४६.२
जगदंबिका : जगदंबा । मा० १.२४७.१
जगदंबिके : जगदंबिका+सम्बोधन (सं०)। हे जगदीश्वरि ! जय जय जगदंबिके  भवानी ।' मा० १.८१.४
जगदातमा : सं०० (सं० जगदात्मन्) । अन्तर्यामी । 'जगदातमा महेस पुरारी।'  मा० १.६४.५
जगदाधार : विश्व का आधार। शेषनाग-लक्ष्मण । 'जगदाधार सेष ।' मा० 
जगदाधारा : जगदाधार । मा० ६.७७.४ 
जगदीस, सा : सं.पु० (सं० जगदीश)। परमेश्वर । मा० २.१२१.४; १.६७
जगदीसु : जगदीस+कए । एक मात्र ईश्वर । 'हेतु जान जगदीसु ।' मा० २ ३८
जगद्गुरु : वि० सं० (सं.)। विश्व में श्रेष्ठ+विश्व का उपदेशक = परमेश्वर ।  मा० ३.४१
जगनिवास : जगन्निवास । मा० १.१६१
जगन्निवास : विश्व के अधिष्ठान-राम । “भई आस सिथल जगन्निवास दील  की।' कवि० ६.५२ 
_______________________________________________
319 
जगपति : जगत्पति । विन० १३६.६
जगपावनि : वि०स्त्री० (सं० जगत्पावनी) । जगत को पवित्र करने वाली। 'गए  जहाँ जगपावनि गंगा।' मा० १.२१२.१
जगमगत : वक्र० । जगमग प्रकाश करता, चमचमाता । 'जगमगत जीनु जराव ।'  मा० १.३१६ छं०
जगमगति : वक०स्त्री० । जगमगाहट फैलाती, चमचमाती-सी । विद्यमान । 'जग  मगति जोरी एक ।' कवि० १.१६
जगमगात : जगमगत । मा० १ ३२५३
जगमगि : पूक० । देदीप्यमान हो (कर) । 'मनि जटित दुति जगमगि रही।'  गी० ७.१६.३
जगमय : वि.पु. (सं० जगन्मय) । विश्वरूप, विश्वव्याप्त । 'जगमय प्रभु का.  बहु कलपना ।' मा० ६.१५.८
जगमूला : जगत का मूल कारण । मा० १.१४८.२
जगहि : जगत् को । 'जो माया सब जगह नत्रावा ।' मा० ७.७२.१
जगाइ : पूकृ० । जगा कर । रावन भाइ जगाइ तब कहा प्रसंगु अचेत ।' रा०प्र०  ५.७१
जगाईबो : भकृ०पू०कए । जगाना, सावधान या सचेत करना । 'उपदेसिबो __ जगाइबो तुलसी उचित न होइ ।' दो० ४८६
जगाई : भूकृ.पु०ब० जगाये। गी० १.१०३.४
जगाएहि : आ० - भूकृ००+मए० । तू ने जगाया । 'अब मोहि आइ जगाएहि __ काहा।' मा० ६.६३.१
जगायो : भूकृ०पु०कए । जगाया, उजागर किया। 'गोरख जगायो जोगु, भगति 
__भगायो लोगु ।' कवि० ७.८४ 
जगावति, ती : वकृ० स्त्री० । जगाती, शयन से उठाती । 'कबहुं प्रथम ज्यों जाइ  जगावति ।' गी० २.५२.२
जगावहु : आ०मब० (सं० जागरयत>प्रा० जग्गावह>अ० जग्गावह) । जगावो,  नींद से उठाओ।' 'जाहु सुमंत्र जगावहु जाई।' मा० २.३८.२
जगावा : भकृ०० (सं० जागरित>प्रा० जग्गाविअ) । जगाया। सचेत किया ।  "मुनिहि राम बहु भाँति जगावा ।' मा० ३.१०.१७ ..
नगावी : जगावहु । 'सोवै सो जगावी, जागि जागि रे।' कवि० ५.६
जगु : जग+कए । जगत् । मा० १.२१६
जग: जगह । दे० /जग।
जग्य : सं०० (सं० यज्ञ) । हवन आदि वैदिक कर्म । मा० १.१८३.८  M 
320 
तुलसी शब्दकोश 
जग्य
उपबीत : यज्ञोपवीत । जनेऊ । 'पीत जग्य उपबीत सुहाएं। मा० १.२४४.२
जग्यकुडु : सं००कए । यज्ञकुण्ड, गहरी हवन वेदी। 'तुलसी समिध सौंज लंक  जग्यकुडु लखि ।' कवि० ५.७ । 
जग्योपबीत : जग्यउपबीत । गी० १.१०८.६
जच्छ : सं०० (सं० यक्ष) । देवजाति विशेष । मा० १.१७६.४
अच्छपति : यक्ष जाति के राजा कुबेर । मा० १.१७६.२
जच्छेस : जज्छपति (सं० यक्षेश) । कुबेर । कवि० ७.११५ 
जमाति, तो : सं०० (सं० ययाति) । चन्द्रवंश का एक राजा । मा० २.१७३.८
जजाती : जजाति । 'सुरपुर ते जनु खसेड जजाती।' मा० २.१४८.६
जजुट : सं०पु० (सं० यजुर्वे द) 'रिगु जजुट अथर्बन साम को।' विन ० १५५.२
जटजूट : जटाजूट । मा० ३.१८ छं०
जानि : जटा+संब० । जटाओं। 'माथे मुकुट जटनि के।' कवि० २.१६
जटा : सं०स्त्री० (सं०) । अप्रसाधित केशकलाप, लुटराये-उलझे केशों का पुज।  मा० १.२६८.५
जटाइ : जटायु । 'सराधु कियो सबरी जटाइ को।' कवि० ७.२२
जटाजूट : संपु० (सं०)। जटाओं का जूड़ा, लुटराये केशकलाप का बंधा हुआ  स्तूपाकार पुञ्ज । मा० २.३२४.३
जटापटल : सं०० (सं०) । जटाओं का समूह, जटाजूट । गी० ५.२२.२
जटाय : जटायु । गीध जसी जटाय ।' गी० ७.३१.४ 
जटायु, यू : सं०० (सं० जटायुष्) । रामायण कथा में एक गृध्र का नाम । मा०  ३.२६.१४
जटित : वि० (सं०) । जड़ा हुआ, जड़ी हुई, खचित । 'फिकिनी कलित कटि हाटक  जटित मनि ।' गी० १.३३.२
जटिल : वि०पु० (सं.) । जटाधारी । 'जोगी जटिल अकाम मन ।' मा० १.६७
जटे : भूकृ०० (सं० जटित)। जड़े हुए, गुम्फित । 'श्रोनित छीट छटानि जटे  तुलसी प्रभु सोहैं ।' कवि० ६.५१
जटने : भूकपु०कए । जटित, जड़ा हुआ, जकड़ा हुआ, गुफा हुआ। 'सबु लागत 
__फोकट झूठ-जटो।' कवि० ७.८६
जठर : सं०पु० (सं०)। उदर, गर्भ । 'जठर धरेउ जेहि कपिल कृपाला ।' मा०  १.१४२.६
जठरागी : सं००+स्त्री० [सं० जठराग्नि) । आमाशय की पाचक शक्ति । जिमि  सो असन पचवै जठरागी।' मा० ७.११६.६ 
_______________________________________________
321 

जठोरि, री: वि.स्त्री० (सं० ज्येष्ठतरा>प्रा० जेट्टयरी), श्रेष्ठ तथा वय में  बड़ी । 'बिप्रबधू कुलमान्य जठेरी ।' मा० २.४६.३
जठेरिन्ह : जठेरि+संब०। वयस्काओं (ने)। बड़ी-बूढ़ो स्त्रियों ने । 'जरठ  जठेरिन्ह आसिरबाद दये हैं ।' गी० १.११.४
जड़ : (१) वि० सं० (सं.)। स्थिर, गतिहीन । कृ. २४ (२) मूर्ख । 'छीनि  लेइ जानि जानि जड़।' मा० १.१२५ (३) अचेतन तत्त्व । 'जड़ चेतन गुन दोषमय बिस्व कीन्ह करतार ।' मा० १.६ (४) महाभूत-पृथ्वी, जल, तेज,  वायु, आकाश । 'जड़ पंच मिल जेहिं देह करी ।' कवि० ७.२७
जड़ता : सं०स्त्री० (सं.)। कठोरता, अचेतनता । मा० १.२५८.७
जड़ताई : जड़ता से, व्यामोहवश । 'अपनी जड़ताई-तुम्हहि सुगाइ ।' मा०  २.१८४.६
जड़ताई : जड़ता । मा० १.७८.४
जड़न्त : जड़+संब० । जड़ तत्त्वों। 'जहें असि दसा जड़न्ह के बरनी।' मा.  १.९५३
जड़मति : वि० (सं.)। मूढ़बुद्धि, दुर्बुद्धि । मा० ६.१०१ क
जड़हि : जड़ को, अचेतन को। 'जड़हि कर चैतन्य।' मा० ७.११९ख
जत : वि.पु । जितना, जितने । 'जड़ चेतन जग जीव जत ।' मा० १.७ग
जतन : सं०० (सं० यतन, यत्न)। (१) उपाय । ' नाम निरूपन नाम जतन तें।'  मा० १.२३.८ (२) प्रयास । 'करि देखा हर जतन बहु ।' मा० १.६२  (३) युक्ति । 'करौं जादू सोइ जतन बिचारी।' मा० १.१३१.७ (४) साधना।  'जेहि कारन मुनि जतन कराहीं।' मा० १.१४६.४
जतनु : जतन+कए । 'करेहु जाइ सोइ जतन बिचारी ।' मा० १.५२.३ 
जति, ती : (१) सं०पु० (सं० यति) । संयमी, योगी । 'जतिहि अबिधा नास ।'  मा० २.२६ (२) सं०स्त्री० (सं० यति)। विराम, सीमा। 'जंघा कदली  जाति ।' गी० ७.१७.४
जतिन्ह : जाति+संब०। यतियों, योगियों। 'दंड जतिन्ह कर भेद जहँ ।' मा.  ७.२२
जती : जति । योगी । 'सोचिअ जती प्रपंचरत ।' मा० २.१७२
जत्रु : सं० (सं.)। गले की दो हड्डियां जिन्हें हसुली कहते हैं । 'गूढ जत्रु बनि पीन  अंस तति ।' गी० ७.१७.१०
जथा : अव्यय (सं० यथा)। जिस प्रकार, जैसा, जैसे । 'जथा बंस व्यवहारु ।' मा०  १.२८६ (२) समान । 'सोउ सर्बग्य जया त्रिपुरारी।' मा० १.५१.१ 
322 
_______________________________________________
जथाजोग : क्रि०वि० (सं० यथायोग्य>प्रा० जहाजोग्ग)। योग्यतानुसार । 'जथा  जोग सनमानि प्रभु ।' मा० २.१३४ (२) यथोचित ।
जथाजोगु : जथाजोग (सं० यथायोग्यम् >प्रा० जहाजोग्गं>अ० जहाजोग्गु) । 
_ 'जथाजोगु निज कुल अनुहारी।' मा० १.२२४.७
जथाथिति : क्रि०वि० (सं० यथास्थिति) । स्थिति के अनुरूप; जैसा था वैसा, - पूर्ववत् स्थिति में । 'भयउ जथाथिति सब संसारू ।' मा० १.८६.२
जथाबिधि : क्रि०वि० सं० यथाविधि) । विधिपूर्वक, विधान के अनुसार। 'मिले  जथाबिधि सबहि प्रभु । मा० १.३०८।।
जथामति : क्रि०वि० । बुद्धि के अनुसार । मा० २.२७२.१
जथारथ : क्रि०वि० (सं० यथार्थ) । अर्थ के अनुसार, जैसा अर्थ है उसी के अनुरूप।  'बोध जथारथ बेद पुराना।' मा० ३.४६.५
जथारथु : जथारथ । तत्त्वतः, वस्तु स्वभाव के अनुसार, यथार्थतः । 'नीति प्रीति , परमारथु स्वारथु । कोउ न राम सम जान जथारथु ।' मा० २.२५४.५
जथारुचि : क्रि०वि० । रुचि के अनुरूप । 'अबिनय बिनय जथारुचि बानी।' मा०  २.३००.८
जथालाम : क्रि०वि० । जितना मिले उतने में ; लाभ के ही अनुसार । 'जथालाभ  संतोषा।' मा० ३.३६.४
जथाश्रुत : क्रि०वि० (सं० यथाश्रुत) । (१) आगमों के अनुसार (२) जैसा सुना  है उसी के अनुसार । 'तदपि जथाश्रुत कहउँ बखानी।' मा० १.११४.५
जथोचित : जथाजोगु (सं० यथोचित) । जैसा उचित हो तदनुसार । 'सहि जथो  चित आसन दीन्हे ।' मा० ११००.१
जदपि : क्रि०वि० अव्यय (सं० यदपि, यद्यपि) । मा० १.१५०.५
जदु : सं०पु० (सं० यदु) । यादवों के पूर्वपुरुष = ययाति के पुत्र जिनके वंश में  कृष्ण ने अवतार लिया था। मा० १.८८.१
'जदुनाथ : यादवों के स्वामी+यदुवंश में श्रेष्ठ = श्रीकृष्ण ।  
जदुराइ, ई : (दे० राई) । यदुराज श्रीकृष्ण । कृ० १
अद्यपि : जदपि । मा० १.२६४.२
जन : सं०० (सं.) (१) लोग। 'जोगिजन'- मा० २.२७६ छं० (२) भक्त,  दास । 'कृपासिंधु जन हित तनु धरहीं।' मा० १.१२२.१ 
/जन, जनइ : (सं० जनयति>प्रा० जणइ-उत्पन्न करना, प्रादुर्भूत करना) आ०  प्रए । जनन करता है । 'जो फल चारि चार्यो जनै ।' गी० ५.४०.१ ।
जनक : वि०+सं० (सं०) । (१) उत्पादक । 'तुम्ह ब्रह्मादि जनक जग स्वामी ।'  मा० १.१५०.६ (२) पिता। 'जननी जनक बंधु सुखदाता ।' मा० २.४३.३ 
_______________________________________________
323 (३) मिथिला देश-जैसे, जनकपति । (४) मिथिला का राजा । (५) मिथिला 
नरेश-सीरध्वज जिनकी पुत्री सीता थीं । 'जनकतनया' मा० १.२३१.१
जनकपति : जनक देश का राजा-सीरध्वज-सीता के पिता । मा० २.२७५.२
जनकपुर : जनक देश की राजधानी । मा० १.२१८.१
जनकपुर : जनकपुर+कए० । मा० १.३१४.४
जनकराज : जनकपति । मा०२.२८१३ जनकसुत
हि : जानकी को । 'जनकसुतहि समुझाइ करि ।' मा० ५.२७
जनकसुता : जानकी=सीता । मा० १ १८.८
जनक : जनक+कए । राजा सीरध्वज - जानकी के पिता । मा० १.२४४.४
जनको : जनक भी, पिता भी। हितू जननी न जनको।' कवि० ७.७७
जनकौर : सं०० (सं० जनकपुर)। सिय नैहर जनकौर नगर नियराइन्हि ।' जा.  मं० १२० 
जनकौरा : वि.पु० (सं जनकपौर)। जनकपुर-वासी। 'कोसलपति गति सुनि  जनकौरा । भे सब लोक सोक बस बौरा ।' मा० २.२७१.१
जनतेउँ : क्रियाति० पुं० उए० । (यदि) मैं जानता। 'जौं जनतेउ बिनु भट भुवि  भाई । तो पनु करि होतेउँ न हँसाई ।' मा० १.२५२.६
जननि : सं०+वि०स्त्री० (सं०)। जन्म देने वाली, माता । मा० १.१८.७
जननिन्ह : जननि+संब० । माताओं (ने) । 'जननिन्ह सादर बदन निहारे ।' मा०  १.३५८.८
जननिहि : माता को। मा० १.६७.५
जननी : (१) जननी+ब० माताएं। 'निमखहिं छबि जननी तनतोरी।' मा०  १.१९८.५ (२) जननी ने । 'बहु बिधि जननीं कीन्ह प्रबोधा।' मा० १.६३.८
जननी : जननि । मा० १.२०१.५
जनपद : सं०० (सं.)। देश, राज्य, राष्ट्र । गी० १.४.३
जनपालक : भक्तों के तथा जनता के रक्षक , मा० ७.२८.७
जनम : सं०पू० (सं० जन्मन्) । (१) उत्पत्ति, प्रसव । मा० १.३४.६ (२) सम्पूर्ण  जीवन । 'जनम गयउ हरि भगति बिनु ।' मा० १.१४२ 
जनम, जनमइ : जनम+प्रए । जन्म लेता है। 'जग जनमइ बायस सरीर  धरि ।' मा० ७.१२१.२४
जनमत : जनम+वकृ० । (१) उत्पन्न होता । 'जनमत जगत जननि दुख लागी।'  विन० १४०.३ (२) उत्पन्न होते ही । 'जनमत काहे न मारे मोही ।' मा०  २.१६१.७ (३) जन्म देती । 'सुन्दर सुत जनमत मैं ओऊ ।' मा० १.१९५.१
जनमथल : जन्म का स्थान । कवि० ७.१३८ 
324 
_______________________________________________
जनमपत्रिका : जन्म कुण्डली जिसमें जन्मकाल की ग्रहस्थिति आदि का ब्योरा रहता  है । दो० २६८
जनमफल : जनमफल+कए० । जीवन का एकमात्र फल, परम पुरुषार्थ । मा०  २.१२१.८
जनमा : जनम+भू००० । उत्पन्न हुआ। 'नहिं अस कोउ जनमा जग माहीं।'  मा० १.६०.८
जनमि : (१) जनमी । उत्पन्न हुई। 'जौं जन मि त भइ काहे न बांझा ।' मा०  २.१६४४ (२) पू० । जन्म लेकर, उत्पन्न होकर । 'भए जग जनमि जनकपुर  बासी।' मा० १.३१०.४
जनमी : जनमी+ब० । उत्पन्न हुई । 'जनमी पारवती तनु पाई।' मा० १.६५.६
जनमी : जनम+भूकृस्त्री०। उत्पन्न हुई। 'जनमी जाइ हिमाचल गेहा ।' मा०  १.८३.२ 
जनम् : जनम+कए । 'जद्यपि जनमु कुमातु तें।' मा० २.१८३
जनमे : जनम+भूकृ००० । उत्पन्न हुए। 'जनमे एक संग सब भाई।' मा०  २.१०.५
जनमेउं : आ० -- भूक.पु+उए । मैंने जन्म लिया। 'कवन जोनि जनमेउं जग  नाहीं ।' मा० ७.६६.८
जममेउ : जनम+भूकृ.पु०कए । उत्पन्न हुआ। तब जनमेउ षटबदन कुमारा।'  मा० १.१०३.७
जनम्यो : जनमेउ । कवि ७.३२
जनयत्री : वि०स्त्री० (सं० जनयित्री)। उत्पन्न करने वाली, जनन शीला । 'द्विज  पद प्रीति धर्म जनयत्री।' मा० ७.३८.६
जनवास : सं०० (सं० जन्य = दूल्हा तथा सहयात्री+बास>प्रा० जन्नवास) ।  बारात ठहरने का स्थान । 'गई जहाँ जनवास ।' १.३०८
जनवासा : जनवास मा० १.३०८.६ 
जनवासे : (१) जनवासा का रूपान्तर । 'जनवासे कहुं चले लवाई।' मा० १.३०६.४  (२) (सं० जन्यवासे-प्रा० जण्णवासे) । जनवास में । 'गे जनवासे राउ।  जा०म० १५८
जनवासेहि : जनवास में । 'उबरा सो जनवासेहिं आवा ।' मा० १.३२६.७
जनवासेहि : जनवासे को । 'जनवासेहि चले ।' जा०म० छं० २०
जनाइ : (१) पक० (संज्ञापयित्वा>प्रा० जाणाविअ>अ० जाणावि । जता कर।  'कहिबी नाम दसा जनाइ।' विन० ४१.३ (२) जनाई। बतायी। 'आपनि बात जनाइ।' रा०प्र० ५.२.७ 
_______________________________________________
325 
जनाई : (१) भूक०स्त्री० (सं० ज्ञापिता>प्रा० जाणाविआ)। निवेदित की,  जताई। 'भूप द्वार तिन्ह खबरि जनाई।' मा० १.२६०.२ (२) विदित की हुई । 'अपराध अगाधनि में ही जनाई।' कवि० ७.४३ (३) जनाइ । जता कर। 'बोलेउ अधिक सनेह जनाई ।' मा० १.१६१.७ (४) सं०स्त्री० (सं. ज्ञप्ति>प्रा. जाणाविई)। पहचान, परख, प्रकटीभाव । 'कपट चतुर नहिं  होइ जनाई।' मा० २.१८.४
जनाउ : सं०पु०कए० (सं० ज्ञापः>प्रा. जाणावो>अ० जाणा) । सूचना ।  'भीतर करहु जनाउ ।' मा० १.३३२
जनाएँ : (सं० ज्ञापितेन>प्रा० जाणाविएण>अ० जाणाविएँ) जताने से, विज्ञापित  करने से । 'प्रभु जानत सब बिनहिं जनाएं।' मा० १.१६२.२
जनाए : भूकृ०० (सं० ज्ञापित>प्रा० जाणाविअ) ब०। (१) जताए, प्रकट किये।  'लिखि नाम जनाए ।' गी० १.६.७ (२) प्रकट हुए । 'राम सीय तन सगुन  जनाए।' मा० २.७.४ । 
जनायउ, ऊ : भूकृ००कए० (सं० ज्ञापित>प्रा० जाणाविओ>अ० जाणावियउ)।  जताया, सूचित किया । 'लखि रुख रानि जनायउ राऊ।' मा० २.२८७.८
जनायो : जनायउ । 'मख राखि जनायो आपु ।' गी० ६.१.२ 
/जनाव, जनावइ : (सं० ज्ञापयति>प्रा० जाणावइ-बताना, जतलाना, सूचित  करना, प्रकट करना) आ०प्रए । ज्ञापित या सूचित करता है । 'मन अति  हरष जनाव न तेही ।' मा० ३.२६.८
जनावउँ : आ० उए० (सं० ज्ञापयामि>प्रा० जाणावमि>अ० जाणावउँ) । जताता हूं,  ज्ञापित करता हूं। 'मैं न जनावउँ काहु ।' मा० १.१६१।।
जनावत : वकृ०० (सं० ज्ञापयत्>प्रा० जाणावंत) । प्रकट करता, जान पड़ता ।  'हरि निरमल मल ग्रसित हृदय असमंजस मोहि जनावत ।' विन० १८५.३
जनावहिं : आ०प्रब० (सं० ज्ञापयन्ति>प्रा० जाणावंति>अ० जाणावहिं) प्रकट  करते हैं । 'बरिसहिं सुमन जनावहिं सेवा ।' मा० १.२५५.३
जनावहु : आ०मब० (सं० ज्ञापयत >प्रा० जाणावह>अ० जाणावहु) । जताओ,  ज्ञात कराओ। तो कहि प्रगट जनावह सोई ।' मा० २.५०.६
जनावा : भूकृ.पुं० (सं० ज्ञापित>प्रा० जाणाविअ) । जताया, व्यक्त किया। निज  प्रभाउ कछ प्रगटि जनावा।' मा० १.५४.३
जनावौं : जनावउँ । विन० १४२.७
जनि : निषेधार्थक अव्यय (अ० जाणि)। 'सोक कलंक कोठि जनि होहू ।' मा०  २.५०.१
जनिहिं : आ०-कवा-प्रब० (सं० ज्ञायन्ते>प्रा० जाणीअंति>अ० जाणीअहिं)। 
326 
_______________________________________________
(१) जान पड़ते हैं । पल सम होहिं न जनिअहिं जाता ।' मा० २.२८०.८ 
(२) जाने जायें। 'रहत न जनिअहिं प्रान ।' मा० २.६६
बनित : भक० (सं.)। उत्पादित । 'देहजनित अभिमान छडावा।' मा० ४.२८.६
अनिबे : जानिबे । जानने । 'जनिबे को रघुराउ ।' दो०२०२
अनियत : जानियत । जाने जाते रहे (हैं) । 'तुलसी राम जनमहिं तें जनियत ।'  गी० १.४६.३
मनिहैं : (१) जानि हैं। समझेंगे। (२) आ०प्रब० (सं० जनयिष्यन्ति >प्रा० जणि हिंत>अ० जणिहिहिं) । जनेंगे, उत्पन्न करेंगे । 'चलिहैं छुटि पुज पापिन के,  असमंजस जिय जनि हैं ।' विन० ६५.२
ननी : (१) वि०स्त्री० (सं० जनि =जनी) । स्त्री+माता, जननी । 'सकल सुमंगल  मनि जनी ।' गी० ५ ३६.५ (२) भूकृ०स्त्री० । उत्पन्न की। 'पुरी 'सुमति जननी जनु जनी ।' गी० १.५१ (३) उत्पन्न हुई । 'सरस सुषमा जनी।' गी  ७५.३
जनु : (१) अव्यय (अ० जणु) । जैसे । 'जनु बहु मनसिज रति तनु धारी।' मा०  १.१३०.१ (२) मानों। 'जनु बिनु पंख बिहंग बेहालू ।' मा० २ ३७.१  (३) जन+कए । अनन्य जन । 'जब लगि जन न तुम्हार ।' मा० २.१०७
जनेउ : जनेऊ । 'चारु जनेउ माल मग छाला ।' मा० १.२६८.७
जनेऊ : सं०० (सं० यज्ञोपवीत >प्रा० जण्णोवईअ) । द्विजों द्वारा धारणीय यज्ञ  सूत्र । मा० १.१४७.७
जनेत : सं०स्त्री० (१) (सं० जन्य यात्रा-जन्य = दुल्हा तथा उसके साथी>प्रा.  जण्णयता>अ० जण्णयत्त) । बरात । 'भत पिसाच प्रेत जनेत ऐहैं साजि के।' पा०म०/०७ (२) (सं० जन्यायात्रा)। बधू को साथ लिए हुए बरात (जन्या  वधू) । 'पहुंची आइ जनेत ।' मा० १.३४३
जनेषु : (सं० पद) लोगों में । 'अह मम मलिन जनेषु ।' मा० २.२२५
जनेस : सं०पु० (सं० जनेश) । राजा । 'हमरें जान जनेस बहुत भल कीन्हेउ ।' जा.  मं०६७
जनेसु : जनेस+कए० । 'जेहि जनेसु देइ जुबराजू ।' मा० २.१४.२
जन : दे० जन।
जनगी : आ०भ०स्त्री०प्रए । उत्पन्न करेगी+प्रसव करेगी। प्रभु की बिलंब अंक .  दोष दुख जनेगी।' विन० १७६.५
नन्म : जनम । मा० १.३४.८
जन्मत : जनमत । 'जन्मत भयउँ सूद्र तनु पाई ।' मा० ७.६७.१ 
_______________________________________________
327 
जन्म
दरिद्र : जन्म से दरिद्र, दरिद्र होकर (दरिद्र माता-पिता से) उत्पन्न । मा०  १.२८६३
जन्मभूमि : सं०स्त्री० (सं०) अपने जन्म का भूभाग। मा० ७.४.५
जन्म : जन्म+कए० । 'पारबती कर जन्म सुनावा।' मा० १.७६.७
जन्मौं : जन्म+उए० । जन्म लं । 'जेहिं जोनि जन्मौं कर्मबस तहँ राम पद  अनुरागऊँ ।' मा० ४.१०/० २
जन्यो : भक०कए० (सं०
जनित:>प्रा० जणिओ>अ० जणियउ)। उत्पन्न  किया । 'अदिति जन्यो जग भानु ।' गी० १.२२.११
जप : सं०० (सं.) । मन्त्र (आदि) का सूक्ष्म उच्चारण-जिसके तीन भेद किये  गये हैं (१) किंचित् श्रव्य (२) उपांशु --जिसमें मुख के बाहर ध्वनि न निकले (३) मानस जप-जिसमें मंत्र के अक्षरों का ध्यान मात्र होता है। उत्तरोत्तर  फल में अधिकता बताई गयी है । जपयज्ञ । मा० १.१३१.८
जपंत : जपत । मा० ३.३२ छ०  
जप, जपई : (सं० जपति>प्रा० जप्पइ-जप करना) आ०प्रए० । जपता-ती है।  'जागिबो जो जीह जप नीके राम नाम को।' कवि० ७.८३
जपउ : आ०उए० । जपता हूं, जपा करता हूँ (था)। ‘जपउँ मंत्र सिव मंदिर  जाई।' मा० ७.१०५.८
जपजाग : अनुष्ठान के रूप में जपकर्म ; जप का नियम से विधान के अनुसार  । 'समन अमित उतपात सब भरत चरित उपजाग।' मा० १.४१ .
जपत : वकृ.पु. (सं० जपत् >प्रा० जप्पंत) । जपता, जपते । 'उमा सहित जेहि  जपत पुरारी।' मा० १.१०.२ .
जपति : जपत+स्त्री० । जपा करती। मा० ५.८.८
जपन : भक० । जप करने । 'अस कहि लगे जपन हरि नामा ।' मा० १.५२८
जपने : भक०० ब० (सं० जपनीय) । 'गौरि गिरापति नहिं जपने ।' कवि० ७.७८
जयहिं : आ०प्रब० (सं० जपन्ति >प्रा० जप्पंति > अ० जप्पहि)। जप करते हैं। . 'साधक नाम जपहिं लय लाएं ।' मा० १.२२.४ 
जपहि : जपु (सं० जप>प्रा० जप्पहि) । तू जप । 'मंत्र सो जाइ जपहि ।' विन०  २४.४
जपहु : आ० मब ० (सं० जपत.>प्रा० जप्पह>अ० जप्पडु)। जपो । 'जपहु जाइ  संकर सत नामा ।' मा० १.१३८.५
जपामि : आ० उए० (सं०) । जपता हूं। मा० ७.१४ छ ।
जपि : पूक० । जप करके । जपि जेई पिय संग भवानी।' मा० १.१६.६  अनष्ठान 
328 
_______________________________________________
ये : आ०कवा०प्रए० (सं० जप्यते>प्रा० जप्पीअइ) । जपा जाय । 'महामंत्र  जपिये सोई जेहि जपत महेस ।' विन० १०८.२
जपिहै : आ०भ० (१) प्रए० (सं० जपिष्यति>प्रा० जप्पिहिइ)। वह जपेगा।  (२) मए० (सं० जपिष्यसि>प्रा. जप्पिहिसि>अ० जप्पिहिहि)। तू  जपेगा । 'राम जीह जौ लौं तू न जपिहै ।' विन० ६८.१
जपु : आ-आज्ञा-मए० (सं० जप>प्रा० जप्प>अ० जप्पु)। तू जप । 'जपु  राम नाम षटमास ।' दो० ५
जपें : जपने से । 'जहाँ बालमीकि भए ब्याध ते मुनिंद साधु 'मरा मरा' जपें।'  कवि० ७.१३८
जपे : जपें। राम नाम के जपे जाई जिय की जरनि ।' विन०१८४.१
जपेउ : भक०कए । जपा, जप किया। 'ध्र वं सग लानि जपेउ हरि नाऊँ।'  मा० १.२६.५
जपें : जपहिं । 'हर से हरनिहार जपं जाके नाम ।' गी० ५.२५.२
जप : दे. जप।
जप्यो : जपेउ । 'जीहहू न जप्यो नाम ।' विन० ३६१.२
जब : अव्यय । जिस समय । मा० १.३.५ 
जबहि, हीं : जभी, ठीक जिस समय, ज्योंही । 'आदि सृष्टि उपजी जबहिं ।' मा०  १.१६२
जबहूं : जब भी, जो कभी । 'सुरपति सरिस होइ नप जबहूं।' मा० ७.१२८.५
जब : जबहिं । कवि० ७.५१
जम : सं०० (सं० यम) । (१) यमराज, मृत्युदेव । मा० १.१७५ (२) अष्टाङ्ग  योग का प्रथम अङ्ग. जिसके गैंच भाग हैं-अहिंसा, सत्य, अस्तेय, ब्रह्मचर्य  और अपरिग्रह । 'क्षम जम नियम फूल फल ग्याना ।' मा० १.३७.१४
जमकातरि : सं०स्त्री० (सं० यमकर्तरी>प्रा० जमकत्तरी>अ० जमत्तरि)। मृत्यु  देव की तलवार, यमधारा (जमधार)। 'तोरि जमकातरि मदोदरी कढोरि  आनी।' हनु० २७
जमगन : सं०पु० (सं० यमगण) । यमदूत । विन० ६६.३
जमघट : सं०पू०। यमदत । तो जमघट साँसतिहेर हम से बषभ खोजि खोजि  बहते।' विन० ६७.४ 'जमघट' समह या जमाव का अर्थ भी देता है जिसे त्रिदोषज सन्निपात रोग का आशय भी निकलता है-'धक्का दर्द जमघट  थके।' विन० २६७.२
जमजातना : सं०स्त्री० (सं० यम-यातना) । नारकीय व्यथा । नरक । 'जमजातना  सरिस संसारू।' मा० २.६५.५ 
_______________________________________________
329 
जम
जातनामई : (दे० मई) । यमयातना से व्याप्त, नरक की प्रचुरता। कीजै मो  को जम जातनामई ।' विन० १७१.१ 
जमदूत, ता : सं०० (सं० यमदूत)। मृत्यु-सन्देशवाहक देवविशेष ।' मा०  २.८३.७
जमधार : (१) सं०० (सं० यमधार) । दुधारी तलवार । (२) सं०स्त्री० (सं०  यमधारा)। यमराज की सेना, धारा प्रवाह यमदूतों की श्रेणी । जमधार सरिस  निहारि सब नर नारि चलिहहिं भाजि के।' पा०म० छं०७
जमघारि : जमधार । 'करि बिचार भव तरिय, परिय न कबह जमधारि ।' विन०  २०३.१८
जमन : (१) यवन । मा० २.१६४ (२) मेच्छ, मुस्लिम । 'जमन महा महिपाल ।'  दो० ५५४
जमनिका : सं०स्त्री० (सं० जवनिक=यमनिका) । आवरण, पर्दा, (नाटक का  पर्दा)। 'हृदय जमनिका बहु बिधि लागी।' मा० ७.७३.८
जमपास : सं०० (१) सं० यमपाश>प्रा० जमपास) । मृत्यु जाल । (२) (सं०  यमपाव>प्रा. जमपास) । मृत्यु के समीप । 'नाम रटो, जम-पास क्यों जाउँ,  को आइ सकै जम किकरु नेरें ।' कवि० ७.६२
जमपुर : संपु० (सं० यमपुर)। यमलोक । मा० १.२८०.६
जमराज : सं०० (सं० यमराज)। यमदेव, मृत्युदेव । रा०प्र० ५.३.६
जमात : सं०स्त्री० (अरबी-जमाअत) । यूथ, समुदाय । 'जोगि जमात बरनत  नहिं बने ।' मा० १.६३ छं० ।
जमाति : जमात । 'जोगिनी जमाति कालिका कलाप तोषिहैं।' कवि० ६.२
जमाती : (१) जमाति (२) जमात या मण्डली बनाकर रहने वाला। 'जती जमाती  ध्यान धरें।' कवि० ७.१०६
जमानो : सं०पु०कए० (फा० जमानः) । युग, कालखण्ड, दौर । 'जाहिर जहान में  जमानो एक भांति भयो।' कवि० ७.७६
जमालय : सं०० (सं० यमालय) । यमलोक, नरक । विन० १४४.२  /जमाव
जमावइ : (१) (सं० यम यति>प्रा० जमावइ-स्थिर करना, रोपना,  घमीभूत करना (२) सं० जनयति-जन्मयति>प्रा० जम्मावइ- उत्पन्न करना) आ०प्रए । स्थिर करे+घनीभूत करे (दूध से दही करने का उपक्रम  करे) । 'धृति सम जावन देइ जमाव ।' मा० ११७.१४
जमिहहिं : आ०भ०प्रब० (सं० जनिष्यन्ते>प्रा. जम्मिहिंति>अ० जम्मिहहिं) ।  जमेंगे, उगेंगे। 'जमिहहिं पंख करसि जनि चिता।' मा० ४.२८.६ 
330 
_______________________________________________
जमी : वि०० (सं० यमिन् >प्रा० जमी) । संयमी, योगी। 'देखि लोग सकुचात  जमी से ।' मा० २.२१५.५
जमु : जम+कए । मृत्यु देवता । 'केहि जम यह लीन्हा ।' मा० २.२६.१
जमुन : जमुना । मा० १.१४७
जमुनहिं : यमुना पार, यमुना में 'बीच बास करि जमुनहिं आए।' मा० २.२२०.८
जमुनहि : यमुना को । 'जमुनहि कीन्ह प्रनामु बहोरी।' मा० २.११२.१
जमुना : सं०स्त्री० (सं० यमुना>प्रा० जमणा) । नदी विशेष । मा० १.३१.११
जमुहात : वकृ०० (सं० जृम्मभाण>प्रा० जंभंत>अ० जम्हंत)। जंभाई लेता  ते। 'राम कहत जमुहात । मा० २.३११
जमुहान : भूकृ०० (प्रा. जम्माण>जम्हाण)। ज॑भाया (जंभाई ली) ।  "कुंभकरन जमुहान ।' रा०प्र० ५७.२ 
जमुहाहि, हीं : आ०प्रब० । अँभाते हैं। 'राम राम कहि जे जमुहाहीं ।' मा.  २.१६४.५
जम्यो : भूकृ००कए । जम गया, घनीभूत हो गया । 'रुधिर गाड़ भरि भरि  जम्यो ।' मा० ६.५३.
जय : सं००+स्त्री० (सं.)। (१) विजय, जीत । 'निज पुर गवने जय जसु  पाई।' मा० १.१७५.८ (२) विष्णु के एक द्वारपाल का नाम । मा० १.१२२.४ (३) प्रणाम सूचक शब्द । जय हो । 'जय जय सुर नायक ।' मा० १.१८६.१ (४) एक संवत्सर का नाम । 'जय संबत फागुन सुदि ।' पा०म० ५ (५) अभ्युदय कामना में जय शब्द । 'जय जय धुनि पूरी ब्रह्म डा।' मा०  ६.१०३.१० (६) दे० जयति । 
जयंत, ता : सं०० (सं० जयन्त) । इन्द्र का पुत्र । मा० २.१४१; ३.२.६
जयऊ : भूकृ००कए । जीत गया । 'भरत धन्य, तुम्ह जसु जग जयऊ।' मा०  २.२१०.६ दे० जयति ।
जयकर : वि० (सं.)। विजेता । 'जय जयंत जयकर ।' कवि० ७.११३ जयकार, जय
जयकार : जयध्वनि, जयघोष, 'जय जय' ध्वनि । ६.७९
जयजीव : (जय = विजयी हो, सर्वोपरि रहो+जीव = जिओ)। ब्राह्मण द्वारा राजा  को कहा हुआ आशीर्वाद-विजय प्राप्त करो और चिरंजीवी होओ। 'कहि  जयजीव बैठ सिंह नाई।' मा० २.३८.६
जयति : आ.प्रए० (सं० जयति =सर्वोत्कर्षेण वर्तते) । सर्वोपरि सत्तावान है,  रात्पर रूप में विद्यमान है। 'जयति सच्चिदानंदा।' मा० १.१८५ छ० ४  (सर्वोपरि सत्ता से प्रणाम अर्थ की स्वतः व्यञ्जना होती है।)
जयमय : वि० (सं०) । विजयपूर्ण, अभ्युदयसूचक । 'जय' शब्द सहित नाम युक्त ।  जयमय मंजुल माल उर ।' रा०प्र० ४.७.३ 
_______________________________________________
331 
जयमाल : जयमाला । मा० १.१३१
जयमाला : सं०स्त्री० (सं०) । (१) विजेता को विजयोपलक्ष में पहनाई जाने  वाली माला । 'सोहत जन जग जलज सनाला। ससिहि सभीत देत जयमाला ।' मा० १.२६४.७ (२) वरमाला जो स्वयंवर में कन्या वर को पहनाती है।  'कुआँरी हरषि मेलेउ जयमाला।' मा० १.१३५.३
जयतील : वि० (सं० जयशील)। विजेता, विजयी। 'कपि जयसील राम बल  ताते ।' मा० ६.८१.३
जये : भूकृ.पुब० । जीत लिये गये (हारे हुए)। 'प्रभु खात......... आदर जनु  जये।' गी० ३.१७.५
जयो : जयऊ । (१) विजयी हुआ। 'जनक को पनु जयो।' कवि० १.१४ (२) पूर्ण  किया। 'चहत महामुनि जाग जयो।' गी० १.४१.१
जर : (१) सं०० (सं० ज्वर>प्रा. जर)। रोग विशेष+संताप । 'जरहिं दुसह  जर पुर नर नारी।' मा० २.२६२.२ (२) संस्त्री० (सं० जटा>प्रा० जडा >अ० जड) । मल तहाँ क्रोध की जर जरि गई। वैरा० ५१ (३) जइइ । जलता-ती है । चिताँ जर छाती।' मा० ४.१२.३ जर 
जरइ, ई : (१) (सं० ज्वलति>प्रा. जलइ.-दग्ध होना, जलना) आ०प्र० । जलता है, भस्म हो रहा है। 'जरइ नगर या लोग बिहाला ।' मा० ५.२६.२ (२) (सं० ज्वरति-ज्वर संतापे>प्रा० जरइ-सन्तप्त होना, ज्वर ग्रस्त होना, आर्त होना) 'सूखहिं अधर जरइ सब अंग ।' मा० २.३८.१ (३) (स० जीर्यति ज वयोहानो>प्रा. जरइ.-जीर्ण होना, क्षीण होना) 'रिस तन जरइ होइ बल हानी।' मा० १.२७८.६ (यहाँ तीनों अर्थ एक साथ हैं) । (४) जलता है+सन्तप्त होता है+क्षय ग्रस्त होता है । 'महाघोर त्रयताए न  जरई ।' मा० १.३६.६ 'राम रोष पावक सो जरई ।' मा० २.२१८.५
जरउँ : आ० उए । दग्ध+सन्तप्त+क्षीण होता हूं (था)। 'हरिजन द्विज देखें  जरउँ।' मा० ७.१०५
जरउ : आ०-संभावना-प्रए० (सं० ज्वलतु >प्रा० जलउ+सं० जीर्यतु>प्रा.  जरउ) । जल जाय, नष्ट हो जाय । 'जरउ सो संपति सदन सुखु ।' मा०  २.१८५
जरकसी : वि०स्त्री० (सं० जट संघाते.+कस बन्धने) । जड़ाऊ, हीरक-मण्डित,  जड़ाव से खचित । 'सुन्दर बदन सिर पगिया जरकसी।' गी० १.४४.१
जरजर : जर्जर । हनु० ३८
जरठ : वि० (सं०) । (१) वृद्ध । 'बाल जुवान जरठ नर नारी।' मा० १.२४०.६  (२) जराग्रस्त, जर्जर । 'जाना जरठ जटायू एहा ।' मा०
३:२६.१४ 
332 
_______________________________________________
खानि ।' कृ० ५२ (सभी अर्थ मिले रहते हैं।)
जरठपनु : (जरठ+पन-दे० पन) कए । बुढ़ापा । 'मनहुं जरउपनु अरु उपदेसा।'  मा० २.२.७ 
जरठाइ, ई : सं०स्त्री. (सं० जरठता)। बुढ़ापा । 'जरठाइ-दिसाँ रबि कालु  उग्यो।' कवि० ७.३१
जरत : वकृ.पु. (१) (सं० ज्वरत्>प्रा. जरंत) । संतप्त । 'अय इव जरत  परत पग धरनी।' मा० १.२६८.५ (२) (सं० ज्वलत्>प्रा० जलंत)। प्रज्वलित होता-ते । 'पावक जरत देखि हनुमंता ।' मा० ५.२५.८ (३) दग्ध होता-ते । 'जरत निकेतु धावी धावी लागि आगि रे।' कवि० ५.६ (४) संतप्त  +दग्ध हो रहा है। 'अजहं हृदउ जरत तेहि आँचा।' मा० २.३२.५ (५) जाज्वल्यमान, ज्वालाकुल+संतप्त 'आगे दीखि जरत रिसि भारी।' मा०  २.३१.३
जरती: क्रियाति.स्त्री०प्रए । 'यदि जलती+सन्तप्त होती+क्षीण होती रहती!  'घरहीं सती कहावती जरती नाह बियोग ।' दो० २५४ 
जरनि, नी : संस्त्री० (दे०जर-~सं० बलन>प्रा० जलण+सं. जरण, जरण  >प्रा० जरण) । (१) दाह । 'जिय के जरनि न जाइ। मा० २.१८२ (२) सन्ताप । 'राम स्याम सावन भादो बिन जिय के जरनि न जाई।' कृ० २६ (दोनों प्रयोगों में तीनों अर्थ गुथे मिलते हैं) (३) परसन्ताप, ईया। 'पर सुख देखि जरनि सोइ छई ।' मा० ७.१२१.३४ (यहाँ तीनों अर्थ सम्पृक्त  हैं-क्षीण होना+सन्तप्त होना+दग्ध होना)
जरहि : आ.प्रब० (१) (सं० ज्वलन्ति प्रा० जलंति>अ० जलहि) । दग्ध होते  हैं। 'जरहिं पतंग मोह बस ।' मा० ६.२६ (२) (सं० ज्वरन्ति>प्रा. जरंति >अ. जरहिं) सन्तप्त होते हैं । 'जरहिं विषमजर लेहिं उसासा ।' मा० २.५१.५ (३) दग्ध + सन्तप्त+क्षीण होते हैं == ईर्ष्याग्रस्त हो जाते हैं । 'सुरत  जरहिं खल रीति ।' मा० १.४
जरा : जरा से, बुढ़ापे के कारण । 'आँधरो अधम जड़ जाजरो जरा जवन ।' कवि.  ७.७६
जरा : (१) सं०स्त्री० (सं.) । बुढ़ापा । 'जरा मरन दुख रहित तनु ।' मा०  १.१६४ (२) भूकृ०० (सं० ज्वलित+ज्वरित>प्रा. जलिअ+जरिअ) !  भस्म हो गया+सन्तप्त हुआ । 'सुनत जरा दीन्हिसि बहु गारी।' मा० ३.२६.१ 
जराए, ये : दे० जराय । जड़ाऊ । नगों से खचित ।' गी० १.३२.२
जराय: सं० । जवाव, नगों की पच्चीकारी। 'हिएँ जग जीति जराय की  चौकी।' कवि० ७.१४३