1046
_______________________________________________
साको : (१) साका+कए । कीति कथा। 'जुग जुग जान किनाथ को जग जागत साको।' विन० १५२.१ (२) ख्यातिप्रद कोई बड़ा काम, यशोदायक उत्कर्ष । 'लरिहै मरिहै करिहै कछु साको।' कवि० १.२०
साखा : सं० स्त्री० (सं० शाखा) । (१) वृक्ष की डाल । 'लता निहारि नहिं तर साखा ।' मा० १.८५.१ (२) (लक्षणा से)। विस्तार, प्रपञ्च, अपवाद या अपयश का प्रसार-प्रचार । 'को करि तर्क बढ़ावै साखा ।' मा० १.५२.७. (३) विश्व-रचना से पच्चीस तत्त्व:-प्रकृति, महत्, अहंकार, मन, पाँच ज्ञानेन्द्रिय, पाँच कर्मेन्द्रिय, पञ्च तन्मात्र या विषय (शब्द, रूप, रस, गन्ध, स्पर्श), पञ्च महाभूत और जीव । 'साखा पंच बोस ।' मा० ७.१३ छं० ५ (४) वंश के गोत्र आदि ।
साखामृग : सं०० (सं० शाखामृग) । वानर । मा० ६.२८.१
साखि, खी : सं+वि०। (१) (सं० साक्षिन् >प्रा० सक्खी) । गवाह, तटस्थ द्रष्टा । 'साखि सखा सब सुबल सुदामा ।' कृ० १२ सत्य कहउँ करि संकरु. साखी ।' मा० २.३१.६ (यहाँ शपथ का भी तात्पर्य है।) (२) (सं० साक्ष्य =साक्षी) संस्त्री० । गवाही, साक्षात्कार, तटस्थ-दर्शन का प्रमाण । 'पावक साखी देइ करि जोरी प्रीति दृढाइ ।' मा० ४.४ (यहाँ भी शपथ का भाव है। (३) सन्तों की वाणी-विशेष जिसमें आत्मा तथा परमात्मा के साक्षात्कार का वर्णन रहता है। 'साखी सबदी दोहरा कहि किहनी उपखान ।' दो० ५५४ (४) शाखी । वृक्ष । 'तुलसी दलि रूँध्यो चहैं सठ साखि सिहोरे ।' विन० ८.४
साखोचारु : साखोच्चारु । 'साखोचारु दोउ कुलगुरु करें।' मा० १.३२४ छं. ३
साखोच्चार : सं०० (सं० शाखोच्चार) । विवाह में वर-वधू के पितवंश के गोत्र, पूर्वजों आदि का विस्तृत कथन जो दोनों ओर के आचार्यों द्वारा किया जाता है। पा०म० १२६
साखोच्चारु : साखोच्चार+कए । मा० १.३२४; छं०३ (पाठान्तर)।
साग : साक (प्रा.)। (१) पत्ती । गी० ३.१७.६ (२) सब्जी, तरकारी । 'सालन साग अलोने ।' विन० १७५.४
सागर : सं०० (सं०) । समुद्र (सगर पुत्रों द्वारा विस्तार देने से नाम पड़ा)। मा० १.१४ च
सागरु : सागर+कए । एकमात्र सागर, अद्वितीय समुद्र । 'सागर रघुबर बाहुबल ।' मा० १.२६१
सागु : साग+ए । हरित पत्र । 'सागु खाइ सत बरष गवाए । मा० १.७४.४
साच, चा : साँच, चा। जानहि झूठ न साच।' मा० १.११४ 'मोर पनु साचा ।" मा० १.२५६.४
_______________________________________________
1047
साचिलो : साँचिलो । विन० १६१.१
साची : सांची । 'सब साची कहौं ।' मा० २.१०० ई०
साचे : साँचे । यथार्थ, प्रमाणित । जन सब साचे होन हित भए सगुन एक बार ।' मा० १.३०३
साचेहुं : साँचेहुं । वस्तुतः, यथार्थ में । मा० १.१५
साज : सं०पू० (सं० सज्ज)। (१) सजावट, बनाव, वेषरचना, साधन-सामग्री। 'दुर्लभ साज सुलभ करि पावा ।' मा० ७.४४.७ (२) (फा० साज) बाजा+ बनाव । 'साजक घिगरे साज के ।' गी० ५.२६.२ (३) क्रि०वि० । समान, तत्सदृश बनाव के साथ । 'मृगराज के साज लरे।' कवि० ६.३६
साजक : वि० (सं० सज्जक) । बनाने-संवारने वाला । 'साजक बिगरे साज के।' गी० ५.२६.२
साजत : सजत । 'सात दिवस भए साजत सकल बनाउ ।' बर० २०
साजन : सजन । सजाने । लगे चलन के साजन साजा । मा० २.३१०.६
साजहिं, हीं : आ० प्रब । सजाते हैं, बनाते या तैयारी करते हैं । 'सकल चलै कर - साहिं साजू ।' मा० २.१८५.५
साजहु : सजहु । 'हय गय स्यंदन साजहु जाई ।' मा० १.२६८.१
साजा : (१) साज । 'बिपिन बसइ तापस के साजा ।' मा० १.१५८.५ (२) भूक० पु. । सजाया गया। 'राम तिलक हित मंगल साजा ।' मा० १.४१.७
साजि : सजि । सुसज्जित कर । मा० ६.६८.१ ।
साजिअ : आ.कवा०प्रए । सजाइए, सुसज्जित किया जाए। 'साजिअ सबुइ समाजु ।' मा० २.४
साजी : (१) साजि । 'बरहिं सुमन सुअंजुलि साजी।' मा० १.१६१.७ (२) भूकृ.स्त्री० । सुसज्जित की। 'बीर बसंत सेन जनु साजी। मा० ६.७६.५ (३) आ०भ० प्रए० (सं० सज्जिष्यति>प्रा० सज्जिहिइ>साजिहि)। सजाएगा । 'को साहिब सेवकहि नेवाजी । आपु समाज साज सब साजी ।' मा० २.२६६.५
साजु : साज+कए। (१) वेष विन्यास । 'साजु अमंगल मंगल रासी ।' मा० १.२६.१ (२) संभार, सामग्री। 'भोजन साज़ न जाइ बखाना ।' मा० १.३३३.४ (३) तैयारी आदि । 'परिछनि साजु सजन सब लागीं।' मा० १.३४६.२ (४) दे० साजू।
साजुज्य : सं०पू० (सं० सायुज्य) । मुक्ति का एक प्रकार जिसमें अद्वैत मतानुसार जीव को ब्रह्म का अभेद उपलब्ध होता-पृथक्ता सर्वथा खो जाती है । विशिष्टाद्वैत में अंशी ब्रह्म के अंश रूप में जीव अपनी परमार्थ सत्ता अनुभव करता और इस प्रकार अंशांशिभाव का भेद रहते भी अभेद पा जाता है जैसा कि अङ्ग का अङ्गी से भेदाभेद रहता है । मा० ६.३.२
साजू : (१) साज । बनाव, शृङ्गार आदि । 'सहि सुलोचनि मंगल साज ।' मा० २.२७.३ (२) आ०-आज्ञा-मए । तू सुसज्जित कर, शृङ्गार सजा । 'रिस परिहरि अब मंगल साजू ।' मा० २.३२.३
साजें : क्रि०वि० । सुसज्जित किए हुए (स्थिति में)। 'नव सप्त साजे संदरी सब ।' ____ मा० १.३२२ छं०
साजे : भूकृ००ब० । सुसज्जित किये, बनाये । 'करि मज्जन प्रभ भूषन साजे।' मा० ७.११.८
साजै : सज, सजइ । स जाता है । गी० ७.१२.२
साटक : (१) सं०० (सं० शाटक)। परिधान, वेषविन्यास । (२) (सं० साटक-साट् दर्शने) । प्रदर्शन, प्रदर्शनी, दिखाव । (३) (सं० सट्टक) एक प्रकार का क्षुद्र पात्रों का नाट्य, ग्राम्य नाट्य । 'सब फोटक साटक है तुलसी अपनो न कछु सपनो दिन हुँ ।' कवि० ७.४१
साटि : पू० (सं० शट अवसादने) । कष्ट उठाकर । 'बार कोटि सिर काटि साटि लटि रावन संकर पे लई ।' गी० ५.३८.३
साढ़साती : (१) सं००+स्त्री० (सं० सार्धसप्तिक>प्रा० सड्ढसत्तिम) । बारहवें, राशिस्थान तथा द्वितीय स्थान को मिलाकर साढ़े सात वर्ष की शनैश्चर की स्थिति जिसमें स्थान परिवर्तन, उच्चाटन आदि कष्ट होते हैं । 'समय साढ़साती सरिस नृपहि प्रजहि प्रतिकूल ।' रा०प्र० ३.२.४ (२) साढ़ेसाती शनितुल्य उच्छेद, उच्चाटन आदि संकट लाने वाली- 'अवध साढ़साती तब बोली।' मा० २.१७.४
साढ़ी : सं० स्त्री० । (दूध के ऊपर जमने वाली) मलाई । गी० ५.३७.२
सात : सप्त (प्रा० सत्त) । संख्याविशेष । मा० ७.११४.१०
सातक : (सात+एक) लगभग सात । 'साथ किरात छसातक दीन्हे ।' मा० २.२७२.८
सातवँ : वि०० (सं० सप्तम>प्रा० सत्तम>अ. सत्ता)। सातवां । मा० ३.३६.२
सातहयजान : (सं० सप्त+हय+यान) सात घोड़ों वाहन वाला=सूर्य (सूर्य को 'सप्ताश्व' तथा 'सप्त-सप्ति' कहा जाता है, इसी आधार पर शब्द गढ़ा गया है) । 'छली न होइ स्वामि सनमुख ज्यों तिमिर सात-हय-जान सों।' गी० ५.३३.२
साता: सात । मा० २.२८०.८
_______________________________________________
1049
सातै : सं०+वि०स्त्री० (सं० सप्तमी>प्रा० सत्तमी>अ० सत्तवीं सत्तवि) । (१) सातवीं (२) सप्तमी तिथि । विन० २०३.८
सातौ : सातों, सब-के-सब सात । 'समुद्र साती सोषिहै।' कवि० ६.२
सात्विक : वि० (सं.)। सत्त्वगुणी, दुःख-मोहरहित, राजस-तामस प्रवृत्तियों से शून्य-शुद्ध प्रकाशानन्दमय, उत्तम । मा० ७.११७.६
साथ, था : (१) सं०० (सं० सार्थ>सत्थ) । गोल, यूथ, संघ । 'गज चिक्करत भाजहिं साथ ते।' मा० ६.७८ छं० (२) सह, संग में । सब मिलि जाहु बिभीषन साथा। मा० ६.१०६.३
साथरीं : साथरी पर । 'ते सिय रामु साथरी सोए।' मा० २.६१.३
साथरी : सं०स्त्री० (सं० स्रस्तर>प्रा० सत्थर) । बिस्तर, घास-फूस का बिछौना ।  'कुस किसलय साथरी सुहाई ।' मा० २.६६.२
साथिन्ह : साथी+संब० । साथियों । 'साथिन्ह सों भुज उठाइ कहौं टेरे।' विन० २२७.१
साथी : वि०पु० (सं० साथिक>प्रा. सत्थिम) । साथ वाला, सहचर, अपने वर्ग का सदस्य, सहवर्गी । गी० ५.१६.२
साथु, थू : साथ+कए० । संग, सहयात्रा । 'केहि सुकृतीसन होइहि साथू ।' मा० २.५८.३
सादर : वि०+क्रि०वि० (सं०) । आदर सहित, सम्मान पूर्वक । 'सेवत सादर समन कलेसा।' मा० १.२.१२
सादरु : सादर+कए । 'सो सब सादरु कीन्ह ।' मा० २.२४७
सादें : वि०पू० (फा० सादः) । सादे से, साधारण से (सहित)। 'भूषन बसन बेष सुठि सादें । मा० २.२२१.६
साध : (१) सं०स्त्री० (सं० श्रद्धा=इच्छा>प्रा. सद्धा>अ० सद्ध)। अभिलाष, वासना, इच्छा । 'सकुचि साध जनि मारो ।' कृ० ३४ (२) वि०० (सं० श्रद्ध>प्रा० सद्ध)। श्रद्धालु । 'सब सुमति साध सखाउ ।' गी० ७.२५५ (३) साधक, सिद्ध करने वाला । 'सगुन साध सुभकाज ।' रा०प्र० १.४.१
साधक : सं०वि०० (सं०)। (१) उद्यमशील । (२) साधना करने वाला, तपस्वी आदि । 'अति पुनीत साधक सिधिदाता।' मा० १.१४३.२ (३) युञ्जान योगी जो योगसिद्धि की प्रक्रिया में चल रहा होता है (इस अर्थ में ही सर्वाधिक प्रयोग हैं)। 'भए अकंटक साधक जोगी।' मा० १.८७.८ 'साधक सिद्ध बिमुक्त उदासी।' मा० ७.१२४.५ (४) कार्य सफल करने वाला । ‘स्वारथ-साधक ।' मा० १.१३६ (५) विवाह के पूर्व वर-कन्या-पक्षों में मध्यस्थ होकर सम्बन्ध पक्का कराने वाला । 'दुलहिनि उमा, ईसु बरु, साधक ए मनि ।' पा०म० ८०
साधको : साधक भी । 'सुनत सिहात सब सिद्ध साधु साधको।' कवि० ७.६८
1050

साधत : वपु । साधना द्वारा सिद्ध करते हुए । 'साधत कठिन बिबेक ।' मा०. ७.११८
साधन : सं०० (सं.) । (१) उपकरण (२) तप आदि उच्चतम साध्य की प्राप्ति के उपाय । 'सोइ फल सिधि सब साधन फूला ।' मा० १.३.८ (३) अष्टाङ्ग योग आदि के उपाय :- यम, नियम, प्राणायम, प्रत्याहार, धारणा, ध्यान और समाधि+हठयोग के साधन मुद्रा आदि-+राजयोग । 'अब साधन उपदेसन आए।' कृ० ५० (४) नवधा भक्ति --जिनका वर्णन अरण्यकाण्ड में है । मा० ३.१६.५
साधहिं : आ०प्रब० । साधना कर रहे हैं। प्रयत्नरत हैं। 'तुम्हरें आश्रम अबहिं ईसु तप साधहिं ।' पा०म० २१
साधहि : आ० मए । तू साधन कर, ग्रहण कर । 'के चुप साधहि सुनि समुझि ।' दो०१८
साधा : भूक.पु । (१) निश्चित किया। 'राज देन कहं सुभ दिन साधा ।' मा० २.५४.७ (२) परखा, कसा । 'अब लगि तुम्हहि न काहू साधा ।' मा० १.१३७.४
साधि : पू० । (१) निश्चित कर । 'सुदिन साधि नप चलेउ बजाई।' मा० १.१५४.५ (२) ग्रहण कर । 'का चुप साधि रहेहु बलवाना ।' मा० ४.३०.३ (३) आ०-आज्ञा-मए । तू सिद्ध कर ले । 'एक ही साधन सब रिधि सिधि साधि रे।' विन० ६६.२ ।
साधी : (१) भूकृस्त्री० । साध ली, ग्रहण की। ‘देखि दसा चुप सारद साधी ।' मा० २.३०७.२ (२) वि०स्त्री० (सं० साध्य) । सिद्ध होने योग्य, सिद्ध की जाने वाली । 'नाम रूप दुइ ईस उपाधी। अकथ अनादि सुसामुझि साधी ।' मा० १.२१.२
साधु : वि० (सं०) । (१) दूसरे का हित करने वाला (सानोति पर-कार्याणि इति साधुः) । 'साधु चरित.. जो सहि दुख पर छिद्र दुरावा ।' मा० १.२.५-६ (२) महात्मा। 'परम साधु परमारथ बिंदक ।' मा० ७.१०५.४ (३) सज्जन, निर्दोष । 'बैठो सकुचि साधु भयो चाहत ।' कृ० ३ (४) (अव्ययात्मक प्रयोग) भला-भला, बहुत अच्छा, अत्युत्तम हुआ (शाबाश)। 'साधु सराहि सुमन सुर बरषे ।' मा० २.२१०.७ (५) वणिक् ।
साधुता : सं०स्त्री० (सं.)। सज्जनता, परहित भावना, तपोनिष्ठा। मा० ७.१०६.४
साधुन्ह : साधु+संब० । साधुओं । 'मुनि सुनु साधुन्ह के गुन जेते।' मा० ३.४६.८
साधुपनो : सं०पु०कए । साधुता । 'ब्याध को साधुपनो कहिए ।' कवि० ७.६३
105
साधु-साधु : अव्यय (सं०) । हर्षोत्साहवर्धक शब्द (शाबाशी) । 'साधु-साधु बोले मुनि ग्यानी ।' मा० २.१२६.७
साधू : साधु । मा० १.५.८
साधें : साधन करने से । 'लहिअ न कोटि जोग जप साधे ।' मा० १.७०.८
साधे : भूकृ.पुब ० । सिद्ध किये । 'समयहिं साधे काज सब ।' दो० ४४८
साधेउँ : आ०- भूकृ००+उए० । मैंने सिद्ध कर लिया; अपनी मुट्ठी में किया। ____ 'अब साधेउँ रिपु सुनहु नरेसा ।' मा० १.१७१.३
साधो : साध्यो । 'साधो कहा करि साधन त ।' कवि० ७.१५६
साधौंगो : आ०भ००उए । सिद्ध कर लगा। कालिहीं साधौंगो काज।' कवि० ७.१२०
साध्य : वि० (सं.)। (१) साधन द्वारा प्राप्य, लक्ष्य । (२) आराध्य । 'सिद्ध  साधक साध्य वाच्य वाचक रूप ।' विन० ५३.७
साध्यौ : भूकृ००कए । सिद्ध किया, पूर्ण किया। गी० २.३.४
सान : सं०पू०+स्त्री० (सं० शाण)। शस्त्रों की धार तेज करने का उपकरणविशेष, खराद । 'धरी कबरी सान बनाई ।' मा० २.३१.२
सानंद : वि० (सं०) । आनन्दरहिन, सुख-संयुक्त । मा० २.२४
साना : भक०० । गुधा हुआ, ओतप्रोत, मिश्रित । 'बिधि प्रपंचु गुन अवगुन 'साना ।' मा० १.६.४
सानि : पू० । गूधकर, मिश्रित करके । 'बोली गिरिजा बचन बर मनहुं प्रेम रस सानि ।' मा० १.११६
सानी : (१) भकृ० स्त्री० । गधी हुई, आई करके मिलाई हुई; ओतप्रोत, लपेटी हुई । 'समुझि न परइ बुद्धि भ्रम सानी ।' मा० १.१३४.६ (२) सानि । 'बोले मधुर बचन छल सानी ।' मा० १.८६.८
सानुकूल : वि०+क्रि०वि० (सं० सानुकूल्य) । अनुकूलता सहित, अनुकूल आचरण पूर्वक । 'सेवहिं सानुकूल सब भाई ।' मा० ७.२५.१
सानुग : वि० सं०) । अनुगामियों (अनुचरों आदि) सहित । हनु० १३
सानुज : वि० (सं०) । अनुज सहित । मा० १.४०.२
सानुराग : वि० (सं०) । अनुराग-सहित, स्नेहयुक्त । कवि० २.१०
साने : भूकृ००ब० । गधे, मोये हुए, ओतप्रोत, स्निग्ध किये हुए । 'सब के बचन प्रेमरस साने ।' मा० ७.४७.७
सान्द्र : वि० (सं.)। सघन, घनीभूत । मा० ३ श्लोक २
सान्यो : भूकृ० पु०कए० । सौंदा, मोया हुआ, लिथरा हुआ, चभोरा हुआ। 'करम कीच चित सान्यो।' विन० ८८.३ न त
1052
_______________________________________________

साप, पा : सं० स्त्री०+पू० (सं० शाप-पू०)। भावी अनिष्टकारी वचनविशेष ! मा० ७.१०७ क; १०६.३
सापत : वकृ.० (सं० शपत्>प्रा० सप्पत)। शाप देता हुआ । 'सापत ताड़त परुष कहता।' मा० ३.३४.१
सापे : शाप दिये जाने पर । 'सापे पाप, नये निदरत खल ।' गी० १.४७.२
साबर : (१) वि० (सं० शाबर)। शबर जाति सम्बन्धी, जंगली, अशिष्ट । (२) शाबरी विद्या जो जंगली जाति में प्रचलित मन्त्रों वाली होती है।
साबरमंत्र : शाबरी विद्या के मन्त्र (जिनकी रचना शबर वेषधारी शिव ने की थी, ऐसा प्रचलित है । इन मन्त्रों की भाषा बेतुकी होती है ।) मा० १.१५.१
साम : सं०० (सं० सामन्) । (१) राजनीति के चार उपायों में प्रथम । प्रतिपक्षी को वाचिक सान्त्वना आदि से अनकल करने का उपाय । 'साम दान भय भेद देखावा ।' मा० ५.६.३ (२) द्वितीय वेद, वैदिक संहिताविशेष । 'धीर मुनि गिरा गभीर सामगान की।' गी० २.४४.१ (सामवेद के मन्त्रों को भी 'साम' कहा जाता है)। (३) सान्त्वना । 'नाम कलि कामतरु सामशाली।' विन० ४४.१
सामध : सं०पु । समाधियों का परस्पर स्नेहाचार आदि । 'सामध देखि देव अनु. रागे।' मा० १.३२०.४
सामरथ : सं०० (सं० सामर्थ्य) । शक्ति, क्षमता । 'यह सामरथ अछत मोहि त्यागहु ।' विन० ६४.५
सामादिक : राजनीति के चार उपाय:- साम, दान, भेद और दण्ड । दो० ५०६
सामु : साम+कए । एकमात्र सामनीति, अनुकूल बनाने का उपाय । ‘राम सों साम किए हितु है।' कवि० ६.२८
सामुझि : समुझि । समझ, विवेक बुद्धि । 'प्रभु पद प्रीति न सामुझि नीकी ।' मा०
सामुहें : क्रि०वि० (सं० सम्मुखे, संमुखेन>प्रा० संमुहेण>>अ० संमुहें) । सामने, अनुकूल होकर आगे । 'तेउ सुनि सरन सामुहें आए।' मा० २.२६६.३
सामहो : वि०पु०कए० (सं० संमुख:>प्रा० संमुहो) । सामने स्थित । 'तुलसी स्वारथ सामुहो।' दो० ४८१
सामै : साम ही, सामनीतिमात्र (दान, भेद और दण्ड नीतियां नहीं) । 'इहाँ किये  सुभ साम।' गी० ५.२५.३
सामो : सं००कए० (सं० सामकम् =मूलधन>प्रा० साम>अ० सामउ) । सामग्री, पूजी (फा० सामान ?) । 'बालमीकि अजामिल के कछु हुतो न साधन सामो।' विन० २२८.४
1053
साय : (१) सं०पू० (सं.)। अन्त, छोर, अवसान, चरम सीमा (२) संस्त्री० (सं० साति>प्रा० साइ) । विनाश (मरण-तुल्य कष्ट) । 'कृपासिंधु बिलोकिए जनः मन की सांसति साच ।' विन० २२०.६
सायक : सं०० (सं.) । बाण । मा० १.१८.१०
सायकन्हि : सायक+संब० । बाणों (ने) । प्रभु के सायकन्हि काटे ।' मा० ६.६८
सायका : सायक (बहुवचन में प्रयुक्त-सं० सायकाः)। 'पचारि डारे सायका। मा० ३.२० छं० २
सायकु : सायक+कए । एक बाण । मा० २.२३६.८
सायर : सागर (प्रा.) । 'सायर जुरै न नीर ।' दो० ७२
सायरकाँठे : (सं० सागर-कण्ठे) समुद्र-तट पर । 'प्रभ आइ परे सुनि सायर-काठे।" कवि० ६.२८
सारँगपानि, नी : (दे० सारंग-सं शाङ्गपाणि) विष्णु (राम) । मा० ६.११६.२
सार : (१) सं०० (सं.)। निष्कर्ष, निचोड़, स्वरस । मा० ६.१२.७ (२) दृढ़ अंश । 'किये बिचार सार कदली ज्यों।' विन० २७७.२ (३) लोहा । 'कपट-सार-सूची सहस ।' दो० ४१० (४) देखभाल । 'सब के सार-संभार गोसाईं।' मा० २.८०.६ (५) शाला । जैसे, घोरसार, हथिसार आदि ।
सारंग, गा : सं००। (१) (सं० शाङ्ग>प्रा० सारंग) । विष्णु का धनुष; धनुष । 'कर सारंग साजि कटि भाथा ।' मा० ६.६८.१ (२) (सं.)। एक प्रकार का संगीत-राग । 'सुसुर सुसारेंग गुंड ।' गी० ७.१६.४ (३) (सं.) तन्त्री-वाद्यविशेष, सारंगी । 'सारंग गुडमलार 'बाजहीं।' गी० ७.१६.४
सारंगधर : वि०+सं०० (सं० शाङ्गधर)। विष्णु (राम) । रा०प्र० ३.७.१
सारथि : सं०० (सं०)। सूत, रथचालक । मा० ६.१००.७
सारथिन्ह : सारथि+संब० । सारथियों (ने)। 'रथ सारथिन्ह बिचित्र बनाए।' मा० १.२६६.३
सारथी : सारथि। मा० २.१४३
सारद : (१) सारदा । सरस्वती । 'सुमिरत सारद आवति धाई ।' मा० १.११.४ (२) वि० (सं० शारद)। शरद् ऋतु-सम्बन्धी । 'सारद ससि सम तुड ।' गी० ७.१६.४
सारदउ, ह : शारदा भी । 'तेहि सारदउन बरने पारा।' मा० १.३१७.१; मा० २.२३८.४
सारदा : संस्त्री० (सं० शारदा) । सरस्वती, वाणी की देवी । मा० १.३५.२
सारदी : वि.स्त्री० (सं० शारदी) । शरद् ऋतु की । 'कहुं कहुं बृष्टि सारदी थोरी ।' मा० ४.१६.१०
1054
_______________________________________________
सारदूल : संपु० (सं० शार्दूल)। सिंह । 'सारदूल को स्वांग करि कूकर की ___करतूति ।' दो० ४१२
सारनु : सं००कए० (सं० सारणः)। रावण का एक गुप्तचर । 'आए सुकु सारनु बोलाए ते कहन लागे ।' कवि० ६.८
सार-सँभार : सं० स्त्री० । देखभाल, रक्षा-व्यवस्था । मा० २.८०.६
सारस : सं०पू० (सं०) । (१) पक्षिविशेष । 'मोर हंस सारस पारावत ।' मा० ७.२८.५ (२) कमल । 'स्याम सारस मृग मनो ससि स्रवत सुधा सिंगारू ।' कृ० १४
सारा : (१) सार । निष्कर्ष । 'अति पावन पुरान श्रुति सारा।' मा० १.१०.१ (२) सार संभार । 'करिहहिं सासु ससुर सम सारा।' मा० २.६६.१ (३) भूकृ०० (सं० सारित>प्रा० सारिस) । सँवारा, लगाया। 'अस कहि राम तिलक तेहि सारा।' मा० ५.४६.१०
सारि : पूकृ० । सार कर, सँवार कर, लगाकर । 'तिलक सारि अस्तुति अनुसारी।' मा० ६.१०६.६
सारिका : सं०स्त्री० (सं० शारिका, सारिका) । मनुष्य वाणी बोलने वाला पक्षि विशेष, मैना। 'सुक सारिका पढ़ावहिं बालक ।' मा० ७.२८.७
सारिखी : वि० स्त्री० (सं० सदशी>प्रा० सारिक्खी) । समानता वाली । 'राम सो न बर दुलही न सिय सारिखी।' कवि० १.१५
सारिखे : वि००ब० (सं० सदृक्ष>प्रा० सारिक्खय) । सरीखे, तुल्य । 'तुम्ह सारिखे संत प्रिय मोरें।' मा० ५.४८.८
सारिखो : वि.पु.कए. (सं० सदक्षः>प्रा० सारिक्खो)। सरीखा, सदृश । 'हनुमान सारिखो न त्रिलोक महाबल भो।' हनु०७
सारीं : सारी+ब० । सारिकाएँ, मैनाएँ । 'सुक सारी-सुमिरहिं राम ।' मा० १.७.१०.
सारी : (१) सारिका । (२) संस्त्री० (सं० शाटी>प्रा० साडी)। स्त्रियों का परिधान विशेष । 'सोह नवल तन सुदर सारी ।' मा० १.२४८.२
सारु, रू : सार+कए । एकमात्र सार, निष्कर्ष, तत्त्व । मा० २.३२३.८ 'यह स्वारथ परमारथ सारू ।' मा० २.२६८.६
सारे : वि.पुं०ब० (सं० सकल>प्रा० सअल =सअलय) । सब। 'परमारथ स्वारथ सुख सारे ।' मा० २.२८६.७
सारेहु : आ०-भ०+आज्ञा-मब । तुम सँवारना, लगाना । 'सारेहु तिलक कहेउ रघुनाथा ।' मा० ६.१०६.३ ।
सारो : सं०पू० (सं० सारक:>प्रा० सारओ) । मैनापक्षी (सारिका का पुलिङ्ग)। 'सुक सों गहबर हिये कहै सारो।' गी० २.६६.१
_______________________________________________
1055
सार् यो : भूकृ०० कए० । (१) रचाया, लगाया। 'तिलक बिभीषन कहें पुनि सार्यो।' मा० ६.११८.४ (२) पूरा किया, सिद्ध किया। काजु कहा नर तनु धरि सार्यो ।' विन० २०२.१
साल : (१) सं०पू० (सं०) । वृक्षविशेष । 'साल तें बिसाल बाहैं ।' कवि० ५.१३ (२) सं०० (सं० शल्य>प्रा० सल्ल)। तीर, तीखी नोक, चुभन, चुभने वाला, कष्टदायी। (३) (सं० शाल, साल)। बाड़ा, घेरा, दीवार आदि । गी० ३.१०.२ (४) साला। घर । जैसे, "परन-साल' । गी० २.४४.३
सालक : साल (सं० शल्यक) । सालने वाला, कष्टदायी । 'खल-सालक बालक ।' मा० ३.१६.११
सालति : वकृ०स्त्री० । शल्यतुल्य चुभती, खटकती। 'असुरनि उर सालति ।' गी० ७.१७.८
सालन : (१) साल+संब० । सालों, बाड़ों या झरोखों (से, में)। 'पल्लव सालन हेरी प्रानबल्लभा न टेरी ।' गी० ३.१०.२ (२) सं०पू० (सं.)। व्यञ्जन (दाल, तरकारी आदि) । 'जस सालन साग अलोने ।' विन० १७५.४
सालभंज : सं-स्त्री० (सं० शालभ जिका) । मति, वास्तु-प्रतिमा आदि ।
सालभंजनि : सालभंज+संब० । मूर्तियों । 'तुल सिदास मोसी कठोर-चित कुलिस सालभंजनि को हहैं।' गी० ६.१७.३
साला : (१) संस्त्री० (सं० शाला>प्रा० साला)। घर । 'बरनि न जाहिं मंजु दुइ साला ।' मा० २.१३३.८ (२) साल (सं० शल्य) । नोक, चुभन, खटका। 'सठ अजहूं जिन्ह के उर साला।' मा० ६.२५.४
सालि : (१) सं०० (सं० शालि)। धान । 'सेवक सालि पाल जलधर से।' मा० १.३२.१० (२) वि० (सं० शालिन) । सम्पन्न, युक्त । 'तप सालि ।' मा० १.३३० (समासान्त में प्रयुक्त)।
सालिम : वि० (अरबी)। पूर्ण, स्वस्थ, अधिक । जिनके गुमान सदा सालिम संग्राम को।' कवि० १.६
साली : सालि । (१) धान । 'ईति भीति जस पाकत साली।' मा० २.२५३.१ (२) (समासान्त में) सम्पन्न, युक्त । बिमल बिबेक धरम नयसाली।' मा० २.२६७.८
सालु : साल+कए० । शल्य, चुभन, कसक, क्लेश । 'भा कुबरी उर सालु ।' मा० २.१३
साले : साला+ब० । शल्य, कसक, काँटे । 'बिराजत बैरिन के उर साले ।' हनु० १७
सावँकरन : सं०० (सं० श्यामकर्ण-श्याम>प्रा० साम>अ० सावें)। यज्ञोपयोगी अश्वजातिविशेष (जिसे साधारण कामों में नहीं जोता जाता)। 'सावकरन अगनित हय होते। ते तिन्ह रथन्ह सारथिन्ह जोते।' मा० १.२६६.५.
सावँतु : संपु०कए० (सं० सामन्त्यम् = सामन्तत्वम् >प्रा. सामंतं>अ० सावंतु)। सामन्तता, पराधीन राजत्व । 'देव निसान बजावत गावत, सावंतु गो, मन भावत भो रे।' कवि० ६.५७
सावँर : वि० (सं० श्यामल >प्रा० सामल>अ० सावल) । श्यामवर्ण । 'सावर कुर सखी सुठि लोना ।' मा० १.२३३.८
सावँरी : सारी ने । कियो बिदेहु मुरति सावरी।' मा० १.३२४ /०४
सावँरी : सावर+स्त्री० । श्यामवर्ण वाली।
सावक : सं.पुं० (सं० शावक) । शिशु, बालक । 'केहरि सावक ।' मा० १.३२.७. 'मृगसावक नयनी ।' मा० २.८.८
सावकास : वि० (सं० सावकाश)। अवकाशयुक्त (कार्यव्यग्रता से मक्त)। 'सावकास सुनि सब रमिवासू ।' मा० २.२८१.३
सावज : साउज । कवि० ७.१४२
सावत : सं०० (सं० सापत्न्य>प्रा० सावत्त)। (१) सपत्नीभाव =सौतिया डाह । (२) सपत्नभाव = शत्रुता । 'सरगहुं मिटत न सावत ।' विन० १८५.४
सावधान : वि० (सं.)। अवधानपूर्वक, दत्तचित्त, एकान । मा० ७.७८.३
सावन : सं०० (सं० धावण>प्रा० सावण) । मास विशेष जो वर्षा ऋतु में परि गणित है, जिसकी पूर्णिमा को श्रवण नक्षत्र पड़ता है। मा० १.३००.२ ।
सावनो : सावन+कए० । सावन महीने का। 'बारिधारा उलदै जलदु जौन सावनो। कवि० ५.८
सास : सासु (सं० श्वधू) । गी० ५.५०.५
सासकु : वि०० (सं० शासक) कए० । एकमात्र शासनकर्ता, नियामक । 'सब को सासक, सब में, सब जामें।' गी० ५.२५.२
सासति : (१) सांसति । कष्ट । 'सासति सहत दास ।' हनु० २६ (२) संस्त्री० (सं० शास्तिः) । शासन, दण्ड आदि । 'सासति करि पुनि करहिं पसाऊ।' मा० १.८६.३
सासन : सं०पू० (सं० शासन) । आदेश । 'सुरपति सासन थन मनो मारुत मिलि धाए।' गी० १.६.५
सासु : सासू । मा० २.५८.१
सासुन्ह : सासु+संब० । (१) सासुओं ने । 'सासुन्ह सादर जानकिहि मज्जन तुरत कराइ ।' मा० ७.११ (२) सासुओं को। 'सासुन्ह सबनि मिली बैदेही ।' मा० ७.७.१
_______________________________________________
1057
सासुर : सं०० (सं० श्वाशुर>प्रा० सासुर)। ससुराल । 'प्रिय न काहि अस सासुर माई ।' मा० १.३११.१
सासुरे : क्रि०वि० (सं० श्वाशुरे>प्रा० सासुरे)। ससुराल में । 'घर गुर गृह प्रिय सदन सासुरे भइ जब जहँ पहनाई।' विन० १६४.४
सासू : सं० स्त्री० (सं० श्वश्रू>प्रा० सासू)। (१) पति की माता। मा० २.९८५ (२) पत्नी की माता। मा० १.३३६.७
सास्त्र : सं०पू० (सं० शास्त्र) । किसी विषय का अनुशासन करने वाला ग्रन्थ, सूत्र, नियम, विधि, विधान आदि । 'सासु सुचितित पुनि पुनि देखिअ ।' मा० ३.३७.८
साह : साहि । सम्राट्, स्वामी। ‘साह ही को गोतु गोतु होतु है गुलाम को।' कवि० ७.१०७
साहनी : सं०० (सं० साधनिक =सैनिक-साधन =सेना>प्रा० साहणिअ)। सेनानायक या सिपाही । 'लिए सुभट साहनी बोलाई ।' मा० २.२७२.३
साहब : साहिब । दो० ६७
साहबी : साहिबी। कवि० ७.१२६
साहस : सं०० (सं०) । (१) अविवेकपूर्ण कार्य। मा० ६.१६.३ (२) दृढता, सहिष्णुता । 'सब मिलि साहस करिय सयानी ।' कृ० ४८
साहसिक : वि० (सं०) । सहनशील, कष्ट सहिष्णु, दृढ, उत्साही । गी० १.९२.२
साहसी : (१) साहसिक (प्रा० साहसि अ) । दो० २३३ (२) सं०स्त्री० । साहस, साहसिकता । 'तुलसी की साहसी स राहिए कृपाल राम ।' कवि० ७.८१
साहि : सं०पु० (सं० शाखि = राजवंशविशेष>प्रा० साहि-फा० शाह = सम्राट) । 'गुलाम राम साहि को।' कवि० ७.१००
साहित : सं०० (सं० साहित्य)। काव्य, वाङमय । 'तुलसी असमय के सवा' धीरज धरम बिबेक । साहित साहस सत्य ब्रत राम भरोसो एक ।' दो० ४४७,
साहिब : सं०० (अरबी) । स्वामी। मा० २.२० ५.१
साहिबहि : साहब को । मा० २.२६८.३ 'सबै साहिबहि सोहै।' कृ० ३५
साहिबिनी : साहिब+स्त्री० (अरबी-साहिब:)। स्वामिनी (सीता) । कवि०.
साहिबी : सं०स्त्री० । स्वामित्व, राजत्व । दो० ५७०
साहिबु : साहिब+कए० । एक ही स्वामी । 'मुख सो साहिब होइ।' मा० २.३०६.
साहु : सं०० (सं० साधु>प्रा० साहु) । वणिक, सेठ धनी। 'तुलसी दिन भल साधु कह, भली चोर कह राति ।' दो० १४८
साहेब : साहिब । दो० ८०
साहेबु : साहिब । कवि० ५.६
1058
_______________________________________________
साहैं : सं०स्त्री०ब० (सं० शाखा:>प्रा० साहाओ>अ० साहई)। द्वारशाखाएं, दरवाजे के खम्भे, बाजु । 'दार बिसाल सुहाई साहैं।' गी० ७.१३.३
सिंगरौर : सृगबेरपुर (प्रा० सिगेरउर) । मा० २.१५१.१
सिंगार, रा : सिंगार । (१) साजसज्जा, वेषविन्यास । 'सिवहि संभुगन करहिं सिंगारा ।' मा० १.१२.१ (२) स्त्रियों के सोलह शृगार । रान० १० (३) शृङ्गार रस (दे० सिंगार)।
सिंगारु, रू: सिंगार+कए । (१) शृङ्गार रस । ससि स्रवत सुधा सिंगारु।' कु. १४ (२) वेषभूषा की रचना । 'संत सुमति तिय सुभग सिंगारू ।' मा० १.३२.१ (३) अलंकरण । 'सकल सुकृत फल सुगति सिंगारू ।' मा० १.२६८.६
सिंचाइँ : भक०स्त्री० ब० । सिक्त करायी। 'बीथीं सकल सुगंध सिंचाई।' मा० ७.६.३
सिंचाई : (१) सं०स्त्री० । सींचने की क्रिया। कृ० ५६ (२) भूकृ०स्त्री० । सिक्त करायी । संतत रहहिं सुगंध सिंचाई ।' मा० १.२१३.४
सिंचावा : भूक.पु । सिक्त कराया, सिंचाया। 'चरन सलिल सब भवन सिंचावा।'  मा० १.६६.७
सिंचि : पूकृ० । सिंचकर, सिक्त होकर । 'कृपासिंधु सिंचि विबुध बेलि ज्यों फिरि सुख फरनि फरी।' गी० १.५७.२
सि : सी। समान । 'प्रीति कि सि मूरति ।'मा० २.२८१.७
सिंगार, रा : सं०० (सं० शङ्गार>प्रा० सिंगार) । (१) शृङ्गार रस जिसका स्थायी भाव रति (प्रेम) होता है । 'जनु प्रेम अरु सिंगार तनु धरि मिलत ।' मा० ७.५ छं० १ इस रस का श्याम वर्ण माना गया है। 'जन सोहत सिंगार धार मूरति परम अनूप । मा० १.२४१ (२) वेषविन्यास, भूषण आदि की सजावट । 'बिधवन्ह के सिंगार नबीना ।' मा० ७.६६.५ (३) अलंकरण । 'निसि सुंदरी करे सिंगारा।' मा० ६.१२.३ (४) कामभोग।।
सिंगारु, रू : सिंगार+कए० । (१) शृङ्गार रस । 'सोभा रज मंदर सिंगारू ।' मा० १.२२७.८ (२) अलंकरण । (३) वेषविन्यास । 'करि सिंगरू सखीं ले आई।' मा० १.१००.५ (४) कामभोग, रतिक्रीडा । 'जगत मातु पितु संभु भवानी । तेहिं सिंगारु न कहउँ बखानी।' मा० १.१०३.२
सिंघ : सिंह (प्रा.)। (१) केसरी । सिंघ कंध आयत उर सोहा ।' मा० ५.४५.५ (२) श्रेष्ठ+सिंह के समान । 'पुरुष-सिंघ बन खेलन आए ।' मा० ३.२२.३
सिंघनाद : सिंहनाद । मा० ६.३६.६
सिंघनदु : सिंघनाद+कए । कवि ५.६
सिंघल : सं०पु० (सं० सिंहल) । लङ कादीप । मा० २.२२३
1059
सिंघासन : सिंहासन । मा० ७.१०.५
सिंघासनु : सिंघासन+कए । मा० १.१००.३
सिधिनि, नी : सिंघ+स्त्री० (सं० सिंही)। मा० २.३६
सिंदूर : सं०० (सं०) । सेंदुर । जा०म०छं० १८
सिंधु : सं०० (सं०) । समुद्र । मा० १.१.१४
सिंधुर : सं०० (सं०)। हाथी । मा० १.३३३.७
सिंधुरगामिनी : गजगामिनी । मा० ७.३.६
सिंधुरबदन : गजानन । मणेश । रा०प्र० १.१.२
सिंधुरमनिमय : गजमुक्ताओं से निर्मित । मा० १.२८८.७
सिंधुसुत : (१) विष । (२) जलन्धर दैत्य (?)। विन० ४६.७
सिंधुसुता : समुद्र की पुत्री= लक्ष्मी । मा० १.१८६ छं० १
सिंधो : सिंधु+संबोधन (सं.)। मा० ७.१८.१
सिसुपा : संस्त्री० (सं० शिशुपा)। सीसम वृक्ष । मा० २.८६.४
सिंह : सं०० (सं०) । (१) मृगराज, हिंसक वन्य जन्तु विशेष। मा० ६.१८ (२) (समासान्त में) सिंह के समान, श्रेष्ठ । 'पुरुषसिंह दोउ बीर ।' मा० १.२०८
सिंहनाद : सिंह तुल्य गर्जन । मा० ६.५०
सिंहासन : सं०० (सं.)। सिंह प्रतिमाओं से सुसज्जित राजपीठ +सिंह तुल्य  राजा का आसन । राजगद्दी, राजासन । मा० ६.१०६.६
सिंहासनु : सिंहासन+कए । मा० २.१०५.७ ।
सिंहिका : सं०स्त्री० (सं.)। राहु की माता राक्षसीविशेष । हनु० २७
सिअनि : संस्त्री० (सं० सीवनी>प्रा० सिअणी>अ० सिअणि)। सिलाई। ___सिअनि सुहावनि टाट पटोरें ।' मा० १.१४.११
सिअरें : (सं० शीतलेन>प्रा० सीअलेण>अ० सीअलें)। ठंढे.. से । 'सिअरें बचन सूखि गए कैसें ।' मा० २.७१.५
सिआर, रा : सं.पु. (सं० श्रगाल>प्रा० सिआल)। गीदड़। मा० २.१५८.५% ६७.७
सिकता : सं०स्त्री० (सं०) । बालू । मा० ७.१२२ क
सिख : (१) सं०स्त्री० (सं० शिक्षा>प्रा. सिक्खा>अ० सिक्ख) । उपदेश । सीतलि सिख दाहक भइ कसें ।' मा० २.६४.२ (२) (सं० शिखा)। चोटी । 'नख सिख खोटी।' मा० २.१६३.७ 'नख सिख सुदक ।' मा० १.२१६
सिखंड : सं०० (सं० शिखण्ड)। (१) मोरपक्ष । (२) मुकुट के बाहर के घुघराले बाल ; अलकावलि । 'सिरनि सिखंड सुमन दल मंडन ।' गी० १.५६.५
1060
_______________________________________________
सिख सिखइ : आ०प्र० (सं० शिक्षते>प्रा० सिक्ख इ)। सीखता है, अभ्यास करता है । 'सिख इ धनुष विद्या बर बीरू ।' मा० २.४१.३
सिखइअ : आ०कवा०ए० । सिखाइए, उपदेश कीजिए, सिखाया जाय । 'तजि सकोच सिख इअ अनुगामी।' मा० २.३१४.७
सिखई : भूकृस्त्री० (सं० शिक्षिता>प्रा० सिक्खि आ =सिक्खविआ)। सिखाई, शिक्षित की। 'के ये नई सिखी सिखई हरि ।' कृ० ४१
सिखन : (१) सं०० (सं० शिक्षण>प्रा० सिक्खण)। सीखना । गी० ७.२३.२ (२) भक० अव्यय । सीखने । “सीक धनुष हित सिखन सकुचि प्रभु लीन्ह ।' बर०८
सिखब : भकृ.पु० (सं० शिक्षितव्य >प्रा० सिक्खि अन्व) । सीखना, सीखना (होगा, ___चाहिए)। 'राम लखन सब तुलसी सिख ब न आन ।' बर० ४६
सिखये : भूक००० । शिक्षित किये, बताये । 'मुनिबर सिखये लोकिको बैदिक बिबिध बिधान ।' गी० १.५.४
सिखयो : भूकृ००कए। सिखाया, सिखाया हुआ। 'देत सिख, सिखयो न मानत ।' विन०१५८.२
सिखर : सं०० (सं० शिखर) । चोटी, शृङ्ग । मा० १.१५६
सिखरन, ति : सिख+पंब० । शिखरों। सिख रन पर राजति कंचन दीप अनी।' गी० ७.२०.२ मिनहुँ हिमालय सिख रनि लसहिं अमर मगनै नि ।' गी० ७.२१.१६
सिखव सिखवइ : आ०ए० (सं० शिक्ष यति>प्रा० सिक्खावइ=सिक्खवइ) । सिखाता है । 'नप हित हेतु सिखव नित नीती।' मा० १.१५५.३
सिखवत : वकृ०० (सं० शिक्षयत्>प्रा. सिक्खावंत=सिक्खवंत)। सिखाता सिखाते । 'ऊधो परम हितू हित सिख वत ।' कृ० ४५
सिखवति : वकृ॰ स्त्री० । सिखाती । गी० १.३२.१
सिखवन : सं०० (सं० शिक्षण>प्रा. सिक्खावण-सिक्ख वण) । सिखाना, उपदेश । विन० १५९.४
सिखवनु : सिखवन+कए । उपदेश । 'सुदरि सिखावनु सुनहु हमारा।' माल २.६२.२
सिखवहिं : आ.प्रब० (सं० शिक्षयतिन्त>प्रा० सिक्खावंति =सिक्खवंति>अ० सिक्खावहि सिक्कावहि) । सिखाते-ती हैं। नारि धरम सिखावहिं मदु बानी।' मा० १.३३४.६
सिखवौ : सिखावहु (अ० सिक्खाबहु) । सिखावो, समुझावो। 'ब्रह्मा कहैं, गिरिजा सिखावी, पति रावरो दानि है बावरो भोरो।' कवि० ७.१५३
सिखा : सं-स्त्री. (सं० शिखा)। (१) शिखर । (२) वृक्षादि का ऊपरी भाग । (३) दीपक या अन्नि की लो । मा० ७.११८.१ (४) चोटी। 'मोर सिखा ।' दो० ३१६ सिरनि सिखा सुहाइ ।' गी० १.५३.२
सिखाइ : पू० । सिखाकर, समझाकर । 'बिरंचि गे देवन्ह इहइ सिखाइ।' मा० १.१८७
सिखाईं : सिखाई+व० । शिक्षित की। 'कुलरीति सिखाईं।' मा० १.३३६.१
सिखाई : सिखाई । शिक्षित की, बताई-पढ़ाई। 'असि मति केहिं सठ तोहि सिखाई।' मा० ६.१०.२
सिखाउ : शिखा भी (लो भी) । 'दीप-सिखाउ ।' बर० ३१
सिखाए, ये : सिखाये । शिक्षित किये । मा० ७.८.५
सिखायो : सिखायो । मा० ६.१०८.६
सिखाव सिखावइ: सिखाव । 'पुनि पुनि मोहि सिखाव सुबोधा।' मा० ७.१०६.८
सिखावत : सिखावत । 'मोहि सिखावत ग्यान ।' मा० ६.९०
सिखवति : सिखावति । 'मातु सिखावति स्यामहि ।' कृ० ५
सिखावतीं : सिखावति+ब० । सिखातीं। कवि० १.१३
सिखावन : (१) सिखावन । उपदेश, शिक्षण। 'नारि सिखावन करसि न काना।' मा० ४.६.६ (२) भक० अव्यय । सिखाने । 'लागेसि मढ़ सिखावन मोही।' मा० ५.२४.३
सिखावनु : सिखावन+कए । सीख, उपदेश । 'तुम्ह से सठन्ह सिखावन दाता।' मा० ५.२१.७
सिखावहिं : सिखवहिं । 'नाना भौति सिखावहिं नीती।' मा० ७.२५.३
सिखावहु : आ०मब० (सं० सिक्षयत>प्रा० सिक्खावह>अ० सिक्चावहु) । सिखालावो, बतावो । 'उठि किन मोहि सिखावहु भाई ।' मा० ६.६१ १६
सिखावा : भूकः । सिखालाया, सिखाई बात । 'न सुनइ सिखावा । मा० १.७८.५
सिखावौं : आ० उए । सिखालाता हूं, उपदेश देता हूं। 'कहि कहि सबहि सिखावौं।' विन० १४२.५
सिखि : (१) पूक० । सीखाकर । 'जो लौं हौं सिखि लेउँ ।' गी० ७.२६.१ (२) आ०-आज्ञा---मए० । तू सीखा ले। 'सेइ साधु गुरु, समुझि सिखि राम भगति थिरताइ ।' दो० १४० (३) सिखी । मयूर । 'गच काँच लखि मन नाच सिखि जनु ।' गी० ७.१८.१
सिखिनि, नी : सं०स्त्री० (सं० शिखिानी) । मयूरी। 'मनहुँ सिखिानि सुनि बारिद नादू ।' मा० १.२६५.३
सिखिहि : आ०-भूक०स्त्री०+मए । तूने सीखी है। 'मूढ़ सिखिाहि कह बहुत मुठाई।' मा० ६.३४.५ है

सिखी : (१) भूकृ०स्त्री० । सीखी, पढ़ी। 'के ये नई सिखी सिखाई हरि ।' क० ४१ (२) सीखी हुईं (ऊपरी, अस्वाभाविक, कृत्रिम)। 'लागति प्रीति सिखी सी।' गी० २.५२.४ (३) सं०० (सं० शिखिन्-शिखी) । अग्नि । विन० १६१.३ (४) मोर पक्षी।
सिखे : भक००ब० । (१) सीखो हुए, दूसरे से सीखकर अभ्यस्त किये हुए (ऊपरी)। 'सकुचत बोलत बचन सिखो से ।' मा० २.३०३.३ (२) सीख गये (जान गये) । 'अब हीं तें ये सिखो कहा धौं चरित ललित सुत तेरे।' क०३
सिगरियै : (दे. सगरे)। सब-की-सब, पूरी-पूरी। 'सिगरिय हो ही खोही, बलदाऊ को न देहौं ।' कृ० २
सित : (१) वि० (सं.)। श्वेत । मा० २.२.७ (२) नील (शिति) । 'तहं जनु बरिस कमल सित श्रेनी ।' मा० १.२३२.२
सितपख सितपाख : शुक्ल पक्ष (सं० पक्ष>प्रा० पक्खा) । गी० १.२.२; पा०म०१
सितलाई : आ.प्रए० (सं० शीतलायते>प्रा० सीअलाइ)। ठंढा हो जाता है। 'अनल सिनलाई।' मा० ५.५२
सितासित : (सित+असित) श्वेत-कृष्ण (गङ्गा-यमुना का जल)। 'सबिधि सितासित नीर नहाने ।' मा० २.२०४४
सिथिल : वि० (सं० शिथिल) । ढीला-ढीले; विशृङ्खल (विकल) । 'ब्याकुल राउ  सिथिल सब गाता ।' मा० २.३५.१
सिद्ध : सं+वि० (सं०) । (१) सफल, पूर्ण । 'सकल काजु भा सिद्ध तुम्हारा।' मा० १.१८६.७ (२) बाणिमा आदि सिद्धियों को प्राप्त योगी। 'होहिं सिद्ध अनिकादिक पाएँ ।' मा० १.२२.४ (३) युक्त योगी जो साधना पूरी करके असम्प्रज्ञात समाधि में लीन हो जाता है । 'साधक सिद्ध बिमुक्त उदासी ।' मा० ७.१२४.५ (४) दिव्य जातिविशेष जो यक्ष आदि के समान अंशत: देवों में गिनी जाती है। किनर नाग सिद्ध गंधर्वा ।' मा० ६.६१.१ (५) सिद्धि प्राप्त, साधना में सफल । 'जौं प्रभु सिद्ध होइ सो पाइहि । खल मायाबी जीति न जाइहि।' मा० ६.७५.५ (६) सिद्धान्त, बिना पकाया हुआ दाल, चावल आदि सामग्री । 'तहँ तहँ सिद्ध चला बहु भाँती।' मा० १.३३३.३
सिद्धनि : सिद्ध+संब० । सिद्धों (ने) । 'सुर सिद्धनि बरदान दए।' गी० १.४५६
सिद्धपीठु: सिद्धपीठ+कए०। (१) योगसिद्धि के उपयुक्त स्थान या तीर्थ । (२) सिद्धासन, योगसाधना में उपयोगी आसन विशेष । 'लंक सिद्धपीठ निसि जागो है मसानु सो।' कवि० ५.२८
सिद्धांत : सं०० (सं.)। सिद्ध मत; प्रमाणित मान्यता । मा० ७.८६.२
सिद्धि : सं०स्त्री० (सं.)। (१) कार्य-फल की प्राप्ति, सफलता । 'सकल सिद्धि सुख संपत्ति रासी।' मा० १.३१.१३ (२) साधना की पूर्ति । 'कवनिउ सिद्धि कि बिनु बिस्वासा ।' मा० ७.६०.८ (३) अष्ट सिद्धियां-अणिमा, महिमा, लघिमा, गरिमा, प्राप्ति, प्राकाम्य, ईशित्व, वशित्व । 'ऋद्धि सिद्धि कल्यान मुक्ति नर पावह हो ।' रान० २० (४) निष्पत्ति, भाव पुष्ट संवेदन (गणेश पत्नी सिद्धि)। राम भगति रस सिद्धि हित भयउ सो समउ गनेसु ।' मा० २.२०८ (५) गणेश पत्नी (जो कार्य पूर्ति का प्रतीक है) । 'सुमिरे सिद्धि गनेस ।' मा० १.३३८
सिद्धिउ : सिद्धि भी । सिद्धिउ नाउँ कलंक ।' दो० २६०
सिद्धिद, प्रद : सिद्धिदायक । मा० ७ श्लोक ३; १.३५.५
सिधरिहहिं : आ०भ०प्रब० । सिधारेंगे, जायंगे (प्राप्त करेंगे)। 'ते तनु तजि मम लोक सिधरिहहिं ।' मा० ६.३.१
सिधाई : भक०स्त्री•। प्रस्थित हुई, चली गयी । 'पुनि त्रिजटा निज भवन सिधाई।' मा० ६.१००.१
सिधाए : भूकृ.पुब । प्रस्थित हुए। 'सनकादिक बिधिलोक सिधाए।' मा० ७.७६.१
सिधायउ : भूकृ.कए । प्रस्थान किया। 'गाधि सुवन तेहि अवसर अवध सिधायउ ।' जा०म० १५
सिधायक : (सिधाय+क) सिधाने का, प्रस्थान का, जाने का। 'मरिहि नपु सुनि संदेस रघुनाथ सिधायक ।' गी० २.३.३
सिधायो : सिधायउ । मा० ६.११७.३
सिधारहिं : आ०प्रब० । सिधारें, प्रस्थान करें, जायँ । पा०म०६६
सिधारा : भूक०० । गया । 'राम कृपा बैकुंठ सिधारा ।' मा० ३.६.१
सिधारि : आ०-आज्ञा+प्रार्थना.-मए । तू प्रस्थान कर । 'मधुप अनत सिधारि।' कृ० ५३
सिधारिए : आ० भावा० । प्रस्थान कीजिए, जाइए। 'घरनि सिधारिए सुधारिए आगिलो काज ।' गी० १.८४.८
सिधारी : भूक स्त्री० । चली गई। मा० ५.१२.६
सिधारे : भूक००ब० । प्रस्थित हुए, गये । मा० १.२०५.३
सिधारो : भूकृकए । गया । 'बन सब लोग सिधारो।' गी० २.६६.४
सिधावहिं, हीं : आ०प्रब० । जाते हैं (सीधे पहुंचते हैं) । 'राम धाम सिधावहीं।' मा० ७.१३० छं. २
सिधावहु : आ०मब० । जाओ, प्रस्थान करो । 'मारुत-सुत के संग सिधावहु ।' मा० ६.१०८.४
सिधावा : भूक०० । गया, प्रस्थित हुआ। मा० ५.६०.८
सिधावी : सिधावहु । 'बहुरो बनहि सिधावी।' गी० २.८७.१
1064
_______________________________________________
सिधि : सिद्धि । मा० ७.८३
सिधैहैं : आ०म०प्रब० । जायंगे । 'पथिक कहाँ धौं सिधे हैं ।' गी० २.३७.१
सिबि : सं०० (सं० शिवि) । उशीनर देश का एक राजा जिसने अग्नि (कबूतर) और इन्द्र (बाज) की परीक्षा में अहना शरीरदान कर दिया था। मा० २.३०.७
सिबिका : संस्त्री० (सं० शिविका। पालकी । मा० ६.१०८.७
सिमिटि : समिटि । 'होहिं सिमिटि इक-ठाई ।' विन० १०३.४
सियँ : सीता ने । 'लखन सचिवें सिय किए प्रनामा ।' मा० २.८७.३
सिय : सीय । सीता। मा० २.६४.१
सियत : वकृ०० (सं० सीव्यत्>प्रा० सियंत)। सिलता-सिलते । सिलाई करता करते । गगन मगन सियत ।' विन० १३२.३ ।।
सियनि : (१) सिअनि । (२) सूई । 'अकास मह चाहत सियनि चलाई।' कृ० ५१
सियबटु : सीताबाटु । कवि० ७.१४०
सियरवनू : (दे० रवन) । सीता-पति-राम । मा० २.२२७.१
सियरे : क्रि०वि० (सं० शीतले>प्रा० सीचले) । ठंढ में, छाया में। 'ठाढे सुरतर सियरे ।' गी० १.८३.२
सियहि : सीता जी को। तासु बचन अति सियहि सोहाने ।' मा० १.२२६.७
सिया : सीया। सीता जी । कवि० १.१२ सियार ; सिआर । रा०प्र० ५.६.३
सियो : भूक००कए० (सं० स्यूतः>प्रा० सिइओ) । सिला, प्रथित किया, बांध कर दढ किया। विधाता निज कर यह संजोग सियो री।' गी० १.७६.३
सिर : (१) सं०पू० (सं० शिरम् >प्रा० सिर) । मस्तक भाग। मा० १.११.१ (२) (अव्ययात्मक प्रयोग) पर, अनुसार । 'कही समय सिर भरत गति ।' मा० २.२८७
सिरउ : सिर भी । सिरउ गिरे संतत सुभ जाही।' मा० ६.१४.४
सिरताज : सं०+वि० (फा० सिरताज)। मुकुट-तुल्ल, शिरोमणि, श्रेष्ठ । 'सकल भूप सिरताज ।' मा० १.३२९
सिरताजु : सिरताज+कए । एक तम श्रेष्ठ । कवि० ५.२२
सिरनि, न्ह, न्हि : सिर+संब० । (१) सिरों। 'बैठहिं गीध उड़ाइ सिरन्ह पर।' मा० ६.८६.१ (२) सिरों पर । 'गिरि निज सिरनि सदा तृन धरहीं।' मा० १.१६७.७; ६.३२.६ (३) सिरों के । 'सि रन्हि समेत ।' मा० ६.३३.६
सिरमति : (१) सिरोमनि । श्रेष्ठ । 'पुरजन सिरमनि राम लला ।' गी० १.२२.५ (२) सिरकी मणि । 'फनिकन्ह जनु सिरमनि उर गोई।' मा० १.३५८.४ प्रथम के साथ भी द्वितीय अर्थ की व्यञ्जना होती है ।
_______________________________________________
1065
सिरमोर, मौर : (दे० मौर) संपु+वि० सं० शिरोमकुट>प्रा. सिरम उड) । सिर पर मुकुट के समान = श्रेष्ठ, शिरोमणि । 'किए साधु सिरमौर ।' मा. २.२६४
सिररुह : सं०० (सं० शिरोरुह)। केश, सिर के बाल । मी० ७.३.३
सिरस : सिरिस । 'सिरस सुमन कन बेधिअ हीरा।' मा० १.२५८.५
सिरसि : (सं० शिरसि) सिर पर । गी० १.४३.२
सिरा : सिर । मा० ३.२० छं०
सिरा, सिराइ, ई : आ०ए० । सिर तक पहुंचता है, अन्त पाता है । 'रूप रासि गुन कहि न सिराई ।' मा० १.१६३.८
सिराइ : पू० । पार कर । 'बिनु स्रम रहे सिराइ ।' मा० २.१२३
सिरात : वकृ०० । पार पाता । 'केहि भांति बरनि सिरात ।' मा० १.३२५ छं०१
सिराति, ती : वकृ०स्त्री० । पार होती (बीतती)। 'सि राति न राती।' मा० ६.१००.३
सिरातो : कृियाति पुए । तो पार पा जाता। 'भव मग अगम अनंत है बिन स्रमहि सिरातो।' विन० १५१.७
सिरान : भक०० । सिरे पर पहुंच गया (समाप्त हो गया) । 'सबु सुख सुकृतु सिरान हमारा।' मा० २.७०.४
सिरानि, नी : भूकृस्त्री० । अन्त पर पहुंची, बीती, समाप्त हुई । 'निसा सिरानि भयउ भिनुसारा ।' मा० ६.७८.३, १२२६.२
सिरानें : व्यतीत होने पर, समाप्त होने से । 'सुखी सिराने नेम ।' मा० २.२३६
सिराने : भूक०० ब० । बीत गये । 'ऐसेहिं जनम समूह सिराने ।' विन० २३५.१
सिरानो, न्यो : सिरान+कए। बीत गया, पार हुआ। सिरानो पथु छन में।' कवि ५.३१ जनम सिरान्यो ।' विन० ८८.४
सिरावै : आ०ए० (सं० शीतलयति>प्रा० सीअलावइ) । ठंढा करे । 'बुद्धि सिरावै  ग्यान घृत ।' मा० ७.११७
सिरावौं : आ०उए । पार करता हूं। 'नाथ कृपा भवसिंधु धेनु पद सम जो जानि ___सिरावौं ।' विन० १४२.११
सिराहिं, हीं : आ.प्रब० । (१) अन्त पर पहुंचते हैं। 'कहिं न सिराहिं।' मा० १.३४२.३ 'रघुपति चरित न बरनि सिराहीं ।' मा० ७.५२.४ (२) बीत जाते हैं, बीत जायें । 'मिलहि न पावक महं तुषारकन जो खोजत सत कलप सिराहीं।' कृ० ५८
सिरिजहिं : आप्रब० । सर्जन करें, रचें, बनाएँ । 'जगदीस जबति जनि सिरिजहिं ।' पा०म० २३
सिरिजा : भूक.पु । बनाया, रचा । 'अनल जेहिं सिरिजा।' मा० ५.२६.७
1066
सिरिस : सं०० (सं० शिरीष>प्रा० सिरीस=सिरिस) । वृक्ष विशेष जो ग्रीष्म में फलता है और उस के फूलों में अति-सूक्ष्म केसर ही गुथे होते हैं । 'भेद कि सिरिस सुमन कन कुलिस कठोरहि।' जा०म०६४
सिरु : सिर+कए । 'सीता चरन भरत सिरु नावा ।' मा० ७.६.२
सिरोमनि : सं+वि. (सं० शिरोमणि)। (१) सिर पर पहनी जाने वाली मणि, शिरोभूषण। (२) शिरोभूषण मणि के समान उत्तम, श्रेष्ठ । कृ० ४७ मा० १.२६.४
सिरोमने : सिरोमनि+सम्बोधन (सं० शिरोमणे)। मा० ७.१३ छं. १
सिल : (१) सिला । मसाला आदि पीसने का प्रस्तर खण्ड । 'फोरहिं सिल-लोढ़ा सदन लागें अढ़ क पहार ।' दो० ५६० (२) सं०० (सं० शिल) । कटै खेत में बचे-पड़े अन्न के दाने ।
सिलनि : सिला-+संब० । शिलाओं (चट्टानों) पर। 'सिलनि चढ़ि चितवन ।' गी० १.५२.५
सिलपोहनी : सं०स्त्री० (सं० शिलापोहन) । (१) विवाहोत्सव के पूर्व शिलापोहन कार्य होता है जब घर की सिल पर धोई आदि पीसने कार्य पूरा कर उस पूज दिया जाता तथा उत्सव भर उससे काम लेना बन्द करके मण्डप के स्तम्भ के पास रख दिया जाता है। (२) भावरों के समय वर उक्त सिल पर वधू को आरोहण कराता है जिसे 'अश्मारोहण' कहते हैं। फिर वर उस सिल को पर से हटाता-अपोहन करता है अत: 'शिलापोहन' का यह दूसरा अर्थ है। 'सिलपोहनी करि मोहनी मन हर्यो मूरति सांवरी ।' जा०म०० १८
सिला : (१) सं०स्त्री० (सं० शिला) । बड़ा प्रस्तर खण्ड या चट्टान । 'फटिक सिला।' मा० ५.२६.८ (२) सिल (सं० शिव) । 'रूप रासि बिरची बिरंचि मनो सिला लवनि रति काम ल ही री।' गी० १.१०४.४ (खेत की फसल कट जाने पर जो दाने छूट जाते हैं उन्हें आधुनिक अवधी में सीला' कहते हैं और गरीब लोग बीन लेते हैं)।
सिलाकन : सं०० (सं० शिलाकण) । पत्थ के छोटे टुकड़े । 'गिरि मेरु सिलाकन होत ।' कवि० २.५
सिलातल : संपू० (सं. शिलातल)। चट्टन का चौरस ऊपरी भाग। गी० २.४५.३
सिलिप : सं० (सं० शिल्प) । वास्तुकला, कारीगरी। रा०प्र०७.२.७
सिलिपि : संस्त्री० (सं० शैल्पी-शिल्पविद्या) वास्तुकला+मूतिकला की कारीगरी । दो० १८४
सिलीमुख : सं०पु० (सं० शिलीमुख) । (१) बाण (२) भ्रमर । 'रावन सिर सरोज बनचारी। चलि रघुबीर सिलीमुख धारी ।' मा० ६.६२.७
_______________________________________________
1067
सिलीमुखाकार : बाणों का आगार-तूणीर, तरकस । मा० ६.८६ छं०
सिलोक : सं०० (सं० श्लोक) । यश, कीति । 'पुन्य सिलोक तात तर तारें।' मा० २.२६३.६
सिल्पि : सं०० (सं० शिल्लिन्) । वास्तुकला कुशल ।
सिल्पिकर्म : शिल्पी का कार्य, शिल्पविद्या । सिल्पिकर्म जानहिं नल नीला।' मा० ६.२३.५
सिवँ : शिव ने । 'सिर्व राखी श्रुति नीति ।' मा० ७.१०६
सिव : सं०० (सं० शिव) । (१) कल्याण । 'आसिव बेष सिव धाम कृपाला।' मा० १.६२.४ (२) त्रिदेय में अन्यतम =शङक। मा० १.१५.८ (३) परमात्मा-दे० सीव ।
सिवता : सं०स्त्री० (सं. शिवता)। शिवत्व = कल्याणरूपता+प्रलयकारिणी शक्ति । विन० १३५.३ ।
सिवपुर : कैलास । मा० ३.२.४
सिवसैलु : (दे० सल) कैलास । मा० १.२६२.८
सिवहि : शिव को। शिव से । मा० १.३४.३ 'पूछा सिवहि समेत सकोचा ।' मा० १.५७.६
सिवा : सं०स्त्री० (सं० शिवा) । शिव की शक्ति पार्वती। मा० ७.५ छं० २
सिवार : सेवार=सैबल । विन० २.४४.३
सिष, ष्य : सं०पू० (सं० शिष्य)। विनेय छात्र, विद्यार्थी, दीक्षार्थी । मा० ७.६६.६
सिष्य : सिष । 'हरइ सिष्य धन सोक न हरई ।' मा० ७६६.७
सिसकत : वकृ. । सिसकता.ते । तीव्र लालसा वश 'सीचनी' करते; सिहाते ।  'जा को सिसकत सुर विधि हरि हर हैं।' गी० २.४५.५
सिसिर : सं०० (सं० शिशिर) । माघ-फाल्गुन का ऋतु । मा० ३.४४.६
सिसु : (१) सं० (सं० शिशु) । आठ वर्ष से कम वय का बालक (या बालिका) । मा० १ ६६.२ (२) बच्चा ।
सिसुचरित : बाललीला । मा० १.६६
सिसुन्ह : सिसु+संब। शिशिओं (ने)। राखेउ बांधि सिसुन्ह हय-साला ।' मा० ६.२४.१३
सिसुपन : सं०० (सं० शिशुत्व>प्रा० सिसुत्तण>अ० सिसुप्पण)। बचपन, लड़कपन । मा० ७.११ ख
सिसुपाल : सं०पू० (सं० शिशुपाल)। चेदि देश का एक राजा जो कृष्ण का फुफेरा ___भाई था और कृष्ण द्वारा ही मारा गया था। विन० २१४.४
सिसुबिनोद : बालक्रीडा । मा० १.२००.७
1068
_______________________________________________
सिसुलीला : बालविनोद । मा० १.१६२ छं०
सिसुहि : बच्चे को । 'सुरभी सनमुख सिसुहि पिआवा।' मा० १.३०३.५
सिस्नोवर : (सं० शिस्नोदर-शिस्न+उदर)। कामभोग और उदरपोषण (शिस्न = पुरुषत्व सूचक अङ्ग विशेष) ।
सिस्नोदरपर : कामसुख तथा उदरभरण में परायण, एकमात्र उन्हीं लौकिक सुखों को परम मानने वाले। 'सिस्नोदरपर जमपुर त्रास न ।' मा० ७.४०.१ '
सिहा, सिहाइ, ई : आ.प्रए० (सं० स्पृहायते>प्रा० सिहाई, छिहाइ)। उत्कट लालसा करता है, ललचाता है, विवश स्पर्धा करता है । 'अवधराजु सुरराज सिहाई ।' मा० २.३२४.६
सिहाउ, ऊ : आ०-आज्ञा+संभावना-प्रए । स्पृहा करे, ललचाए, सिहाए । थापिअ जन सब लोग सिहाऊ ।' मा० २.८८.७
सिहात : वकृ.पु । ललचाता-ते। जेहिं सिहात अमरावति पालू ।' मा० २.१६६.७
सिहानी : भूकृ०स्त्री० । ललचायी। 'देखत दुनी सिहानी।' गी० १.४.६
सिहाने : भूक००ब० । स्पहा-विह्वल हुए, ललच उठे। 'लोकपाल अवलोकि सिहाने ।' मा० १.३२६.६
सिहाहिं, हीं : आ०प्रब० । स्पृहा करते हैं, सिहाते हैं, ललचाते हैं । मा० १.३४४ ___'सुर सकल सिहाहीं।' मा० २.१०१.८
सिहाहुं, हूं : आ०-संभावना, कामना-प्रए । सिहाए। ललचाएँ । 'अब ते सकुचाहुं सिहाहूं।' विन० २७५.४
सिहोरे : सं०० (सं० शाखोटक>प्रा० साहोऽय) । झाड़ जैसे सिहोर वृक्ष को सिहोर उपयोगहीन वृक्षविशेष है)। 'तुलसी दल सैंध्यो चहै सठ साखि सिहोरे ।' विन० ८.४
सींक : सं०स्त्री० (सं० इषीका)। गांडर का लम्बा डंठल (मञ्जरी की नाल) । ___मा० ३.१.८
सींग : सं० +स्त्री० (सं० शृङ्ग>प्रा० सिंग) । पशु-मस्तक के शङ कु । कृ. ४६
सींच, सींचइ : .प्रए० (सं० सिञ्चति>प्रा० सिंचइ)। सिवत करता है; पानी डालता है । कोटि जतन कोउ सींच ।' मा० ५.५८
सींचत : वक०० । सींचता-ते । 'सींचत सीतल गरि ।' मा० २.१५४
सींचति : वक०स्त्री० । सींचती, सिक्त करती। रा०प्र० २.३.३
सींचहिं : आ.प्रब० (सं० प्रा० सिञ्चन्ति>अ० सिंचहि) । सींचते हैं । दो० ३७७
सींचा : (१) भूक । सिक्त किया (पानी डाला) । 'पेड़ काटि तै पाल उ सींचा।' मा० २.१६१.८ (२) सं० । स्नान, पानी का छींटा । जासु छांह छइ लेइअ सींचा ।' मा० २.१६४.३
_______________________________________________
1069
सींचि : पूक० । सींच कर, भिगो कर । निज लोचन जल सींचि जड़ाना।' मा० ४.३.६
सींचिए, ये : आ०कवा०प्रए । सिक्त कीजिए, आर्द्र कीजिए। 'राम कृपा जल ___ सींचिए । दो० २३६
सींचिबे : भक००। सींचने । 'सोइ सींचिबे लागि मनसिज के रहँट नयन नित रहत नहे री ।' गी० ५.४६.२
सींचिबो : भक०कए । सींचना । पात-पात को सींचिबो।' दो० ४५२
सींची : भक०स्त्री०ब० । सिक्त की। 'बीथीं सींची।' मा० १.२६६
सींचु : आo-आज्ञा-मए । तू सींच, सिक्त कर । 'सुचि सनेह जल सीचु ।' दो० २२०
सौंचे : भूकृ००० । सींचे हुए, सिक्त हुए । 'अनजल सींचे रूख ।' दो० ३१०
सींचै : सींचहिं । 'नीके सब काल सींचे सधासार नीर के ।' कवि० ५.२
सींचो : भूक०कए । सिक्त किया हमा, आर्द्र किया हुआ। 'बोरत न बारि ताहि जानि आपु सींचो।' विन० ७२.४
सींव, वा : सं० स्त्री० (सं० सीमा>अ० सीवा-सी) । परमावधि, परा काष्ठा, छोर, चरम बिन्दु। 'रघुपति करुना सीव ।' मा० ७.१८ 'अंगद हनूमंत बल सीवा ।' मा० ६.५०.२
सी : (१) सीय। सीता । छुट्यो पोच सोच सी को।' गी० १.८८.४ (२) वि. स्त्री । सदश। 'बिरची विधि सकेलि सुषमा सी।' मा० २.२३७.५ (३) मानों (उत्प्रेक्षा)। "सकुच वेचि सी खाई।' कृ०८ (४) पूक० (स.. स्यूत्वा>प्रा० सिविअ, सिइअ>अ० सिवि, सिइ)। सिल कर, सिलाई करके ! 'सेवक को परदा फट तू समरथ सी ले ।' विन० ३२.४ .
सीकर : सं०० (सं०) । जल आदि का कण, बूंद । मा० ७.५२.४ ।।
सीकरनि : सीकर+संब०। बदों (से)। कबहुंकि कांजी सीकरनि छीरसिंधु बिनसाइ ।' मा० २.२३१
सीख : सिख (सं० शिक्षा>प्रा० सिक्खा>अ० सिक्ख)। उपदेश । दो० ४२७
सीझे : भूकृ.पु.ब० । सिद्ध हुए (साधना की) । तप, तीर्थ स्नान आदि करके पवित्र हुए । 'कासी प्रयाग कब सीझे ।' विन० २४०.१
सीठि, ठी : वि०स्त्री० (सं० शिष्टा>सिट्ठी) । मधुर द्रव का बची तलछट (मीठी का विलोम) । अमधुर, माधुर्यहीन, रसहीन । 'तौं लौं सुधा सहस्र सम राम भगति सुठि सीठि।' दो० ८३
सीठे : वि०० ० । अमधुर (मीठे का विलोम); नीरस । 'तो नवरस षटरस रस अनरस ह जाते सब सोठे।' विन० १६६.१
2070
_______________________________________________
सीत : सं.वि.पु. (सं० शीत)। (१) शीतल, ठंहा। 'सुखद सीत रुचि चारु चिराना।' मा० १.३६.६ (२) जाड़े की ऋतु=शिशिर । 'सीता सीत-निसा सम .. आई।' मा० ५.३६.६
सीतल : वि० (सं० शीतल)। ठंडा, शीत लाने वाला। मा० १.१७.५ (२) ताप शामक ।
सीतलता : सं०स्त्री० (सं० शीतलता)। (१) ठंडक । (२) तापशामकता । विन० ६०.२ (३) मानसिक तापहीनता, करुणा आदि की द्रवरूपता। 'सीतलता सरलता मयत्री।' मा० ७.३८६
सीतलि : सीतल+स्त्री० । ठंडी+तापहीन । 'तोहिं देखि सीतलि भइ छाती।' मा० ५.२७.८
सीतहि : सीता को । मा० ७.६७.४
सीताँ : सीता ने । 'दुइ सुत सुंदर सीता जाए।' मा० ७.२५.६
सीता : संस्त्री० (सं.)। (१) ब्रह्म राम की आदि शक्ति=महामाया; विश्व प्रकृति, योगमाया । मा० १.१८ (२) जानकी । मा० १.२५५ (३) (व्यञ्जना में-सं० शीता) जानकी+ठंडी (जड़ कर देने वाली) । “सीता सीतनिसा सम आई ।' मा० ५.३६.६
सीताबटु : (दे० बटु) गङ्गा तट पर एक वटवृक्ष जिसे सीता जी द्वारा लगाया कहा गया है । कवि० ७.१३८
सीतानाथ, पति, बर : रामचन्द्र । मा० २.२६६; २.४३३; ७.७८.४
सीताबरु : सीताबर+कए । राम । विन० २०५.३
सीते : सीता+संबोधन (सं०) । हे जानकी। 'सीते पुत्रि करसि जनि त्रासा।' मा०३.२६.६
सीदत : वकृ.पुं० । अवसादग्रस्त रहता (रहते); कष्ट पाता (पाते) । 'सीदत सुसेवक बचन मन काय के।' हनु० ३१
सीदहिं : आ.प्रब० (सं० सीदन्ति) । अवसादग्रस्त रहते हैं; दुखी होते हैं, क्लेश पाते हैं । ‘सीदहिं बिप्र धेनु सुर धरनी ।' मा० १.१२१.७
सीदै : सीदहिं । 'फलै फूल फैले खल, सीदै साधु पल पल ।' कवि० ७.१७१
सीद्यमान : वि०० (सं.)। अवसादग्रस्त । 'लोग सीद्यमान सोचबस ।' कवि० ७.६७
सीधो : (दे० सिद्ध) कए० । सीधा-पकाने से पूर्व सूखा दाल, चावल आदि । 'पान पकवान बिधि नाना के, संधानो, सीधो, बिबिध बिधान धान बरत बखारहीं।' कवि० ५.२३
सीप : (१) सं०स्त्री० (सं० शुक्ति>प्रा० सुत्ती=सिप्पी>अ. सिप्पि) । सीपी । मा० १.११७ (२) (सं० सीप) नौकाकार पात्र विशेष ।
