288

चितभंग : सं०० (सं० चित्तभङ्ग)। (१) चित्त की टूटन, समूचे अन्त:करण  मन अहंकार और बुद्धि-की शक्तियों का भङ्ग =उत्साह की पूर्ण हानि+ (2) वदरिकाश्रम के मार्ग की एक पर्वतमाला जो यात्रियों का उत्साह भङ्ग करती है (चित्त को तोड़ देती है। मान मनभंग, चितभंग मद, क्रोधलोभादि पर्वत दुर्ग ।' विन० ६०.६
चितयउँ : आ० भकृ००+उए । मैंने देखा।' चितयउँ आँखि उधारि ।' मा० ७.७६ क
चितयउ : भूकृ००कए० । देखा । 'नपु चितयउ आँखि उधारि ।' मा० २.१५४
चितव, चितवइ : (सं० चित्रयति>प्रा. चित्तवइ-विस्मय आदि से देखना, ताकना) आ० प्रए० । साश्चर्य देखता है या देखती है। 'चकित चितव मुदरी पहिचानी।' मा० ५.१३.२
चितवत : वकृ०० (सं० चित्रयत् >प्रा. चित्तवंत)। (१) देखता, देखते। 'चितवत चकित धनुष मखसाला ।' मा० १.२६८.६ (२) देखते ही। 'चितवत काम भयउ जरि छारा।' मा० १.८७.६
चितवति : चितवत+स्त्री० । देखती। चितवति चकित चहूँ दिसि सीता।' मा० १.२३२१
चितवनि : सं०स्त्री० (सं० चित्रण>प्रा० चित्तवण) । ताकने या देखने की क्रिया जिसमें विस्मय का चित्र रंग हो। 'चितवनि चारु मार मन हरनी।' मा० १.२४३.३
चितवनियाँ : चितवनि+ब० । चितवनें । गी० १.३४.५
चितवनिहारा : वि.पु. । देखने वाला, ताकने वाला (दृष्टि डालने वाला)। 'को प्रभुसँग मोहि चितवनिहारा ।' मा० २.६७.७
चितवाहिं : आ०प्रब० (सं० चित्रयन्ति >प्रा० चित्तवंति>अ. चित्तवहिं) देखते-ती हैं। 'जहँ चितवहिं तहँ प्रभु आसीना।' मा० १.५४.६
चितवा : भूकृ.पु । ताका, साश्चर्य निहारा। 'फिरि चितवा पाछे प्रभु देखा।' मा० १.५४.५
चितवै : चितवहिं । ताकते हैं । 'मग चौंकि चकै चितवं चितु दै ।' कवि० २.२७
चितहि : चित्त को । 'चितवत चितहि चोरि जनु लेहीं।' मा० १.२१६.७
चिता : संस्त्री० (सं.)। शवदाह की काष्ठ रचना विशेष । मा० २.१७०.४
चितु : चित+कए । अन्तःकरण । 'रघुपति पद सरोज चितु राचा ।' मा० १.२५६.४
_______________________________________________
289
चितरें: सं०० कर्त कारक (सं० चित्रकरण>प्रा० चित्तयरेण>अ० चित्तयरें)। चित्रकार द्वारा । 'चित्रित जनु रतिनाथ चितेरें।' मा० १.२१३.५
चितेरे : (१) सं००० (सं० चित्रकरा:>प्रा. चित्तयरा)। चित्रकार । (२) वि.पु.ब. (सं० चित्रीकृता>प्रा० चित्तयरिया)। चित्रित, चित्र में उरेहे हुए । 'रहे नर नारि ज्यों चितेरे चित्रसार हैं।' कवि० २.१४ ।
चितेरो: सं०+वि.पु.कए० (सं० चित्रकर:>प्रा० चित्तयरो)। चित्रकार । 'पिय चरित सिय चित चितेरो लिखत नित हित भीति ।' गी० ७.३५.४
चितै : (१) चितइ । देखकर । 'सैल सिखर चढ़ि चितै चकित चित अति हित बचन कह्यो बल भया ।' कृ० १६ (२) आ०-आज्ञा-मए० । तू देख । 'प्रात काल रघुबीर बदन छबि चितं चतुर चित मेरे ।' गी० ७.१२.१
चितैहैं : आ०भ०प्रब० । देखेंगे । 'बार-बार प्रभु तुम्हहि चितेहैं।' गी० ५.५१.६
चितैहौं : आ०भ० ए० । देखूगा । 'भूलि न रावरी ओर चितहौं।' कवि० ७.१०२
चितैहौ : आ०भ०मब० । देखोगे । 'रघुबीर मोहू चितैहो।' विन० २७०.१
चितौ : आ० आज्ञा-मए । तू देख । 'नेकु सुमुखि चितलाइ चितो री।' गी० १.७७.१
चित्त : सं०० (सं.)। अन्तःकरण =संकल्पात्मक मन, अभिमानात्मक अहंकार और निश्चयात्मक बुद्धि का समवेत सम स्वरूप। शैवदर्शन में चित्त प्रकृति पर्याय है जो उक्त तीनों की साम्यावस्था है-तीनों अन्तःकरण चित्त में एकीभत रहते हैं; विषय की प्रतिक्रिया के रूप में तीन व्यापार हो चलते हैं जो मन, अहम् और बुद्धि कहलाते हैं जो सशः राजस, तामस तथा सात्त्विक हैं। 'अहंकार सिव, बुद्धि अज, मन ससि, चित्त महान् ।' मा० ६.१५ क
चित्तनि : चित्त+संब० । चित्तों (में) । हनु० ४
चित्र : (१) सं०० (सं.)। आलेख्य । मा० १.२६० (२) आश्चर्य, विस्मयपूर्ण दश्य । 'खगमग चित्र बिलोकत बिच-बिच ।' गी० १.५५.५ (३) वि०॥ चित्रपर्ण, विविध रंगों से युक्त । 'चित्र चारु चौंके रची।' गी० १.६.७
चित्रकूट : सं०पु० (सं०) । विविध रंगों से युक्त विस्मयजनक शिखरों वाला= पर्वत विशेष । मा० १.३१
चित्रकेतु : एक निशाचर का नाम । मा० १.७६.२
चित्रलिखित : चित्र में बनाया हआ। 'चित्रलिखित कपि देखि डेराती।' मा० २.६०.४
चित्रसार : चित्रसाला । कवि २.१४
चित्रसाला : संस्त्री० (सं० चित्रशाला)। वह शाला जिसमें चित्र बने हों। मा० ७.२७
290
चित्रित : भूकृ०वि० (सं.)। चित्र किया हुआ । 'चित्रित जनु । रतिनाथ चितेरें ।' मा० १.२१३.५
चिदबिलास : सं०० (सं० चिद्विलास)। चैतन्य का विलास, आत्मतत्त्व का प्रसार । परमात्मा का प्रपञ्च रूप में लीला विस्तार । विन० १२४.५
चिदानंद : (चित्+आनन्द) । चैतन्य तथा आनन्द । 'चिदानंद सुखधाम सिव ।' मा० १.७५
चिदानंदमय : चैतन्य तथा आनन्द गुणों से परिपूर्ण। मा० २.१२७.५
चिदानंदु : चिदानंद+कए० । चैतन्य तथा आनन्द कल्याण गुणों वाला-ब्रह्म । 'चिदानंदु निरगुन गुनरासी ।' मा० १.३४१.६
चिनमय : वि० (सं० चिन्मय) । चैतन्यस्वरूप, चैतन्यपूर्ण । 'राम ब्रह्म चिनमय अबिनासी ।' मा० १.१२०.६
चिन्तक : वि०० (सं.)। ध्यान करने वाला । मा० ७ श्लो०१
चिन्ह : सं०० (सं० चिह्न>प्रा. चिण्ह) पहचान, लक्षण । 'द्विज चिन्ह जनेउ ।' मा० ७.१०१.७
चिन्हारी : सं०स्त्री० (सं० चिह्नकारि:>प्रा. चिण्हारी)। परिचयक्रिया । 'असमय जानि न कीन्हे चिन्हारी।' मा० १.५०.२
चिपिटि : पू० । चिपटा हो (कर) । 'चारिइ चरन के चपेट चा चिपिटि गो।' कवि० ४.१
चिबुक : सं०पु० (सं०) । ठोड़ी, ठुड्डी । मा० १.१४७.१
चिया : सं०स्त्री० । फली (इमली आदि की) । विन० ३३.२
चिर : अव्यय (सं.)। बहुत समय, सदा । 'सकल तनय चिर जीवहुं ।' मा० १.१९६
चिरजीबी : वि.पु. (सं० चिरजीविन्) । दीर्घायुष्म । मा० २.२८६.७
चिराना : भू० कृ०पु० (सं० चिरायित >प्रा. चिराण)। अधिक समय ठहरा हुआ । 'सुखद सीत रुचि चारु चिराना ।' मा० १.३६.६
चिराव, चिरावइ : (सं० चिराययति-चिरि हिंसायाम् +प्रेरणा>प्रा० चिरावइ-चीरा लगवाना, शल्यक्रिया करवाना) आ० प्रए । चीरा लगवाता ती है। 'मात चिराव कठिन की नाईं।' मा० ७.७४.८
चिरु : क्रि०वि० (सं० चिरम् >प्रा. चिरं>अ० चिरु) । सदैव, बहुत समय तक । ___चिरु जीवहुं सुत चारि ।' मा० १.२६५
चीखा : भू००० (प्रा० चक्खिअ)। चखा, स्वाद लिया। 'डारि सुधा विषु चाहत चीखा ।' मा० २.४७.३
_______________________________________________
291
चीठी : संस्त्री० । चिट्ठी, पत्र । 'राम लखन उर कर बर चीठी।' मा० १.२६०.५ चिट्ठ', परवाने, आदेशपत्र, (उच्चपद के) नियक्ति पत्र । 'नाम की लाज राम करुनाकर केहि न दिए कर चीठे ।' विन० १६६.३
चीत, चीता : चित्त । 'जा को हरि बिनु कतहुं न चीता।' वैरा० १४
चीन्हा : (१) चिन्ह । लक्षण, प्रतीक । 'मन कपटी तन सज्जन चीन्हा ।' मा० १.७६.४ (२) भूकृ०० । पहचाना, चिन्हों से जाना । 'नामु जान पै तुम्हहि न चीन्हा ।' मा० १.२८२.२
चीन्ही : पूकृ० । पहचान कर । 'हरष हृदय निज नाथहि चीन्ही।' मा० ४.२.७
चीन्हें : पहचान लेने पर । 'कर्म कि होहिं स्वरूपहि चीन्हें ।' 'मा० ७.११२.३
चीन्हे : भूकृ००० । पहचाने, लक्षित किये । 'तिन्ह कहं कहिअ नाथ किमि चीन्हे ।' मा० १.२६२.३
चीन्हो : चीन्ह्यो। (१) पहचाना, लक्षित किया। 'चीन्हो री सुभाय तेरो।' क० १५ (२) पहचान में आया हुआ । 'चीन्हो चोर जिय मारिहै ।' विन २६६.४
चीन्ह् यो : भूकृ०० कए० । पहचाना, जाना । 'तं तउ न चीन्ह्यो। कवि ६.१८
चीर : सं०० (सं.) (१) वस्त्र । मा० १.२६२ (२) वस्त्रखण्ड । 'पहिरे बल कल चीर ।' मा० २.१६५
चीरा : चीर। मा० १.१०६.६
चीरि : पूक। चीरकर, फाड़कर । 'चीरि कोरि पचि रचे सरोजा।' मा० १.२८८.४
चीरी : संस्त्री० (सं० चीरि, चीरिका=झींगुर)। पतिंगा। 'चीरी को मरनु खेल बालकन को सो है।' हनु० २६ (बच्चे पतिगे को तागे में बांध कर खेलते हैं ।)
चुबत : वक०० (सं० चुम्बत् >प्रा० चुबंत)। चूमता, चूमते । 'धवल धाम  ऊपर नभ चुंबत)।' मा० ७.२७.७
चुंबति : चुबत+स्त्री० । चूमती। 'मुख चुबति माता ।' मा० २.५२.३
चुआ : चौपाया (?)। चारु चुआ चहुं ओर चलें ।' कवि० ७.१४३
चुक, चुकइ : (सं० च्युत्करोति>प्रा. चुक्क इ-चूकना, हुचना, लक्ष्य का असफल रह जाना) आ०प्रए० । चूकता-ती-है । 'चुक इ न घात मार मुठभेरी।' मा० २.१३३.४
चुकाहीं : आ.प्रब० । चूकते हैं, अवसर खोते हैं । 'तेउ न पाइ अस समउ चुकाहीं।' मा० २.४२.४
292
_______________________________________________
चुकें : समाप्त होने पर, चूक जाने पर, खोदने के बाद । 'समय चुके पुनि का पछितानें ।' मा० १.२६१.३
चुके : चुके । 'चुके अवसर मनहुं सुजनहि सुजन सनमुख होइ।' गी० ५.५.४
चुकै : चुकइ । चूक जाय । ‘अवसर कौड़ी जो चुके, बहुरि दिएं का लाख ।' दो०
चुचाते : वक००ब० । अतिशय स्राव करते, धारा बहाते । 'झूमत द्वार अनेक मतंग जंजीर जरे मद अंबु चुचाते ।' कवि० ७.४४
चुचुकारि : पूकृ० । चू-चू ध्वनि करके । (१) बालक को दुलराने की ध्वनि । गी. १.११.२ (२) पशु को रोकने की ध्वनि । 'उतरि-उतरि चुचुकारि तुरंगनि सादर जाइ जोहारे ।' गी० १.४६.१
चुचकारे : भूकृ.पुं०ब० । मुख ध्वनि विशेष से दुलराए हुए । गी० २.८७.२
चुटकी : सं०स्त्री० । अंगुलियों से की हुई ध्वनि विशेष --चुटचुटाहट । 'किलकि किलकि नाचत चुटकी सुनि ।' गी० १.३२.५
चुन, चुनइ : (सं० चिनोति>प्रा. चुणइ-बीनना, चयन करना या चुगना) __ आ०प्रए । चुनता-ती है । 'मुकुताहल गुनगन चुनइ ।' मा० २.१२८
चुनि : प्रकृ० । चुनकर, चयन करके । मा० ३.१.३
चुनिन : चुनी+संब० । चुनियों, जड़ाव की मूल्यवान् कणिकाओं । 'कनक चुनिन सों लसित नहरनी लिए कर हो।' रा०न० १० (सं० 'चूणि' मूलत: चूर्ण-पर्याय है । परन्तु उससे निष्पन्न 'चुन्नी' या 'चुनी' सोने-चांदी आदि के उन दोनों का अर्थ आता है जो जड़े जाते हैं । उन दोनों से युक्त गोटे को भी 'चुनी' कहा जाता है।)
चुनौती : सं०स्त्री० (सं० चय+पत्री>प्रा० चुणवत्ती) लड़ाई के लिए चयन करने की चिट्ठी, ललकार, आह्वान । 'ताके कर रावन कहुं मनहुं चुनौती दीन्हि ।' मा० ३.१७
चुप : (१) वि० (सं० चुप-चुप मन्दायां गतो) । मौन, वाचंयम । 'पहिं रहे रघुनाथ सकोची।' मा० २.२७०.३ (२) सं०स्त्री० । चुप्पी । 'देखि दसा चुप सारद साधी ।' मा० २.३०७.२
चुपकि : पूकृ० । चुप्पी साध कर, मौन होकर । 'चुपकि न रहत, कह्यो कछु चाहत ।' कृ० ११
चुपचाप : वि०+क्रि०वि० (सं० चुप मन्दायां गतौ+चप सान्त्वने) । मौन शान्त । सब चुपचाप चले मग जाही।' मा० २.३२२.२
_______________________________________________
293
चुपरि : पू० । चुपड़कर । (१) घी आदि से स्निग्ध करके । 'रोटी चिकनी चुपरि के तू दे री मैया ।' कृ० २ (२) तेल लगाकर । 'चुपरि उबटि अन्हवाइ के।' गी० १.१०.१
चुव→ चुवइ : (सं० श्चोतते>प्रा०चुअइ-चूना, टपकना, साव करना) आ०प्रए । चूता है, टपकती है । 'बोलत बोल समृद्धि चुवै ।' कवि० ७.१८०
चुवत : वकृ०० । चूता, चूते । 'जलकन चुवत लोचन चारु ।' कृ० १४
चुवन : भूकृ. अव्यय । चूने , टपकने । 'लागे लोचन चुवन ।' गी० ५.४८.२
चुवाइ : पू० (सं० श्चोतयित्वा>प्रा. चुआइअ>अ. चुआइ) । रस टपकाकर ।  'सुचि बचन कहैं चुवाइ ।' कवि० ७.११६ ।।
चूक : सं०स्त्री०। (१) भूल । 'छमिअ देबि बड़ि चूक हमारी ।' मा० २.१६.८ (२) दोष, अपराध । 'रहति न प्रभु चित चूक किए की।' भा० १.२६.५
चूका : भूकृ०० (सं० चुत्कृत>प्रा० चुक्कअ) । चूक गया, खो बैठा । 'अहह मंद _ मैं अवसर चूका ।' मा० २.१४४.६
चूकिबो : भक पु०कए । चूकना, खो देना । 'औसर को चूकिबो सरिस न हानि।' गी० ५.७.२
चूकी : चूक । 'अजामिल की चलिग चल चूकी।' कवि० ७.८६
चूको : भूकृ.पु०कए । चूक गया। 'कलिकाल कराल न चूको।' कवि० ७.६०
चूडाकरन : सं०० (सं० चूडाकरण) । चौलकर्म, बालक का मुण्डन संस्कार । मा० १.२०३.३
चूड़ामनि : सं० स्त्री० । (१) शिरोभूषण विशेष । मा० ५.२७.२ (२) शिरोमणि =श्रेष्ठ । 'उदार-चूड़ामनि ।' विन० १८५.६
चुनरी : सं०स्त्री० । नव बधू का परिधान विशेष । गी० १.१०५.३
चूमि : पूकृ० (सं० चुम्बित्वा>प्रा० चुबिअ>अ० चुबि)। चूमकर, चुम्बन लेकर । गी० १.११.२
चूरन : सं०० (सं० चूर्ण)। (१) धूलि । विन० ३१.४ (२) धूलि बनाया हुआ औषध । 'अमिअ मूरिमय चूरन चारू ।' मा० १.१.२
चेटक : सं०० (सं०) । (१) दास, कर्मचारी (२) जार, उपपति (३) बाजीगर । 'नटुज्यों जनि पेट कुपेटक कोटिक चेटक कौतुक ठाट ठटो।' कवि० ७.८६ __ (चेटक कौतुक =इन्द्रजाल)
चेटकी : सं०स्त्री० । चेटक कौतुक । इन्द्रजाल । कवि० ७.६६
चेटुवा : सं० । अण्डे से निकला नवजात शिशु । 'अंड फोरि कियो चेटुवा ।' दो० ३०३
294
_______________________________________________
चेत : सं०० (सं० चेतस्) । संज्ञा, बोध, होश (स्मरण) । 'म बस रहा न चेत ।' मा० १.१७२
चेतन : वि० (सं.) । चेतनायुक्त । जे जड़ चेतन जीव जहाना।' मा० १.३.४
चेतनहिं : चेतन में । 'जड़ चेतनहिं ग्रंथि परि गई।' मा० ७.११७.६
चेता : (१) चेत । 'पठवन चले भगत कृत चेता।' मा० ७.१६.१ (२) भूकृ००। सोचा हुआ, चाहा हुआ । 'होइ चित चेता।' मा० २.११.५।
चेति : प्रकृ० । चेत कर, चेतना में आकर। 'अब चित चेति चित्रकूटहि चलु ।' विन० २४.१
चेतु, चेतू : (१) चेत + कए० । 'रहत न आरत के चित चेतू ।' मा० २.२६६.४ (२) आo-आज्ञा-मए। तू चेत, होश कर, स्मरण कर । चित्रकट को चरित्र चेतु चित्त करि सो।' विन० २६४.५
चेते : भूकृ००० (सं० चेतित) । चेतना में आये । ध्यानयुक्त हुए । 'हौं अब लौं करतूति तिहारिय चितवत हुतो, न रावरे चेते ।' विन० २४१.५ (२) सावधान हुए । 'सेवहि ते जे अपनपी चेते।' विन० १२६.२
चेन : चैन । आमोद-प्रमोद, सुख । 'सुभटन्ह के मन चेन ।' मा० ६.८७
चेरा : सं०० (सं० चेटक >प्रा० चेउअ)। दास । मा० २.१३१.८
चेराई : सं०पू० । दासता, सेवा भाव । जो चेराई राम की करतो न लजातो।' विन० १५१.१
चेरि : चेरी । मा० २.१३.८
चेरी : सं०स्त्री० (सं० चेटी>प्रा० चेडी) । दासी। मा० २.२२.५
चेरे : चेरा का रूपान्तर (ब.)। दास । मा० १.१८.४
घेरो : चेरा+कए । दास । 'चेरो रामराय को।' कवि० ७.१६६
चैत : सं०० (सं० चैत्र>प्रा० चइत्त)। मासविशेष जिसकी पुणिमा को चित्रा नक्षत्र रहता है। गी० १.२.२
चैतन्य : सं०० (सं.)। चेतना, संज्ञा । 'जड़हि करइ चैतन्य ।' मा० ७.११९ख
चैन : सं०स्त्री० (सं० चेतना>प्रा० चेअणा) । सुख, आनन्द, हर्षोल्लास । ‘मनु - बड़न लग्यो सहित चित चैन ।' गी० ५.२१.२
चैल : सं०पू० (सं.)। वस्त्र । 'चल चारु भूषन पहिराई ।' मा० १.३५३.४
चोंच : सं०स्त्री. (सं चञ्चु) । टोंट । मा० ३.१.७
चोंच : चोंच+संब० । चोंचों (से)। 'चोंचन्ह मारि बिदारेसि देही।' मा० ३.२६.२०
चौथे : भूक०० (सं० चुण्टित>प्रा० चुटिय) नोचे हुए (नोच डालने पर)। 'आयो सरन सुखद पद पंकज चौथे रावन बाज के ।' गी० ५.२६.३
_______________________________________________
295
चोखा : वि.पु.० (सं० चोक्ष>प्रा० चोक्ख)। उत्तम, विचित्र, मनोहर, दक्ष । 'चला बिमान तहां तें चोखा ।' मा० ६.१२०.४
चोखी : वि.स्त्री० (सं० चोक्षा>प्रा० चोक्खी) । उत्तम, विलक्षण । 'ये अब लही चतुर चेरी पंचोखी चालि चलाकी ।' कृ० ४३
चोखें : चोखे...से । 'लेखें जोखें चोखें चित'..।' कवि० ७.२४
चोखे : चोखा+ब० । (१) दक्ष, उत्तम, विलक्षण । 'असि चमकत चोखे हैं ।' गी० १.६५.१ (२) तीखे, नुकीले । 'बिसिख काल दखननि तें चोखे ।' गी० ५.१२.१
चोट : सं०स्त्री० (सं० चुट छेदने) । आघात । 'चपेट की चोट चटाक दै फोरौं ।' कवि० ६.१४
चोटिया : सं०स्त्री० (सं० चोटिका?>प्रा० चोट्टिया)। छोटी शिखा, केश शिखा । कृ० १३
चोटी : चोटिया । (१) शिखा (२) (लक्षणा से) मर्यादा, प्रतिष्ठा । 'हाथ ___कपिनाथ ही के चोरी चोर साहु की।' हनु० २८
चोप : सं००+स्त्री० । उत्साह । 'सिंघ किसोरहि चोप ।' मा० १.२६७
चोर : सं+वि० (सं०) । तस्कर । मा० १.२४२
चोरऊ : चोर भी । 'नाथ ही के हाथ सब चोरऊ पहरु ।' विन० २५०.३
चोरत : वकृ०० (सं० चोदयत्>प्रा० चोरंत) । चुराता, चुराते । 'चोरत चितहि सहज मुसुकात ।' गी० २.२
चोरति : वकृ०स्त्री० (सं० चोरयन्ती>प्रा० चोरंती>अ. चोरंति)। चुराती; अपहरण करती। 'चोरति चितहिचारु चितवनियाँ ।' गी० १.३४.५ ।।
चोरहि, चोरहीं : आ०प्रब० (सं० चोरयन्ति>प्रा० चोरंति>अ० चोरहिं)। चुराते हैं। 'अंग सब चित चोरहीं।' मा० १३२७.छं०
चोरा: चोर । मा० ५.४.३
चोराइ : पूकृ० । चुराकर । 'लेत चितहि चौराइ ।' गी० ७.३३.५
चोराई : चोराइ । 'लेहिं न बासन बसन चोराई ।' मा० २.३५१.३
चोराए, चोराये : भकृ०० । अपहृत किये। 'अरुन अधर चित लेत चोराये।' गी० १.३२.३
चोरि : चोराइ (सं० चोरयित्त्वा>प्रा० चोरिअ>अ० चोरि) । (१) चुराकर, अपहृत कर । लिए चोरि चित राम बटोहीं।' मा० २.१२३.८ (२) छिपाकर। 'अघ हदय राखे चोरि ।' विन० १५८.३
चोरी : सं०स्त्री० (सं० चौर्य =चौरी>प्रा० चोरी)। चोर-कर्म, अपहरण । 'चंदिनि कर कि चंडकर चोरी।' मा० २.२६५.६ (२) गोपन । 'औरउ एक कहउँ निज चोरी।' मा० १.१९६ (३) चोरि । चुराकर । 'लेत चितवत चित चोरी।' गी० ७.७.७
चोरु : चोर+कए । ‘ऐसे हू साहब की सेवा सों होत चोरु रे ।' विन० ७१.१
चोरें : चुराकर, चुराए हुए । 'चले लै चितु चोरें।' कवि० २.२६
चोरे : भूकृ.पुब० । चराये । गी० ३ २.३
चोर् यो : भूकृपु०कए । चुरा लिया। 'चोर्यो है चित चहुं भाई ।' गी० १.१५.३
चोलना : संपु० (सं० चोल) । अंगरखा, परिधान विशेष । गो० १.७४.१
चौंक, चौंकइ : (सं० चमत्करोति >प्रा. चमक्कइ>अ० चक्कइ-चमत्कृत होना, विस्मित होना, चकपकाना) आ०प्रए । चौंकता है, विस्मय पाता है। 'कोन की हाँक पर चौंक चंडीसु ।' कवि० ६.४५
चौंकि : पूकृ० । आश्चर्यचकित होकर । चौंकि चकै चितवै चितु दे।' कवि० २.२७
चौंके : भकृ०० (सं० चमत्कृत>प्रा० चमक्किय>अ० चक्किय) ब०। चकित हो गये । 'चौंके बिरंचि संकर सहित ।' कवि० १.११
चौंधी : चकचौंधी। चितवत मोहि लगी चौंधी सी।' गी० २.३५.३
चौक : सं०स्त्री० (सं० चतुष्क>प्रा. चउक्क) । चौकोर रचना विशेष । रंगोली आदि । 'गजमनि रचि बहु चौक पुराई।' मा० ७.६.३
चौकी : सं० स्त्री० (सं० चतुष्किका>प्रा० चउक्किआ>अ० चउक्की)। चौकोर __रचनाविशेष जो आभूषण आदि में बनायी जाती है । कवि० ७.१४७
चौकें : चौक+ब० । रंगोलियां । मा० १.२६६
चौगान, चौगाना : सं० । गेंद का एक खेल । 'खेलहहिं भालु कीस चौगाना।' मा० ६.२६५ (फ्रा० चौगान बल्ले या तिरछे डंडे का अर्थ देता है। उसका प्रयोग पोलो की कन्दुकक्रीडा के लिए हुआ है।)
चौगानै : चौगान+ब० । बल्ले, गेंद खेलने की तिरछी लकड़ियां । 'करकमलनि बिचित्र चौगाने ।' गी० १.४५.२
चौगुन : वि.पु. (सं० चतुण>प्रा० च उग्गुण) । चौगुना । मा० २.५१.८
चौगुने : 'चौगुन' का रूपान्तर (प्रा० चउग्गुणय)। "चंचलता चौगुने चाय ।' विन० ८३.२
चौगुनो : चौगुन+कए । गी० १.१०४.१
चौतनि: चौतनी । 'चौतनि सिरनि, कनक कली काननि ।' गी० १.६२.२
चौतनियाँ : चौतनी । गी० १.३४४
चौतनीं : चौतनी+ब० । चौकोर टोपियां । रुचिर चौतनी सुभग सिर ।' मा० १.२१६
_______________________________________________
297
चौतनी : संस्त्री० । चार बन्दों वाली चौकोर टोपी । 'कल कुंडल चौतनी चारु अति ।' गी० १.६३.३
चौथ : वि०० (सं० चतुर्थ>प्रा० चउत्थ) । चौथा। मा० १.१४२
चौथि : चउथि । चौथी। मा० ३.३५
चौथें : चौथे......में । 'चौथेपन जेहिं अजसु न होई ।' मा० २.४२.५
चौदसि : सं०+वि०स्त्री० (सं० चतुर्दशी>प्रा० चउद्दसी>अ० चउद्दसि)। (१) चौदस तिथि+(२) चौदहवीं । विन० २०३.१५
चौदह : संख्या (सं० चतुर्दशन् >प्रा० चउद्दह) । मा० २.२८.३
चौपट : सं०+वि० (सं० चतुष्पट्ट>प्रा० चउप्पट्ट)। चौरस, समतल (ध्वंस से किया हुआ समतल भूतल) । मा० ६.३०
चौपाईं : चौपाई+ब० । चौपाइयाँ । 'सत पंच चौपाईं मनोहर ।' मा० ७.१३० । छं०
चौपाई : संस्त्री० (सं० चतुष्पादिका>प्रा० चउप्पाइआ>अ० चउप्पाई) । एक छंद जिसके प्रत्येक चरण में १६ मात्राएं होती हैं । मा० १.३७.४
चौबारे : सं०पुब० (सं० चतुरिक>प्रा० चउव्वारय)। चार दरवाजों वाले हवादार बंगले । 'मनिमय रचित चारु चौबारे।' मा० २.६०.८
चौरासी : संख्या (सं० चतुरशीति>प्रा० चउरासीइ) । मा० १.८.१
चौर : चोर । विन० २८.४
चौहट : चउहट्ट । चौक, चौराहा । मा० ७.२८.८
च्वै : पूकृ० । चू कर, साव करके, बह (कर)। 'अंखियाँ अति चारु चलीं जल च्वै ।' कवि० २.११
च्वै हैं : आ०भ०प्रब० (सं० श्चोतिष्यन्ते>प्रा. चुइहिति>अ० चुइहिहिं) । चुलाएंगे, बहाएंगे, स्राव करेंगे, चुयेगे। 'खग मृग मुनि लोचन जल च्चे हैं ।' गी० ६.१८.३
## छ
छँगनमँगन : (दे०छगन) क्रि०वि० । बालगणों के बीच क्रीडा में मग्न । 'ऊँगनमैगन अँगना खेलत।' गी० १.३०.१
298
_______________________________________________
छँटि : भुकृ००ब० । छैटे हुए, चुने हुए । 'साजि चढ़े छेटि छैल छबीले ।' कवित
छ : संख्या (सं० षष्>प्रा० छ) । छह । 'साथ किरात छ सातक दीन्हे ।' मा० २.२७२८
छंडै : छांडइ । छोड़ दे, ग्याग करे । 'जाय सो जती कहाय बिषय बासना न ठंडें ।' कवि० ७.११६
छंद, छंदा : सं.पु० (सं० छन्दस्) । (१) पद्य । 'जनु तनु धरै सकल श्रुति छंदा।' मा० १.३००.४ (२) पद्य विशेष-हरिगीतिका आदि । 'छंद सोरठा सुन्दर दोहा ।' मा० १.३७.५ (३) (सं० छन्द) अभिप्राय, स्वेच्छा । रिषिबर तहँ छंद बास ।' गी० २.४३.२
छई : (१) भूकृस्त्री० । छा गई, व्याप्त हुए। 'अंग पुलकावलि छई।' मा० १.३१८.छं० (२) छय (सं० क्षय) । राजयक्ष्मा रोग । 'पर सुख देखि जरनि सोइ छई।' मा० ७.१२१.३४
छए : च्ये।
छगन : सं०० (सं० छ=शिशु+गण) । बालक (दुलराने में प्रयुक्त) । 'छगन . छबीले छोटे छया।' गी० १.२०.२
छगनमगन : क्रि०वि०+वि० (सं० छगण-मग्न) । शिशुगण के मध्य क्रीडारत । 'छगनमगन अँगना खेलिही मिलि ।' गी० १.८.३
छछुंदरि : सं०स्त्री० (सं.)। मूषिक जातीय जन्तुविशेष जो छू-छू ध्वनि करता है और कहा जाता है कि उसे साँप निगल ले तो मर जाता है तथा पकड़ने के बाद छोड़ दे तो अन्धा हो जाता है। 'भइ गति साँप छधुंदरि केदी।' मा० २.५५.३
छटनि : छटा+संब० । छटाओं । 'बिधि बिर, बरुथ बिधुत छटनि के।' कवि० २.१६
छटा : सं०स्त्री० (सं०) । (१) द्युति, आभा-पुञ्ज (२) समवाय (३) निरन्तर रेखा, श्रेणी।
छटानि : छटनि । छटाओं (से) । 'श्रोनित छोट छटानि जटे।' कवि० ६.५१
छठ : वि० (सं० षष्ठ>प्रा० छ8) । छह संख्या का पूरक, छठा । मा० ३.३६.२
छठी : छठ-+स्त्री०। (१) छह संख्या की पूरणी। (२) तिथिविशेष । (३) कार्तिकेय-पत्नी-देवसेना देवी जो नवजातकों की रक्षिका तथा प्रसव देवी मानी गयी हैं =षष्ठी देवी । (४) जन्म से छठे दिन षष्ठी देवी के उपलक्ष में किया जाने वाला उत्सव । गी० १.४.१२
छटें : छठे...में । 'छठे श्रवन यह परत कहानी।' मा० १.१६६.२
_______________________________________________
299
छड़ाइ : पू० (सं० छर्दयित्वा=मोचयित्वा>प्रा० छड्डाविअ>अ० छड्डावि) । छुड़ा (कर), छीन (कर) । लेहु छड़ाइ सीय कहें कोऊ ।' मा० १.२६६ ३
छड़ाइसि : आ०-भूकृ.स्त्री०+प्रए (मए) । तूने (उसने ) छुड़ा दी। ‘सठ रच भूमि छड़ाइसि मोही।' मा० ६.१००.८ ('शठ ने छुड़ा दी' या 'ऐ सठ तूने छुड़ा दी')
छड़ाई : छड़ाइ । (१) छीन कर । 'जासु देस नृप लीन्ह छड़ाई।' मा० १.१५८.२ (२) वियुक्त कर, अलग कर । 'तिल भरि भूमि न सके छड़ाई।' मा० १.२५२.२ (३) मुक्त करा (कर) । 'भरतु दयानिधि दीन्हि छड़ाई ।' मा. २.१६३.८
छड़ावा : भूकृ०० । छुड़ाया, हटाया, दूर किया। 'देह जनित अभिमान छड़ावा।" मा० ४.२८.६
छत : सं.पु० (सं० मत)। व्रण, घाव । 'पाकें छत जनु जाग अहारू ।' मा०. २.१६१.५
छतज : सं०० (सं० क्षतज) । (घाव से निकला ताजः रुधिर) रक्त (लाल)। 'छतज नयन उर बाहु बिसाला ।' मा० ६.५३.१
छति : सं०स्त्री० (सं० क्षति) । (१) हानि । 'का छति लाहु जून धनु तोरें। मा०. १.२७२.२ (२) भङ्ग, नाश । 'टूटत अति आतुर अहार बस छति बिसारि आनन की।' विन० १०.३
छत्र : (१) सं०० (सं.)। छाता, आत पत्र । 'छत्र मेघ डंबर सिर धारी।' मा ६.१३.५ (२) (सं० क्षत्र) क्षत्रिय । 'छत्र जाति कर रोष । मा० ६.२३ घ
छत्रक : सं०पू० (सं.)। छत्राकार उद्भिज्जविशेष, कुकुरमुत्ता। 'तोरौं छत्रक दंड जिमि ।' मा० १.२५३
छत्रबंधु : संपु० (सं० क्षत्रबन्धु) । क्षत्रियाधम, नीच क्षत्रिय । 'छत्रबंधु ते बिप्र बोलाई ।' मा० १.१७४.१
छत्रि : छत्रिय । 'छत्रि जति रघकूल जनम ।' मा० २.२२१
छत्रिय : संपु० (सं० क्षत्रिय) । क्षत्र वंशज (क्षत्र जातीय माता-पिता की सन्तान) । मा० ३.१६.६
छत्री : छत्रिय । 'बैरी पुनि छत्री पुनि राजा।' मा० १.१६०.६
छत्रु : छत्र+कए० राजा का छत्र । 'एकु छत्रु एकु मृकुटमनि ।' मा० १२०
छन : सं०० (सं० क्षण) । लघुतम कालखण्ड । 'छन महुं मिटे सकल श्रुति सेतू ।' मा० १.८४.६ (२) (दे० छिन)
छन, छनइ : आ.प्रए । छनता-ती है (झंझरे अवकाश में से निकलती है)। 'घन छांह छन प्रभा न भान की।' गी० २.४४.२
छनभंगु, छनभंगू : छनभंग (सं० क्षणभङ्ग)+कए । क्षणिक, क्षणविनाशी, क्षणों में परिवर्तन लेकर नष्ट होने वाला क्षणभंङ्ग र । मा० २.१६०.३, २११.७
छपत : व००० (सं० क्षप्यमाण>प्रा० छप्पंत) । नष्ट होते । (२) छिपते । 'कलिमल छल छपत ।' विन० १३०.१
छपद : सं०० (सं० षट्पद)। भ्रमर । 'छपद सेनहु बर बचन हमारे।' कृ० ५७
छपदु : छपद+कए० । भ्रमर (प्रतीकरूप में उद्धव) । 'पठयो है छपदु छबीले _ कान्ह काहूं कहूं।' कवि० ७.१३५ ।।
छपन : वि०० (सं० क्षपण) । नाशक । 'छोनिप छपन बांको बिरदु बहुत हौं।' कवि० १.१८
छपनिहार : वि०पु= छपन । विनाशकर्ता । कीन्ही छोनी छत्री बिनु छोनिप छपनिहार ।' कवि० ६.२६
छपा : सं०स्त्री० (सं० क्षपा) । रात्रि । गी० १.१९.३ /
छपा, छपाइ, ई : (छिपना, अन्तहित होना) आ०प्र०ए० । छिपता है, अन्तर्धान __ हो जाता है । 'कबहुंक प्रगटइ कबहुं छपाई ।' मा० ३.२७.१२
छपाइ, छपाई : पूकृ० । छिप (कर) । 'उठी रेनु रषि गयउ छपाई ।' मा० ६.७९.७
छपाए : भूकृ००ब० । छिपा लिए, ढक लिए । 'नील जलद पर उडुगन निरखत तजि सुभाव मानो तड़ित छपाए ।' गी० १.२६.६
छप्यौ : भूकृ००कए । छिपा हुआ । कवि० १.१८
छबि, छबी : संस्त्री . (सं० छबि) । आभा, कान्ति, दीप्ति । 'जैसें दिवस दीप छबि छूटे ।' मा० १.२६३ ५
छबीलीं : छबीली+ब० । आभा युक्त । 'अंगुरियां छबीली छोटी।' गी० १.३३.१
छबीले : छबीले...'ने । 'पठयो है छपदु छबीले कान्ह ।' कवि० ७.१३५ छबीले वि०० (सं० छविमत्>प्रा० छविल्ल-छविल्लय) ब०। आभायुक्त, सौन्दर्थच्छटा सम्पन्न, शोभाशील । 'छरे छबीले छ्यल सब ।' मा० १.२६८
छबीलो : वि०पु०कए० (सं० छविमान्>प्रा. छविल्लो)। शोभाशाली। गी० १.१६.५
छम : वि.पु. (सं० क्षम)। समर्थ । 'ब्रह्मांड दहन-छम ।' विन० २३६.४ 'दुख दोष दलन छम ।' विन० २७५.१
छमत : सं०० (सं० षट् । प्रा. छ+मत)। षड्दर्शन-न्याय, वैशेषिक, सांख्य; योग, मीमांसा, वेदान्त । 'पढ़िबो पर यो न छठी छमत ।' विन० १५५.२ 'छ-मत बिमत न पुरान मत एकमत ।' विन० २५१.४
छमब : भूक०० (सं० क्षन्तव्य>प्रा० छनिअन्व) । क्षमा करना (चाहिए)। 'अनुचितु छमब जानि लरिकाई।' मा० १.४५.६
_______________________________________________
30
छमबि : छमब+स्त्री० । छमा करनी (चाहिए)। 'छमबि देबि बड़ि अबिनय मोरी ।' मा० २.६४.५
छमहु : आ०मब० (सं० क्षाम्यत>प्रा० छमह>अ० छमहु) । क्षमा करो। 'छमहु च क अनजानत केरी ।' मा० १.२८२.४
छमहूं : आ०-प्रार्थना-प्रब० । (वे) क्षमा करें । 'लघुमति चापलता कबि छमहूं।" मा० २.३०४.१
छमाँ : क्षमा से । 'तोष मरुत तब छा जुड़ावै ।' मा० ७.११७.१४ ।
छमा : सं०स्त्री० (सं० क्षमा)। (१) सहिष्णुता, दूसरे के अपराध के प्रति सहन शीलता । 'छमा दया दमलता बिताना ।' मा० १.३७.१३ (२) पृथ्वी । 'बिस्व भार भर अचल छमासी।' मा० १.३१.१० (३) शक्ति, सामर्थ्य --'नीति सुनहि करहि छमा ।' मा ६.९०
छमाइ : पूकृ० । क्षमा करवा कर । 'छमि अपराध छमाइ कृपा करि ।' विन० १००.५.
छमासील : वि० (सं० क्षमा शील) । क्षमा की प्रकृति वाला । मा० ७.१०६.५
छमि : पूकृ० । क्षमा करके । 'छमि सब करिहाई कृपा बिसेषी।' मा० २.१८३.४
छमिअ, छमिय : छमिए । 'कौसिक कहा छमिअ अपराधू ।' मा० १.२७५.५
छमिए : आ०--कवा...-प्रए० (सं० क्षम्यते>प्रा० छमीअइ) । क्षमा किया जाय, क्षमा कीजिए।' छमिए अघ ओगुन मेरे।' गी० २.७६.२
छमिबो : भूक.पु०कए० (सं० क्षन्तव्यः>प्रा० छमिअव्वो>अ० छमिअव्वउ)। क्षमा करना । 'अपराधु छमिबो ।' मा० १.३२६.छं
छमिहहिं : आ०भ०प्रब० (सं० ऑस्यति>प्रा० मिहिति>अ० छमिहिहिं) क्षमा करेंगे। 'छमिहहिं सज्जन मोरि ढिठाई।' मा० १.८.८
छमिहि : आ०भ०प्रए० (सं० ऑस्थति>प्रा० छमिहिइ)। क्षमा करेगा। 'छमिहिः देउ अति आरति जानी।' मा० २.३००.८
छमिहैं : छमिहहिं ।' सोचें सब, या के अध कैसे प्रभु छमिहैं ।' कवि ७.७१
छमुख : षण्मूख । कार्तिकेय । कवि० ७.१७६६
छमेहु : आ०.-भ०+प्रार्थना-मब० । तुम क्षमा करना । 'छमेह सकल अपराध अब ।' मा० १.१०१
छमैया : वि० (सं० क्षन्तक>प्रा. छमिइय) । क्षमा करने वाला । 'अपराध सबै छलु छाडि छमैया ।' कवि० ७.५३
छय : सं०पू० (सं.)। (१) विनाश । 'जेहिं रिपु छ्य सोइ रचेन्हि उपाई।' मा०. १.१७०.८ (२) रोगकिशेष-दे० छई
छयल : वि.पु. (प्रा० छइल्ल=विदग्ध)। चतुर, दक्ष, निपुण, कुशल । 'छरे. छबीले छयल सब ।' मा० १.२६८ thoo
302
_______________________________________________
छये : भूक००० । आच्छादन किये हुए । 'ब्योम विमाननि बिबुध बिलोकत खेलक पेषक छाँह छये ।' गी० १.४५.३
छर : सं०० (सं० छल) । (१) ब्याज, बहाना, कपट । (२) धान कूटने की क्रिया विशेष । 'तहाँ तहाँ नर नारि बिन छर छरिगे।' गी० २.३२.१ (जैसे धान बिना कटे ही कुट जाय, उसी प्रकार बिना जपतप आदि का ब्याज लिप ही लोग कलुषमुक्त हो गये।)
छरनि : सं०स्त्री० (सं० छलता) (१) प्रवञ्चना, प्रतारण। (२) कूटने की क्रिया। 'बीच पाइ एहि नीच बीच ही छरनि छर्यो हौं ।' विन० २६६.२
छरमार : (दे० छरुभारु) उत्तरदायित्व । 'यह छरभार ताहि तुलसी जग जाको दास कहैहौं ।' विन० १०४.४
छरस : (सं० षड्रस>प्रा० छरस) छह प्रकार के स्वाद-मधुर, अम्ल, लवण, कट, कषाय और तिक्त । मा० १.१७३.१
छरि : पू० (१) छले हुए हो (कर) । (२) धान कूटे जाकर । जेहि जेहि मग सिय राम लखन गए, तहँ तह नर नारि बिनु छर छरि गे।' गी० २.३२.१ (जैसे धान बिना कुटे ही बूसी से मुक्त हो जाय उसी प्रकार बिना जप-तप के व्याज के ही लोग मायावरण-मुक्त हो गये)
छरी : सं०स्त्री० । छड़ी, पतली यष्टि । 'लिये छरी बेंत सोधें विभाग ।' गी० ७.२२.५
छरु : सं.पु (सं० सरु =तलवार की मूठ>प्रा० छरु) । (लक्षणा से) युद्धकार्य, संघर्ष-कार्य का कठिन उत्तरदायित्व; विपत्ति में उलझा कार्य भार । मा० २.३१५.७
छरभारू : (दे० छरु तथा भारु) । सम्पूर्ण कठिन उत्तरदायित्व । 'लखि अपने सिर सब छरु.भारू ।' मा० २.२६.२
छरे : वि००ब० । (सं० छलिक>प्रा० छलिय) । चुस्त, चतुर, सतर्क, विदग्ध । 'छरे छबीले छयल सब ।' मा० १.२६८
छरैगी : आ०भ०स्त्री०ए० । (१) छलेगी, ठगेगी। (२) कुचल डालेगी, धान के समान कूटेगी। 'बाहुबल बालक हबीले छोटे छरंगी।' हनु० २५
छरो : छर् यो । छल लिया, ठगा । 'निगम नियोग तें सो केलिडी छरो सो है।' कवि० ७.८४
छर् यो : भूकृ००कए० (सं० छलित:>प्रा० छलिओ)। (१) छला हुआ, ठगा गया (२) कूटा गया, कुचला हुआ। 'बीच पाइ एहि नीच बीच ही छरनि छर्यो हौं ।' विन० २६६२
'छल : सं०० (सं.)। छघ्न, धूर्तता, वञ्चना, व्याज= बहाना । 'सब मिलि करहु छाडि छल छोहू ।' मा० १.८.३ 'बोले मधुर बचन छल सानी ।' मा० १.६८.८
_______________________________________________
303
छलक : सं०स्त्री० । (द्रव पदार्थ का) उबरा कर उछलना, तरङ्ग लेकर बाहर बह चलना । 'बड़ि गयो जा के बल बारिधि छलक मैं ।' कवि० ६.२५
छलकारी : छल करने वाला । मा० ३.२५.२ छल कि है : आ०भ०प्रए । छलकेगी, उबर कर लहरायगी। छबि छल किहै भरि अँगर्नया ।' गी० ५.६.३
छलके : आ०प्रब० । छलकते-ती हैं । उबर कर लहराते-ती हैं 'मनहुं उमगि अंग अँग छबि छलके ।' गी० १.३१.२
छलग्यानी : कपट से ज्ञानी बना हुआ, धूर्त । मा० १.१७०.१
छलन : वि०पू० । छलने वाला । 'छलन बलि ।' विन० ५२.५
छलहिं, छलहीं : आप्रब० । छलते हैं, ठगते हैं । 'बंचक बिरचि बेषु जगु छलहीं।' मा० २.१६८.७
छलाईं : छलना में, धोखा देने में । 'सुजोधन भो कलि छोटो छलाईं। कवि० ७.१३१
छलि : पूकृ० (सं० छलित्वा>प्रा० छलिअ>अ० छलि) । छल करके, छघ्न अपना कर । 'कहै काह, छलि छुअति न छाँही ।' मा० २.२८८.५
छलिन : छली+संब० । छलियों। 'छलिन की छोड़ी।' कवि० ७.१८
छली : वि.पु. (सं० छलिन्) । छलनायुक्त, धूर्त, कपटी। 'छली मलीन कतहुं न प्रतीती।' मा० २.३०२.२
छलु : छल+कए । अद्वितीय छल । 'करि छलु मूढ़ हरि बैदेई ।' मा० १.४६.५
छले : भूकृ०० (सं० छलित>प्रा० छलिय) ब० । ठगे, प्रवञ्चित किये। 'सिव बिरंचि बाचा ले।' गी० ५.४१.२
छलो : भू कृ००कए । प्रवञ्चित किया (ठगा)। बिबुध काज बावन बलिहि छलो भलो जिय जानि ।' दो० ३६६
छवनी : संस्त्री० । छोनी, बालिका । 'भई है प्रगट अति दिब्य देह धरि मानो त्रिभुवन छबि छवनी ।' गी० १.५८.१
छवा: संपु । (१) पैर, चरणतल । (२) (सं० सव=प्रसव) शावक, शिशु । 'बिदले अरि कुंजर छैल छवा से।' हनु० १८
छहु, छहूं : (छ-+हूं) छहों, सभी छह । 'कीरति सरित छहूं रितु रूरी।' मा० १.४२.१
छाँड़ छाँडइ : (/छाड़+छाड़इ) छोड़ता है, फेंकता है, चलता है । 'सर छाँडइ होइ लाहिं नागा ।' मा० ६.७३.१०
छाँड़त : वकृ०० (च्छाड़त)। छोड़ता। 'भूमि न छाँड़त कपि चरन ।' मा० ६.३४
छाँडहु : (छाड़हु) । 'छोडहु तात मृषा जल्पना ।' मा० ६.५६.५
छाँडि : (छाड़ि)। छोड़ (कर) । 'सब छूछे के के छाँड़ि गो।' कवि० ६.२४
304
_______________________________________________
छाँड़िअ, य, ए : (छाडिअ)। छोड़ा जाय । 'का छोडिअ का संग्रहिम)।' दो० ३५१
छाँड़ियो : आ० - भवि०+प्रार्थना-मब० । तुम छोड़ना । 'तह तहं जा । तुम छोड़ना । 'तहँ तहँ जनि चित छोह छाँडियो ।' विन० १०३.३
छाँड़िहि : (छाडिहि) छोड़ेगा । 'मम कर तीरथ छाँ डि हि देहा।' मा० ३.२६.१४
छाँड़ी : (छोडी) छोड़ी, चलायी। 'छाँड़ी सक्ति प्रचंड ।' मा० ६३
छाँडु़, : आo-आज्ञा-मए । तू छोड़ दे। 'तुलसी राम नाम जपु आलस छाँड़ ।' बर०६६
छाँड़े : (छाड़े) (१) छोड़े, चलाये, फेंके । 'खैचि सरासन छाँड़े सायक ।' मा० ६.६२.६ (२) छोड़े हुए (त्याग कर) । 'चलहिं कुपंथ बेद मग छाँड़े।' मा. १.१२.२
छाँड़ेउँ : आ० - भूकृपु+उए । मैंने छोड़ा, मुक्त किया। 'बूढ़ जानि सठ - छाँड़ तोही।' मा० ६.७४.५
छाँड़ेउ : (छाड़े उ) छोड़ा, चलाया । 'पावक सर छाँड़ उ रघुबीरा ।' मा० ६.६१.३
छाँड़ेसि : (छाड़े सि) (१) उसने चलाया, फेंका । 'प्रभु कहँ छोड़सि सूल प्रचंडा।' मा० ७.७६.७ (२) उसने फेंके । 'अस्त्र सस्त्र छाँड़ेसि बिधि नाना।' मा. ६.६२.३ (३) छोड़े, त्यागे । 'अस कहि छोड़सि प्रान ।' मा० ६.७६
छाँड़ै : (छाड़ै)। छोड़ने, फेंकने । 'कुलिस समान लाग छाँई सर ।' मा० ६.६१.१
छाँड् यौं : (छाँड़उँ) । मैंने छोड़ दिया, त्याग दिया । ‘इन्ह के लिए खेलिबो छाँड़ यौं तऊ न उबरन पावहिं ।' कृ० ४
छाँह : सं०स्त्री० (सं० छाया>प्रा० छाहा>अ० छाह)। प्रतिबिम्ब । 'तनु तजि रहति छाँह किमि छेकी ।' मा० २.६७.५
छाँही : छाँह (प्रा० छाही) । मा० २.२८८.५
छाँहू : छाया भी । 'सकुचत छुइ सब छांहू ।' विन० २७५.२
छाइ : पूकृ० (सं० छादयित्वा>प्रा० छाइअ>अ० छाइ)। (१) छप्पर आदि से छाया करके । 'रहे परनगृह छाइ ।' मा० ३.१३ (२) व्याप्त होकर, आच्छादित कर । 'रहे छाइ नभ सिर अरु बाहू ।' मा० ६.६२.१४ (३) आ-आज्ञा मए । तू छा । 'तुलसी घर बन बीचहीं प्रेम पुर छाइ ।' दो० २५६
छाईं : भू०० स्त्री०ब० । फैल गयीं, व्याप्त थीं। 'सकल सिद्धि संपति तहं छाई।' मा० १.६५.७
छाई : (१) छाइ । रह्यो उर नभ पर छाई।' कृ० २६ (२) भकृ०स्त्री० । आवृत हो गयी । 'फूलें कास सकल महि छाई।' मा० ४.१६.२ (३) व्याप्त हुई, भर गयी । 'मूक बदन जन सारद छाई । मा० १.३५०.८ (४) सजाई । 'पुरी रुचिर करि छाई।' गी० १.१.६
_______________________________________________
305
छाउ : छाए+कए० (सं० छाद:>प्रा० छाओ>अ० छाउ)। आवरण, दुराव। - तिन न तज्यो छल छाउ ।' विन० १००८
छाए : भूक०० (सं० छादित>छाइय) ब० । (१) भर गये । 'आश्रम देखि नयन जल छाए।' मा० १.४६.६ (२) फैल गये, व्याप्त कर रहे । 'जथा जोगु जहं तहं सब छाए ।' मा० १.६४.७ (३) परिपूर्ण हुए । 'सकल लोक सुख संपति छाए।' मा० १.१६०.६ (४) आवृत । 'मनहुं मनोहरता छबि छाए।' मा. १.२४१.१ (५) घेरे हुए । 'मुनि मन मधुप रहत जिन्ह छाए।' मा० १.३२७.२ (६) रहे, विराजमान हुए । 'चित्रकूट रघुनंदन छाए । मा० २.१३४.५ (७) छावनी डाल कर रहे । 'जनु भट बिलग-बिलग होइ छाए।' मा० ३.३८.४ (८) (छप्पर आदि) डाल कर बनाए। 'ताल समीप मुनिन्ह गृह छाए।' मा० ३.४०.५
छाक : सं०स्त्री० (सं० चक्षा>प्रा० चक्खा)। तृप्तिकारी भोजन । 'बलदाऊ देखियत दूरि ते आवति छाक पठाई मेरी मैया ।' कृ० १९ (सं० चक्षण दो अर्थ देता है-(१) भूख उद्दीप्त करने वाला खाद्य पदार्थ, चटनी आदि । इसी 'चखना' या 'चीखना' हिन्दी में चलता है जिसका 'चक तप्ती से भी सम्बन्ध है। (२) मदिरा पीने के साथ जो नमकीन आदि खाते हैं उसे भी 'चक्षण' कहा . गया है। इस 'चख>छक्क>छाक' मद्य, मद्यपान तथा मद के अर्थों में ब्रजभाषा में चलता है-'छाके' में इसी का प्रयोग है।)
छाके : भूक००० (दे० छाक) । नशे में धुत्त, मत्त, पान किये हुए । 'जाहिं सनेह सुरा सब छाके ।' मा० २.२२५.३
छाछी : सं०स्त्री० । छाछ, दही का तोड़, तक्र । 'चहिअ, अमिअ जग जुरइ न छाछी।' मा० १.८.७
छाज, छाजइ : (सं० छाद्यते--विराजते>प्रा० छज्जइ-सुशोभित होना, विराजना) आ०प्रए । सोहता है, फबता है, फबती है। 'छोनी में के छोनीपति, छाजे जिन्हें छत्र छाया ।' कवि० १.८
छाजति : वक-स्त्री० । सुशोभित होती । 'पीत दुकूल अधिक छबि छाजति।' गी. ७.१७६
छाजा : छाजइ । फबता है । 'जो कछु करहिं उन्हहि सब छाजा ।' मा० ३.१७.१४
छाड़ : आ०-आज्ञा-मए । तू छोड़ दे। 'नाहिं त छाड़ कहाउब रामा।' मा० १.२८१.२
छाड़,→ छाड़इ : (सं० छर्दयति-मुच्चति>प्रा० छड्डइ-छोड़ना, फेंकना, बाहर करना) आ०प्रए० । छोड़ता या छोड़ती है (उगलती है) । 'छाड़इ स्वास कारि जन सापिनि ।' मा० २.१३.८
306
_______________________________________________
छाड़त : वक०० (सं० छर्दयत् >प्रा० छडुत) । छोड़ता, छोड़ते । हनु० ३२
छाड़न : सं०पु० (सं० छर्दन>प्रा० छड्डण) । छोड़ना, फेंकना । 'मिल्लिनि जिमि छाड़न चहति बचनु भयंकर बाजु ।' मा० २.२८
छाड़ब : भकृ०० (सं० छदितब्य >प्रा० छड्डिअव्व) । छोड़ना (चाहिए)। देबि न हम पर छाड़ब छोहू ।' मा० २.११८.१ ।
छाड़हिं : आ०प्रब० (सं० छर्दयन्ति >प्रा० छड्डुति>अ० छड्डहिं)। छोड़ते-ती-हैं। 'छाड़हि नचाइ हाहा कराइ।' गी० ७.२२.७
छाड़हु : आ० मब० (सं० छर्दयत>प्रा० छड्डह>अ० छड्डुहु)। छोड़ो। 'अस बिचारि उर छाड़हु कोहू ।' मा० २.५०.१
छाड़ा : भूक०० (सं० छर्दित >प्रा० छड्डिअ) । छोड़ा, फेंका । 'छाड़ा बान, माझ उर लागा।' मा० ६.७६.१६
छाड़ि : पूकृ० (सं० छर्दयित्वा>प्रा० छड्डिअ>अ० छड्डि) । (१) त्याग कर । 'सब मिलि करहु छाडि छल छोहू ।' मा० १८.३ (२) मुक्त कर । 'ल ले दंड छाडि नृप दीन्हे ।' मा० १.१५४.७ (३) अतिरिक्त, बिना । 'रामहि छाडि कुसल केहि आजू ।' मा० २.१४.२
छाड़िअ, छाड़िय : आ०कवा०प्रए । छोड़िए, त्यागा जाय । 'ले इस संग मोहि छाडिअ जनि ।' मा० २.६६.७
छिड़िसि : आ० भकृस्त्री०+प्रए । उसने छोड़ी, फेंकी। 'बीरघातिनी छाडिसि साँगी ।' मा० ६.५४.७
छाड़िहउँ : आ०भ० उए० (सं० छर्दयिष्यामि>प्रा० छड्डिहिमि>अ० छड्डिहिउँ) । छोड़गा। तब मारिहउं कि छाडिहउं ।' मा० १.१८१
छाड़िहिउँ : आ०भ०प्रए० (सं० छर्दयिष्यति >प्रा० छड्डिहिइ)। छोड़ेगा। 'सील सनेह न छाडिहि भीरा ।' मा० २.७६.३
छाड़ी : भूकृ०स्त्री० । त्यागी । सेवक छोह तें छाड़ी छमा।' कवि० ७.३
छाड़े : भूकृ०० (सं० छदित>प्रा० छड्डिअ) । छोड़े, फेंके । छाड़े सर एक तीस ।' मा० ६.१०२
छाड़ेउ : भकृ०पू०कए । छोड़ दिया। प्रभु छाड़े उ करि छोह ।' मा० ३.२
छाड़ेन्हि : आ० भूकृ.पु+प्रब० । उन्होंने छोड़े, चलाये, फेंके । 'छाड़ेन्हि गिरि तरु जूह ।' मा० ६.६६
छाड़ेसि : आ०-भूक पु+प्रए । (१) उसने छोड़े, त्यागे । 'राम राम कहि छाडेसि प्राना।' मा० ६.५८.६ (२) चलाये, फेंके, फेका । 'संधानि धनु सर निकर छाड़ेसि ।' मा० ६.८२ छ ।
_______________________________________________
307
छाड़ै : (१) छाडइ । छोड़ दे । 'सहज छमा बरु छाई छोनी।' मा० २.२३२.२ (२) भकृ० । छोड़ने । 'सर समूह सो छाड़े लागा।' मा० ६.५०.५
छाड् यौ : छाड़ेउ । “छोनी में न छाड्यो छप्यो छोनिप को छोना छोटो।' कवि०
छाता : छत्र (प्रा० छत्तअ)। रा०न० ८
छाती : संस्त्री०। (१) वक्षःस्थल । 'नारि बंद कर पीटहिं छाती ।' मा ६.४४ ४ (२) अन्तःकरण, मन-प्राण । 'हृदयं लगाइ जड़ावहिं छाती।' मा० १.२६५.५ (३) कलेजा । 'बिटरति नहिं छाती ।' मा० ६.३३.४ .
छानि, छानी : पूक । (१) छान कर, छन्ने से शुद्ध करके । 'मज्जन पान कियो के सुरसरि कर्मनास जल छानी ।' क० ४६ (२) भटक कर, इधर-उधर निरुद्देश्य घुमघाम कर, थक कर । 'कोटिक कलेस करौ मरौ छार छानि सो।' कवि० ७.१६१
छाम : वि.पु. (सं० क्षाक) । क्षीण, कृश । 'राम छाम लरिका लखन ।' गी० ५.२३.२
छाय : संपु० (सं० छाद>प्रा० छाय) । आवरण, छिपख-दुराव । 'राम राज न चले मानस मलिन के छल छाय।' विन० २२०.३
छायउ : भूक००कए (सं० छादितम् >प्रा० छाइयं >अ० छाइयउ)। छा गया, ब्याप्त हुआ । 'जग जनु छायउ ।' जा०म० १८०
छायाँ : छाया में । 'बट छायां बेदिका बनाई।' मा० २.२३७.८
छाया : सं०स्त्री० (सं०) (१) प्रतिबिम्ब । त्रिविध समीर सुसीतलि छाया ।' मा० १.१०६.३ (२) छाता आदि । 'नहिं पदत्रान सीस नहिं छाया।' मा० २.२१६.५ (३) झलक, आभा । 'केहि छाया कबि मति अनुसरई ।' मा० २.२४१.३ (४) संस्कार, अवशेष, छाप । 'अजहुं न छाया मिटति तुम्हारी।' मा० १.१४१.५ (५) छाय । आवरण । 'पालु बिबुधकुल करि छल छाया .' मा० २.२६५.२
छायो : छायउ । (१) व्याप्त। 'सब सनेह छल छायो।' विन० २००.२ (२) व्याप्त हुआ, भर गया। 'हरष उर छायो ।' मा० ६.१०७.८ (३) आवृत हुआ । 'बिपति जाल जग छायो।' विन० २४३.४
छार, छारा : सं०० (सं० क्षार) । (१) भस्म, राख । 'तन छार ब्याल कपाल भूषन ।' मा० १.६५.छं० 'चितवत कामु भयउ जारि छारा ।' मा० १८७६ (३) धूल, मिट्टी । 'छार ते संवारि के पहारहूं तें भारी कियो ।' कवि० ७.६१
छारै : छार को, मिट्टी को । 'पब्बय तें छार, छार पब्बय पलकहीं।' कवि० ७.६८
छाल : सं०० (सं० छल्ल) । चर्म, त्वचा । पा०म०/० १२
308
_______________________________________________
छाला : छाल । 'एहि मग कर अति सुन्दर छाला ।' मा० ३.२७.४ .
छालि : पूकः । छाल निकाल कर । गढ़ि गुढ़ि छोलि छालि कुंद भीसी भाई . बातें।' कवि०७.६३ (२) प्रक्षालन करके, स्वच्छ कर
छालिका : वि०स्त्री० (सं० क्षालिका)। धो बहाने वाली, स्वच्छ करने वाली।  पाप छालिका ।' विन० १७.१
छालित : भूक०वि० (सं० क्षालित) । धो कर स्वच्छ किया हुआ । 'रघुपति भगति .. बारि छालित चित ।' विन० १२४.५
छावत : वकृ० । आच्छादित करता-ते, आपूरित करता-ते । 'जनु सुनरेस''प्रजा सकल सुख छावत ।' गी० २.५०.२
छावन : भकृ० । छाने को, आच्छादन करने , 'गुनिगम बोलि कहेउ नप मांडव छावन ।' जा० मं० ११३
छावहिंगे : आ०भू० कृ.पु.प्रब० । भर देंगे, व्याप्त करेंगे। 'अंग-अंग छबि भिन्न भिन्न सुख निरखि निरखि तह तह छावहिंगे । गी० ५.१०.२
छावा : भूक. (सं० छादित>प्रा० छाविअ)। छाया हुआ, आवृत किया । 'ध्वज पताक तोरन पुर छावा ।' मा० १.१९४.१ (२) छा गया, व्याप्त हुआ, फैला। 'सुजसु पुनीत लोक तिहुं छावा ।' मा० १.३६१.४ (३) छावइ। व्याप्त होता है, फैलेगा । 'धरमतर्जे तिहूं पुर अपजसु छावा ।' मा० २६५.६
छावौं : आ०ए० (सं० छादयामि>छावमि>अ० छावउँ) । छाता हूं, छप्पर बनाता हूं। 'कपट दल हरित पल्लवनि छावौं ।' विन० २०८.२ . . ..
छाहँ : छाया में । 'परिखो पिय छाह धरीक है ठाढ़े।' कवि० २.१२ ।
छाही : (१) (सं० छायायाम >प्रा० छाहीहिं) । छाया में । पाय पखारि बैठि . तरु छाहीं।' मा० २.६७.३ (२) छाँही। आभा, दीप्ति, छटा । जिमि घट कोटि एक रबि छाहीं।' मा० २.३४४.४ (३) प्रतिबिम्ब । 'सुन्दर सिला सुखद तरु छाहीं।' मा० २.२४६.८
छाहैं : (१) छाँह+बहु । छायाएँ । 'आरत दीन अनाथन को रघुनाथ करें निज हाथ की छाहैं ।' कवि० ७११ (२) छाहीं। छायाओं में । बिलम न छिन छिन छाहैं।' विन० ६५.५
छिटकि : पू० । छटा बिखेरकर। 'छपा छिटकि छबि छाई ।' गी० १.१६.३
छिति : सं०स्त्री० (सं० क्षिति) । (१) भूलोक । 'बन चर देह धरी छिति माहीं।' मा० १.१८८.३ (२) पृथ्वी, भूतल । 'कूदहिं गगन मनहुँ छिति छाँड़े।' मा० २.१६१.६ (३) पञ्च महाभूतों में पृथ्वी तत्व । 'छिति जल पावक गगन समीरा।' मा० ४.११.४
_______________________________________________
309
छितिपाल : राजा । कवि० ७.१८१
छिद् यो : भक०० कए. । (सं० छिद्रित:>प्रा० क्षिदिओ) । विद्ध हुआ। 'छिद्यो न तरुनि कटाच्छ सर ।' दो० ४३८
छिद्र : सं०० (सं.)। (१) छेद, रन्ध्र, सन्धि । 'छिद्र सो प्रगट इंदु उर माहीं।' मा० ६.१२.८ (२) दुराव-छिपाव । ‘मोहि कपट छल छिद्र न भावा ।' मा० ५४४.५ (३) गुप्ताङ्ग (४) गोपनीय बात । 'जो सहि दुख पर छिद्र दुरावा।' मा० १ २.६ (५) घात करने का अवसर । 'अखिल खल...छिद्र निरखत सदा। विन० ५६३
छिन : सं०पू० +क्रि०वि० (सं० क्षण>प्रा० खण-छण) समय का अत्यन्त सूक्ष्म भाग जो क्रियाखंड के संयोग-विभाग से नापा जाता है। बिलम न छिन छिन छाहैं ।' विन० ६५.५
छिनि : छीनि । छुड़ा (कर) । 'देखि बधिक बस राजन्मरालिनि लखन लाल छिनि लीजै ।' गी० ३.७.२
छिनु : छिन+कए । क्षण भर, एक क्षण | प्रतिक्षण । मा० २.६६.४
छिनुकु : छिनु । एक क्षण, क्षण भर, थोड़ा-सा । कहहिं गाइअ छिनुकु भ्रम ।' मा० . २.११४
छिपाइ : छपाइ । छिपा कर, छिप कर । गी० १.८४.४
छिया : (१) सं०स्त्री० (सं०)। विनाश । (२) अव्यय (सं० छि:) । धिक्कार । (३) (अवधी में घृणार्थक) निष्ठा । 'हौं समुझत साईं द्रोह की गति छार छिया : रे।' विन० ३३.६
छिरकत : वकृ०० (सं०क्षरत् +कुर्वत् >प्रा० छरक्कंत) । छिड़कते । 'मनहुं अर गजा छिरकत, भरत गुलाल अबीर ।' गी० २.४७.१६
छिरकहिं : आ०प्रब० । छिड़कते हैं। 'कुंकुम अगर अरगजा छिरकहिं ।' गी० १.२.१६
छिरकै : छिरकहिं । 'छिटकै सुगंध भरे मलय रेनु ।' गी० ७.२२.३
छींक : सं०स्त्री० (सं० छिक्का) । अकस्मात् नाक से तीव्र वायु-निःसरण । 'एतना कहत छींक भइ बाएँ ।' मा० २.१६२.४
छीके : सं०पु० अधिकरण (सं० शिक्ये>प्रा० सिक्के)। सिकहर पर । 'यो कहि  मागत दहिउ धर्यो जो है छीके ।' क० १०
छीज,→ छीजइ : (१) (मं० छिछते>प्रा० छिज्जइ) आ०प्रए । विछिन्न या खंडित होता है, कटता या टूटता है। 'सखि सरोष प्रिय दोष बिचारत प्रेम पीन पन छोज ।' कृ० ४५ (२) (सं० क्षीयते>प्रा० छिज्ज इ) । क्षीण या कृश होता है। 'कोन दिनहुं दिन छीज।' क०७
310
_______________________________________________
छीजहिं, छीजहीं : आ.प्रब० (सं० छिद्यन्ते, क्षीयन्ते>प्रा० छिज्जति>अ० छिज्जहिं)। कटते-मिटते हैं । 'छीजहिं निसिचर दिन अरु राती ।' मा० ६.७२.३
छीजे, छीजै : छी जइ । (१) विच्छिन्न हो (सं० छिद्यते । जेहिं छोज निसिचर सम दाई ।' मा० ६.७५.६ (२) क्षीण हो (सं० क्षीयते) । 'मज्जन करिअ समरश्रम छोजे ।' मा० ६.११६.५ (३) क्षीण+विछिन्न हो । 'प्रौढ अभिमान चितष्टत्ति छीज ।' वि०न ४७.२
छीट : सं०स्त्री० । छींट, बदों की श्रेणी। 'श्रोनित छीट छटानि जटे।' कवि०
छीन : वि०पु० (सं० क्षीण, छिन्न>प्रा० क्षीण, छिन्न) । दुर्बल तथा विच्छिन्न = व्यग्रचित्त । 'छधा छीन बलहीन सुर ।' मा० १.१८१
छीनत : व०००। दूसरे से बलात् लेते; छीनते, झपट लेते । 'खेलत खात परसपर डहकत छीनत ।' क० १६
छीनता : सं०स्त्री० (सं० क्षीणता+छिन्नता)। अल्पता+नाश । 'सुमिरत होत कलिमल छल छीनता ।' विन० २६२.५
छीना : छीन । रहित, शन्य। 'उदासीन सब संसय छीना।' मा० १.६७.८
छीनि : पू० । छीन कर, झपट-लेकर। 'एक ते एक छीनि ले खाहीं।' मा० ६८८.२
छीनी : भूकृ०स्त्री० । छीन ली, बलात् स्वायत् कर ली। 'दामिनी की छबि छीनी।' गी० १.४४.१
छीने : भकृ००। (१) छीने हुए, झपटकर स्वायत्त किए हुए । 'लेत जन छीने ।' मा० २.११८.७ (२) छीने हुए, क्षीण किये हुए । 'बिकल मनहुं माखी मधु छीने ।' मा० ७६.४ (३) काट दिए, छिन्न कर दिये । 'राम बहोरि भुजा सिर छीने ।' मा० ६६.११
छीबो : भक०कए० (सं० छोप्तव्यम>प्रा० छिविअन्वं>अ. छिविअब उ) । छूना, स्पर्श करना ! 'भलो न भूमि पर बादर छीबो ।' कृ. ६
छीर : सं.पु. (सं० क्षीर) । दूध । मा० २.६१.१
छीरनिधि : छीर सागर ।
'छीरसागर : सं०० (सं० क्षीरसागर)। पुराण प्रसिद्ध समद्र विशेष जिसमें जल के स्थान पर दूध माना गया है और जिसमें प्रलय में विष्णु शयन करते हैं। मा० १.०.३
छीरसिंधु : छीरसागर । मा० २.२३१
छीरु : छीर-+कए । दूध । मा० २.१५१.२
