487 
धरमध्वज : (सं० धर्मध्वज) धर्म का झंडा-कठाये दम्भी-धर्म व्यवसायी । 'धींग घरमध्वज धंधक धोरी।' मा० १.१२.४
घरमवतु : सं०कए । एकान्त धर्म निष्ठा । मा० २.१७१.६
घरममय : वि० (सं० धर्ममय)। धर्मयुक्त । मा० २.१७१.४
धरमसील : वि० (सं० धर्मशील) । धर्मात्मा । मा० १.१५५.२
धरमा : धरम । मा० १.२.११ 
घरमु, मू : धरम+कए । एकमात्र धर्म । 'घरमु धरेउ सहि संकट नाना।' मा० २.६५.४, २.२०४.७
धरषा : भूकृ०० (सं० धर्षित>प्रा० धरिसिअ)। आक्रान्त हुआ, दबाव में पड़ा । 
__ 'डोले धराधर धारि धराधरु धरषा।' कवि०६.७
धरषि : पू० (सं० धृष्ट्वा>प्रा० धरिसिअ>अ० धरिसि) । धर्षण करके, दलित करके, तिरस्कृत करके, आक्रान्त करके । 'रिपु बल धरषि हरषि कपि ।' मा० ६.३५ क
धरहरि : संस्त्री०। प्रबोध देना (धर्य बंधाना), सहलाना, पुचकारना । 'चिकुर... करनि बिबरत...अहिसिसु...ससि सन लरत, धरहरि करत रुचिर जन जग फनी ।' गी० ७.५.३ 
धरहि, ही : आप्रब० । (१) पकड़ते हैं । ‘मारहिं काहिं धरहिं पछारहिं ।' मा० ६.८१.५ (२) धारण करते हैं । गिरि निज सिरन्हि सदा तन धरहीं।' मा० १.१६७.७
घरहि : आ०-आशा~मए० । तू धारण कर । 'धरनि धरहि मन धीर ।' मा० १.१८४
घरहुं : आ० - आज्ञा, कामना-प्रब० । धारण करें। 'उर धरहं जबती जन बिलोकि तिलोक सोभा सार सो।' पा०म० छं० १६ 
घरहु, हू : आ०मब० । (१) धारण करो । 'अब उर धरह ब्रह्म बर बानी।' मा० १.७५.२ (२) धारण करते हो । 'व्यर्थ घरहु धनु बान कुठारा ।' मा० १.२७३.८ (३) पकड़ो। धरहु कपिहि धरि मारहु ।' मा० ६.३२ ख (४) रखो। 'तुलसी जनि पग धरहु गंग मह साच।' बर० २४
घरहुगे : आ०भ००मब० । रखोगे। 'अधम आचरन कछु हृदय नहिं धरहुगे।' विन० २११.२
घरा : (१) संस्त्री० (सं०) । पृथ्वी। 'धरा अकुलानी।' मा० १.१८४.४ (२) भूकृ० । धारण किया। 'कोपि कर धनु सर धरा ।' मा० १.८४ छं. (३) पकड़ा । 'धाइ धरा जिमि जंतु बिसेषा ।' मा० ६.२४.१५
घराइ : पू० (सं० धारयित्त्वा>प्रा० धराविम>अ० धरावि) । धरा कर, धारण करके । 'असि देह धराइ के जायें जिये ।' कवि० ७.३८ 
488 
_______________________________________________
घराई : भूक०स्त्री० । स्थिर कराई, रखवाई। 'राम तिलक हित लगन धराई ।' मा० २.१८.६
धराधर : सं०० (सं०) । पृथ्वी धरने वाला । (१) पर्वत (२) शेषनाग । 'डोले धराधर धारि, धराधरु धरषा ।' कवि० ६.७
धराधर : धराधर+कए० । शेष । 'धराधरु धीर भारु सहि न सकतु है।' कवि० 
धरायहु : आ०-भ०+आज्ञा -मब० । तुम स्थिर कराना, रखवाना । 'जौं मन मान तुम्हार तो लगन धरायहु ।' पा०म० ७८
घरासुर : भूसुर । ब्राह्मण (भृगु) । 'उर धरासुर पद लस्यो।' मा० ६.८६ छं०
धरि : पू० । (१) धारण करके । 'धरि धीरजु तब कहइ निषादू ।' मा० २.१४३.१ (२) पकड़ कर । 'धरहु कपिहि धरि मार ।' मा० ६ ३२ ख 
धरिअ, ए : आ०कवा०प्रए । रखिए, धारण कीजिए । 'धीरज धरिअ नरेस ।' मा० २.२७६
धरित : भूकृ० (सं० धृत) । धारण किया। 'मृगराज बपु धरित ।' विन० ५२४
धरिबे : भक०० (१) रखने, स्थापित करने । 'ज्ञान बिराग कालकृत करतब हमरेहि सिर धरिबे हो।' कृ० ३६ (२) धारण करने । 'कठिन कुठार धार धरिबे को धीर ।' कवि० १.१८ 
धरिय, ये : धरिअ । सिय धीरज धरिये।' गी० ५.५१.१
धरहिउ : आ० भ० उए० । धारण करूंगा, ग्रहण करूंगा। 'तुम्हहि लागि धरिहउँ नर बेसा। मा० १.१८७.१
धरिहहि : आ०भ०प्रब० । धारण करेंगे, ग्रहण करेंगे। 'धरिहहिं बिष्नु मनुज तनु तहिआ ।' मा० १.१३६.६
धरिही : आ०भ०प्रए० । धारण करेगा, ग्रहण करेगा। 'त्रेता बिष्नु मनुज तनु धरिही।' मा० ४.२८.७
धरिहैं : धरिहहिं । रखेंगे । 'धरिहैं नाथ हाथ माथे ।' गी० ५.३०.३
धरिहो : आ०भ०मब० । धरोगे, ग्रहण करोगे, रखोगे । “जो पै जिय धरिही अवगुन जन के ।' विन० ६६.१
घरी : (१) धरि । 'मसक समान रूप कपि धरी। लंकहि चलेउ ।' मा० ५.४.१ (२) भूकृ०स्त्री० । ग्रहण की, धारण की । 'कपि केहि हेतु धरी निठुराई।' मा० ५.१४.४
घर : आ०-आज्ञा, प्रार्थना-मए । (१) तू धारण कर । 'जननी हृदयं धीर धरु ।' मा० ५.१५ (२) पकड़ ले । 'मारु मारु धरु धरु धरु मारू ।' मा० ६.५३.६ 
_______________________________________________
489 
घरें : क्रि०वि० । धारण किये (मुद्रा में) । 'मम पाछे धर धावत धरे सरासन बान ।' मा० ३.२६
घरे : भूक.पु० (ब)। (१) रखे। 'आनि घरे प्रभु पास ।' मा० ६.३२ क (२) धारण किये हुए । 'हृदय आनि सिय राम धरे धनु भाथहि । पा०म० १
घरेउ : आ० --भूकृ.पु+उए० । मैंने धारण किये, ग्रहण किये । 'एहि बिधि धरेउँ बिबिध तनु ।' मा० ७.१०६ घ 
घरेउ, ऊ : भूकृ००कए । धारण किया, ग्रहण किया। 'राम धरेउ तनु भूप।' मा० ७.७२ क
घरेन्हि : आ० - भूकृ.पु+प्रब० । उन्होंने पकड़े। तदपि न उठइ धरेन्हि कच जाई ।' मा० ६.७६.३
धरेसि : आ०- भूकृ०पु+प्रए । उसने पकड़ा, पकड़े। 'कोपि कूदि द्वौ धरेसि बहोरी।' मा० ६६८.६
घरेहु : (१) आ०-भ०+आज्ञा+मब० । तुम रखना । 'संतत हृदय धरेहु मम काजू ।' मा० ४.१२.६ (२) आ०-भूक००+-मब० । तुमने रखा । 'नर तनु धरेहु संत सुर काजा।' मा० २.१२७.६
धरै : धरहिं । रखते हैं । 'छबि भूरि अनंग की दूरि धरं ।' कवि० १.३
धर : (१) धरइ । रखता है । ‘मन संतोष धरै।' विन० ६२.४ (२) रखे । 'चित्त दिआ भरि धरै दृढ़।' मा० ७.११७ ख (३) भकृ० अव्यय । पकड़ने । 'ताहि धरै जननी हठि धावा ।' मा० १.२०३.८
धरंगो : आ०भ००प्रए । धारण करेगा । 'सुत सिर छत्र धरंगो।' गी० २.६०.३
धरो : धर्यो। (१) रखा हुआ । 'हरो धरो गाड़ो दियो धन ।' दो० ४५७ . (२) पकड़ रखा । 'जोग सिधि साधन रोग बियोग धरो सो।' विन० १७३.३
धरोइ : रखा ही (रख लिया सो रख लिया)। 'दीपक काजर सिर धर्यो, धर्यो सो धर्यो धरोइ ।' दो० १०६
धरौं : घरउँ । (१) धारण करूँ। 'कर न धरौं धनु माथ।' मा० १.२५३ (२) रखू, रखता हूं। 'धरौं सचि पचि सुकृत सिला बटोरि ।' विन० १५८.४
घरी : धरहु । पकड़ो। 'कह्यो धरी धरी धाए बीर बलवान हैं ।' कवि० ५.७
धर्म : (दे० धरम) मा० १.७७.५
धर्मतरु : धर्मरूपी वृक्ष । मा० ३ श्लो० १
धर्मपरायन : धर्म में सदा तत्पर। मा० ७.१२७.२
धर्ममय : वि० (सं०) । धर्म रूप । 'परम धर्ममय पय दुहि भाई ।' मा० ७.११७.१३
धर्मरत : धर्म परायण । मा० ७.२१.७
धर्मसील : घरमसील । 
490 
तुलसी शब्दको 
धर्मसीलता : धर्म परायणता । मा० ६.२२.५
धर्मसीलन्ह : धर्मसील+संब० । धर्मात्माओं । 'जथा धर्मसीलन्ह के दिन सुख संजत जाहिं ।' मा० ३.३६ ख
धर्महीन : अधार्मिक । मा० ६.३८ क
धर्मा : धर्म । 'सब बिधि सुख त्रेता कर धर्मा ।' मा० ७.१०४.३
घरयो : धरेउ । रखा । 'दीपक काजर सिर धर्यो।' दो० १०६
धवल : वि० (सं०) । श्वेत, उज्ज्वल । मा० १.२१३
धवलधाम : सं०० (सं०) । धवलगृह धौरहर-चूने से पुते ऊँचे महल । मा० २.११६.८
धवलिहउँ : धवल+भ उए । श्वेत कर दूगा । 'जस धवलिहउँ भुवन दस चारी।' मा० २.१६०.५ 
घस, घसइ : (सं० ध्वंसते-ध्वंसु अवलंसने>प्रा० धंसइ, धसइ) आ०प्रए। धंसता-ती है; अधोगति लेकर प्रवेश करता-ती है; घसकता-ती है। 'धरनि धसइ धर धाव प्रचंडा।' मा०६.७१.६
धसी : भूक०स्त्री० । (१) प्रवेश कर गई (२) निकली । “जनु कलिंदजा सुनील सैल तें धसी समीप ।' गी० ७.७.५
घाँके : भक०पू० ब० । धाक में लिए. आतङिकत किये। 'बीर बिरुदैत बर बैरि धाँके ।' कवि० ६.४५
धाइ : पूक० (सं० धावित्वा>प्रा० धाविअ>अ० धाषि) । दौड़ कर । 'धाइ खाइ जन जाइ न हेरा।' मा० २.३८.४
धाइबो : भकृ०पु०कए । दौड़ना । 'तुलसी कबंध कैसो धाइयो बिधारु ।' कवि० ७.८३
धाई : भूकृ०स्त्री०ब० । दौड़ पड़ों । 'जुबति बृद रोवतः उठि धाई ।' मा० ६.१०४.२
पाई : भूकृ०स्त्री० । दौड़ पड़ी। 'सुनि धाई रजनीचर धारी।' मा० ६.६७.७
धाएँ : दोड़ने से, पर । 'तुलसी जिन्ह धाएं धुकै धरनी ।' कवि० ६.३३
पाए : भूक००० । दौड़ पड़े । 'सुनि मुनि आयसु धावन धाए ।' मा० २.१५७.४
धाता : सं०० (सं०) । ब्रह्मा । मा० ७.१०६.३
धातु : सं०० (सं०) । (१) सुवर्णादि खनिज । (२) गेरू आदि । 'सिय अंग लिखें धातु राग ।' गी० २.४४.४ (३) अङ्ग रचना के घटक तत्त्व । 'सब अंग धातु भवभय मोचनं ।' कृ० २३ (४) शरीर के सप्तधातु -- रस, रुधिर, मांस, मेदा, अस्थि, मज्जा और शुक्र । 'सातै सप्त धातु निरमित तन ।' विन० २०३.८ (५) सात संख्या । 'मुनि गनि दिन गनि धातु गनि । रा०प्र० ७.७.२
धान : सं.पुं० (सं० धान्य>प्रा० धन्न) । शालि, व्रीहि. (अन्न विशेष) । 'बए न जामहि धान ।' मा० ७.१०१ ख दुलमी शोर 
491 

धाम, मा : सं० (सं० धामन्) । (१) घर । 'लखा कि रहिहिं धाम ।' मा २.४६ (२) लोक । 'रघुबंसमनि किमि गवने निज घाम ।' मा० १.११०
घामका : वि०स्त्री० (सं.)। लोक देने वाली । 'मम धामदा पुरी।' मा० ७.४.७
धामिनी : वि०स्त्री० । धाम वाली, आवास करने वाली। (गङ्गा...) त्रिपुरारि सिर धामिनी ।' विन० १८.२ 
धामु, मू: धाम+कए० । मा० २.६२७
धाय : धाइ।
घायउँ : आ०- भूक.पु+उए । मैं दौड़ा। 'निर्भर प्रेम हरषि उठि धायउँ ।" मा० ७.८२.३
पायउ : भूकृ.पु०कए । दौड़ा । 'धायउ परम क्रुद्ध दसकंधर ।' मा० ६.८२.१
घायल : धायउ (भोजपुरी में प्रचलित) । 'कोपि गगन पर धायल ।' मा० ६.६७.६
धाये : धाए ।
धायो : धायउ। 'देखि बिकल सर अंगद धायो।' मा०६.६७.८
धार : सं०स्त्री० (सं० धारा)। (१) प्रवाह । 'सुरसरि धार नाउँ मंदाकिनी।' मा० २ १३२.६ (२) तलवार आदि का पैना भाग । 'मूठि कुबुद्धिः धार निठुराई।' मा० २.३१.२ (३) (जमधार) कृपाण । 'जम कर धार किधौं बरिआता।' मा० १.६५.७.
धरना : सं०स्त्री० (सं० धारणा) । अष्टाङ्ग योग में चित्त को एकाग्र (निरुव) करने का छठा अङ्ग जिसमें किसी विषय पर चित्त को बार-बार टिकाया जाता है। यही धारण सध जाने पर ध्यान का रूप लेती है जब विषय पर चित्त की धारा एकतान हो जाती है। धारणा, ध्यान और समाधि को एक साथ संयम कहा जाता है। ध्यान धारना समाधि साधन प्रबीनता।' कवि० ७.६२
पारमिक : वि० (सं० धार्मिक) । धर्मशील, धर्मात्मा । हनु०१०
धारा : धार । (१) प्रवाह । 'सुरसरिधारा।' मा० १.२.८ (२) खड्ग आदि का तीक्ष्ण भाग । 'सीतल निसित बहसि बर धारा।' मा० ५.१०.६ (३) दोनों का श्लेश ।' 'जासु परसु सागर खर धारा।' मा० ६.२६.३ (४) निरन्तर श्रेणी। 'चतुरंगिनीं अनी बहु धारा।' मा० ६.७६.१ (५) भूकृ०० (सं० धारित> प्रा० धारिअ) । रखा । 'निज पुर पगु धारा।' मा० १.२५.५
पारि : सं०स्त्री० (सं० धारा)। (१) अविच्छिन्न श्रेणी, समूह । 'बिबुध धारि भइ गुनद गोहारी ।' मा० २.३ १७.३ (२) (सं० धाटि>प्रा० धाडि) आक्रामक यूथ । "प्रबल मोह के धारि ।' मा० ३.४३ (३) पूक० । धारण करके । 'अब जनि धावै धनु धारि।' गी० १.२२.१४ । 
धारिअ, य : धारिए । 'भयउ समउ अब धारिअ पाऊ ।' मा० १.३१३.७ 
धारिए, ये : आ०-कवा०-प्रए । रखिए । 'पाउ धारिए ।' गी० ५.३५.२. 
492 
_______________________________________________
धारिनि : (समासान्त में) वि०स्त्री० (सं० धारिणी) । धारण करने वाली । 'निज इच्छा लीला बपु धारिनि ।' मा० १.६८.४
धारी : (१) धारि। आक्रामक सेना। 'रचनीचर धारी।' मा० ६.६७.७ (२) समूह, श्रेणी । मा० ३.१६.१ (३) पू० धारण करके । 'राम भगतहित नर तनु धारी किए साधु सुखारी।' मा० १.२४.१ (४) भूक०स्त्री० । रखी। 'सिय पगु धारी।' मा० १.२४८.४ (५) (समासान्त में) वि०पू० (सं० धारिन्) धारण करने वाला। 'धनधारी।' 'तनुधारी' । मा० १.१८२.१०-१२
धारें : धरें। मनिपट धार उर फूलनि के हार हैं।' कवि० २.१४ ।
धारे : भकृ००० । रखे । 'जहँ रनिवासु तहाँ पगु धारे।' मा० १.३५४.२
धारेउ : भूकृ.पु.कए । रखा । भूपति सुरपति पुर पगु धारेउ।' मा० २.१६०.२
धारें : (१) धार+ब० । धाराएँ । 'धारै बान, कूल धनु, भूषन जलचर ।' गी० ७.१३.३ (२) आप्रब० । धारण करते हैं। जिन्ह को पुनीत बारि धारै सिर पै पुरारि ।' कवि० २.६
धाव : (१) धावइ । दौडता है। 'धर धाव प्रचंडा।' मा० ६.७१.६ (२) टूट पड़ता है, धावा बोल देता है । 'चपरि चहूं दिसि धाव ।' दो० ५२० /धाव
धावइ : (सं० धावति --धावु गतौ>प्रा० धावइ) आ०प्रए । दौड़ पड़ता है, धावा बोल देता है । 'आपुन उठि धावइ ।' मा० १.१८३ छं०
धावत : वकृ० पु । दौड़ता, दौड़ते । 'धरहु धरहु धावत सुभट ।' मा० ३.१८
धावन : सं०पु० (सं०) । दूत, हरकारा । मा० २.१५७.४
धावनि : संस्त्री० । दौड़ने की क्रिया । 'धावनि नवनि बिलोकनि बिथकनि।' गी. 
धावहि, हीं : आ०प्रब० । दौड़ते हैं, दौड़ पड़ते हैं, धावा बोल देते हैं। 'देखत जग्य निसाचर धावहिं ।' मा० १.२०६ ४
धावहिंगे : आ०भ००प्रब० । दौड़ेंगे। 'लोचन बहु प्रकार धावहिंगे।' गी० ५.१०.२
धावहि : आ०मए । तू दौड़ता-ती है। 'कत रबिकर जल कहँ धावहि ।' विन० २३७.२
धावहु : आ०मब० । दौड़ पड़ो। धावहु मरकट बिकट बरूथा।' मा० ६.१.६
धावा : (१) धावइ । दौड़ता-ती है। 'ताहि धरै जननी हठि धावा।' मा० १.२०३.८ (२) भूक०० । दौड़ा। 'प्रेरित मंत्र ब्रह्मसर धावा।' मा० ३.२.१
धाव : धावइ । दौड़ पड़े, धावा करे । 'अब जनि धावै धन धारि ।' गी० १.२२.१४
धावौं : आ०उए । दौड़ जाऊँ, दौड़ सकता हूं। 'जो जन सत प्रमान ले धावौं ।' मा० १.२५३.८ हू तुलसा शब्द-कोश 
493 
घावोंगी : आ०भ०स्त्री.उए । दौड़गी। 'सुनि संदेस....उठि धावौंगी।' गी०. २.५५.३
धावी : धावहु । दोड़ो, भागो। 'धावी धावी लागि आगि रे ।' कवि० ५.६
घाहैं : सं०स्त्री०प० । धाड़ें, चिल्लाहटें (विलाप की पुकारें)। 'जिन्ह रिपु मारि सुरारि नारि तेइ सीस उघारि दिवाई धा हैं।' गी० ७.१३.६
धिक : अव्यय (सं० धिक, धिग)। छिः छिः, धिक्कार है। 'जे न ठगे धिक से।' कवि० १.१
धिग : धिक । मा० २.८६.५
घींग : वि०+क्रि०वि० । धींगा मुश्ती वाला, नितान्त छलनापूर्ण, उत्कट । 'धींग धरमध्वज धंधक धोरी।' मा० १.१२.४ 'अपनायो तुलसी सो धींग धमधूसरो।, कवि० ७.१६
घीय : सं०स्त्री० (सं० धीता, धीदा, दुहिता>प्रा० धीया)। कन्या, पुत्री। 'धीय को 
__ नमाय, बाप पूत न सँभारहीं।' कवि० ५.१५
घोर : (१) वि० (सं.)। धैर्यशाली । 'धरमधुरंधर धीर सयाने ।' मा० २.७८.२ (२) सं.पु० (सं० धैर्य>प्रा० धीर) । 'धरमधुरंधर धीर धरि ।' मा० २.३०
धीरज : धीर । धैर्य । मा० १.८४.७
घोरजु : धीरज+कए । 'धरनि सुतां धीरजु धरेउ ।' मा० २.२८६ .
घोरतर : वि० (सं.) । अतिशय धैर्यशाली। कृ० ३१
धीरता : संस्त्री० (सं०) । धैर्य । मा० १.३३८.५
धोरधुर : वि० (सं० धीरधुर्य, धैर्यधुर्य-दे० धुर)। धैर्यधारी, धीरशिरोमणि । ___'धीरधुर रघुबीर ।' गी० ५.४.२
धीरन्ह : धीर+संब० । धैर्यशालियों। धीर-ह के मन बिरति दृढाई ।' मा०. ३.३६.२
धीरा : धीर । (१) धैर्यशाली। 'सेवत जाहि सदा मुनि धीरा।' मा० १.५१.८ (२) धैर्य । 'बिधि केहि भाँति धरौं उर धीरा ।' मा० १.२५८.५
घोरु : धीर+कए । धैर्य । 'तज्यो धीरु धरनी ।' कनि० ६.१६
धीरे : धैर्य को। 'धीर न सकत धीरौ धीरै ।' गी० ६.१५.३
धीरौ : धैर्य भी । गी० ६.१५.३
धुंद : सं०पु० (सं०
धुन्धुमार:-धुआँ) । अँधेरा । 'छुटे बार बसन उघारे धूम धुद अंध।' कवि० ५.१५ .
धुआँ : सं०पु० (सं० धूम>अ० धू) । (१) आग का धूम ! 'धुआँ कैसो धौरहर देखि तू न भूलि रे ।' विन० ६६.४ (२) (सं० धूम = उल्कापात) विध्वंससूचक अपशकुन, विनाश । 'धुआँ देखि खर दूषन केरा । जाइ सुपनखां रावन टेरा .' 
494 
_______________________________________________
मा० ३.२१.५ (जिस प्रकार उल्कापात राजा के विनाश का सूचक होता है 
उसी प्रकार खरदूषत-विनाश रावण के विध्वंस का सूचक था ।)
धुकि : पू० (सं० ध्र गतिस्थैर्ययोः)। (१) झुककर, घुमड़न के साथ नत होकर । _ 'जलद घन घटा धुकि धाई है।' हनु० ३५ (२) स्थिर हो-झुककर-चलकर । 'सुनि कल बेनु धेनु धुकि धैया ।' कृ० १६
धुके : आ०प्रए० । रुक-रुक चलती है , धकधकती है, कॉप-काँप जाती है । 'तुलसी जिन्ह धाएँ धुके धरनी।' कवि० ६.३३
धुज : ध्वज ।
धुजा : ध्वजा । 'कदलि ताल बर धुजा पताका ।' मा० ३.३८.२ Vधुन
धुनइ : (सं० धुनाति, धूनोति-धू कम्पने) आ०प्रए । झिटकता है, झकझोरता है, कपाता है (रुई के समान धुनकता है) 'जो जहँ सुन इ धुनइ सिरु सोई ।' मा० २.४६.८
धुनत : वकृ००। (१) कपाते । 'करनि धुनत धनु तीर ।' गी० २.६६.२ (२) झिटकते, ताल ठोंक झकझोरते । 'बाजे बाजे बीर बाहु धुनत समाज के।' कवि० १.८
धुनहिं : आ०प्रब० । धुनते हैं (झिटकते हैं) । 'धुनहिं सीस पछिताहिं ।' मा० २.६६
धुना : भूकृ०० । झिटका (पीट लिया)। 'पुनि कालनेमि सिरु धुना।' मा० 
धुनि : (१) प्रकृ० । धुनकर, झिटक कर (पीट कर)। 'परेउ धरनि धुनि माथ ।' मा०२.३४ (२) सं०स्त्री० (सं० ध्वनि)। नाद, शब्द, गूंज, घोष (दे० पंचधुनि) । 'कंकन किकिनि नूपुर धुनि सुनि ।' मा० १.२३०.१ (३) नदी। दे० देवधुनि।
धुनिए : आ०कवा०प्रए । झिटकिए (चाहे पीट डालिए)। 'बरज्यो न करत कितो सिर धुनिए।' कृ०३७
धुने : भुकृ००ब० । झिटक डाले (पीट लिये) । 'बारिद बचन सुनि धुने सीस सचिवन्ह ।' कवि० ५.२० 
धुनेउ, ऊ : भूकृ०पु० ए० । धुना, धुनका, झिटकारा (पीट लिया)। 'नृप सनेहु लखि धुने उ सिरु ।' मा० २.७३
धुन्यो : धुने उ । 'पर्यो धरनि ब्याकु सिर धुन्यो ।' मा० ६.६५.७
धुर : (१) सं०स्त्री० (सं० धुर्>प्रा० धुरा)। भार, बोझ । 'सकल घरम धुर धरनि धरत को।' मा० २.२३३.१ (२) वि०पू० (सं० धुर्य)। धुरीण (भार धारण करने में समर्थ) श्रेष्ठ । 'हिमवानु धरनि-धर धुर धनि ।' पा०म०६
धुरंधर : (१) वि०पुं० (सं०) । भार धारण-समर्थ, धुरीण । 'धरम धुरंधर नृप. रिषि जानी।' मा० १.१४३.६ (२) श्रेष्ठ । तुलसी शब्दकोश 
495 
धुरंधर : धुरंधर+कए । एक भी धुरीण, समर्थ । 'को अवनीतल इन सम बीर धुरंधरु ।' जा०म० ६२
पुरधारी : धुरीण, धुरंधर । 'नरबर धीर धरम-धुर-धारी।' मा० २.७२.२
धुरीन : वि०पु० (सं० धुरीण) । धुर=भार उठाने में समर्थ, धुरंधर । 'धरम धुरीन बिषय रस रूखे ।' मा० २.५०.३ धुरीन । 'तात भरत तुम्ह धरम पुरीना ।' मा० २.३०४.८
धुव : ध्रव । नक्षत्रविशेष । 'बंदन बंदि ग्रंथिबिधि करि धुव देखेउ ।' पा०मं. १३२
धुवाँ : धुआं।
धूत : वि०० (सं० धूर्त>प्रा० धुत्त) । वञ्चक, कपटी, ठग । 'छलमलीन बल धूत ।' रा०प्र० ५.२.१ ।
धूति : पूकृ० । धूर्तता में डाल कर, छल कर। 'गई गिरा मति धूति ।' मा० २.२०६
धूप : सं००+स्त्री. (सं०) । एक प्रकार का सुगन्धित काष्ठ।' मा० १.१६५.५
धूम : (१) सं०० (सं०)। धुआँ । 'धूम अनलसंभव सुनु भाई।' मा० ७.१०६.१० (२) सं०स्त्री० (सं० धूम्या=धूम समूह, कुहासा)। विजय आदि का आतङक जो दूसरों को धूमिल कर दे, धाक । 'भरि भुवन सकल कल्यान धूम।' गी० 
धूमउ : धुआँ भी । “धूमउ तजइ सहज करु आई।' मा० १.१०.६
धूमकेतु : सं०० (सं.)। (१) राक्षस-यूथप, विशेष का नाम । मा० १.१८० (२) पुच्छल तारा, टूट कर गिरने वाला नक्षत्र । 'धूमकेतु सत कोटि सम दुराधरष भगवंत ।' मा० ७.६१ ख (यहाँ 'अग्नि' अर्थ अधिक संगत है)। (३) धूमध्वज-अग्नि । 'कंस बंसाटबी धूमकेतू ।' विन० ५२.७
धूमधुज : धूमध्वज । 'दनुज बन धूमधुज ।' विन० ४८.३
धूमध्वज : सं०पु० (सं०) । जिसका ध्वज धूम है =अग्नि । 'शत्रु वन दहन इव धूमध्वज ।' विन० १०.४
धूरि : सं०स्त्री० (सं० धूलि)। धूल, रजः कग । मा० १.१७५ ।
धुरिधानी : सं०स्त्री० (सं० धूलि+धानी=स्थान) । धूलि का प्रदेश, धूलधक्कड़, रजोमय, चूरचूर । 'जातुधान धारि धूरिधानी करि डारी है।' हनु० २७
धूरी : धूरि (सं० धूली) । मा० १.३४.१
धूलि : धूरि (सं.)। गी० ५.२.२
धूसर : वि.पु. (सं०) । मटमले रंग का। 'धूसर धूरि भरे तन आए ।' मा० १.२०३.६
धूसरित : वि० (सं०) । धूसर किया हुआ । 'धूरि धूसरित अंग ।' रा०प्र० ४.३.१ 
496 
_______________________________________________
- 
घृत : भूकृ०० (सं.)। धारण किये हुए । 'धृत सर रुचिर चाप तूनीरहि ।' मा० ७.३०.४
धृति : सं०स्त्री० (सं०) । धैर्य, मानसिक स्थिरता । मा० ७.११७.१४ (इस की _ गणना दस मानव धर्मों में प्रथम है) ।
धेइ : पूक० । ध्यान करके । 'सेइ न धेइ न सुमिरि के पद प्रीति सुधारी ।'
विन: १४८४
धेनु : सं०स्त्री० (सं०) । दूध देने वाली गाय । निरखि बच्छ जिमि धेनु लवाई।' मा० ७.६.६ (गोस्वामी जीने धेनुधूरि, धेनुमति आदि में इसे केवल गो-पर्याय माना है)।
धेनुधूरि : सं०स्त्री० (सं० गोधूलि)। सन्ध्या का झुटपुटा, जब चर कर लोटी हुई गायों के खुर की धूल आकाश में छा जाती है। मा० १.३१२
धेनुपद : गोपद । गाय के खुर का चिन्ह । 'नाथ कृपा भवसिंधु धेनुपद सम जो जानि सिरावौं ।' विन० १४२.११
धेनुमति : सं०स्त्री० (सं० गोमती)। लखनऊ होकर बहने वाली एक नदी। मा० १.१४३ ५
धेन : धेनु । मा० १.१४६.१
धया : धाई (सं० घाविता>प्रा० धाविया धाइया) । दौड़ पड़ी। सुनि कल बेनु धेनु धुकि धया।' कृ०१६
है : आ० भ० ए० । दौड़ेगा । 'बिबुध समाज बिलोकन धेहै ।' गी० ५.५०.२
घंही : आ०भ०मब० । दौड़ोगे । 'ठुमक ठुमक कब धेही ।' गी० १.८.३
धोइ : पू० । धो कर, प्रक्षालित कर । 'कलिमल मनोमल धोइ बिनु श्रम राम धाम __सिधावहीं।' मा० ७.१३० छं० २।
धोएँ : क्रि०वि० । धोए हुए । 'बिना पग धोएँ नाथ नाव ना चढ़ाइहौं।' कवि० २.८
धोए : (१) भूकृ००० । प्रक्षालित किये । 'जिन्ह एहिं बारि न मानस धोए।' मा० १.४३.७ (२) धोएं। धोने से । ह है कीच कोठिला धोए ।' कृ० ११
धोख : सं० । धोखा, छल, भूल, भ्रम । 'भाइहु लावह धोख जनि ।' मा० २.१६१ (खेत में पशुओं से रक्षा हेतु बनायी हुई मानवाकृति को भी धोख' कहते हैं।
धोखें : क्रि०वि० । धोखे से, भ्रमवश । जिमि धोखें मदपान करि।' मा० २.१४४
धोखे : धोख+ब० । तृण-मानब (दे० धोख) । जहाँ तहाँ भे अचेत खेत के से धोखें हैं।' गी० १६५.३
धोखेउ : धोखे से भी, अनजान में भी । 'धोखेउ निकसत राम ।' वैरा० ३७
धोखेह : धोखेउ । 'सो धोखेहु न बिचार्यो ।' विन० २०२.१ तुलसी शब्दकोश 
497 
घोडो : धोख+कए। धोखा, भूल भटक, चूक । 'तुलसी प्रभु झूठे जीवन लगि समय न धोखो लेहौं ।' गी० ३.१३.४
षोती : सं०स्त्री० । धौत वस्त्र, स्वच्छ अधोवस्त्र, जो कटि से नीचे पहना जाता है। श्वेत परिधान विशेष । मा० १.३२७.३
घोजी : सं०० (सं० धावक) । रजक । 'धोबी कैसो कूकरु न घर को न घाट को।' कवि० ७.६६
धोये : धोए।
बोयो : भूक-पु०कए। प्रक्षालित किया। 'चाहत कुटिल मलहि मल धोयो।' विन० २४५.३
घोरी : (१) सं०स्त्री० (सं० धोरणी)। लगातार श्रेणी, अखण्ड पांत । 'धींग धरमध्वज धंधक धोरी।' मा० १.१२.४ (दे० द्वितीय अर्थ) । (२) वि.पु. (सं० धौरेय)। धुरीण, भारधारी। 'चलत भगति बल धीरज धोरी।' मा० २.२३४५ 
Vधोव, धोवइ : (सं० धावति-धावु शुद्धी>प्रा० धोवइ) आ०प्रए । धोता है, प्रक्षालित करती है। रान० १४
घोवनि : सं०स्त्री०। धोने की क्रिया (मुखप्रक्षाल आदि) । 'रोवनि धोवनि 
__ अनखानि अन रसनि ।' गी० १.२१.२
घोवावई : आ०प्रब० । धुलाते हैं । 'जो पगु नाउनि धोवइ राम धोवावई हो।' रा०न० १४
घौ : अव्यय (सं० ध्र वम्>प्रा० धुवं)। (१) निश्चय ही। 'समुझि धौं जिय भामिनी ।' मा० २.५० छं० (२) भला । (प्रश्न) । 'काहे को करति रोष, देहि धौं कोने को दोष ।' कृ० ३७ (३) संभावना । 'ईसु काहि धौं देइ बड़ाई।' मा० १.२४०.१ (४) अथवा । 'की धौं स्रवन सुनेहि नहिं मोही।' मा० ५.२१.२
घौंज : सं०स्त्री० (सं० धृज-वृजि गतो) । दौड़, धावन क्रिया। 'एक करें धौंज, एक कहैं काढ़ौ सौंज ।' कवि० ५.८
धौर : वि.पु. (सं० धौरेय) । बड़े, भारी भरकम, भारधारी। 'धरनीधर धौर ___धकान हले हैं।' कवि० ६.३३
धौरहर : सं०० (सं० धवलगृह>प्रा. धवलहर)। चूने से पुता हुआ विशाल प्रासाद । 'चढ़ि धौरहर बिलोकि दखिन दिसि ।' गी० ६.१७.१
घोरि : धोरी । श्रेणी । गी० ७.१८.१
घोल : धवल । श्वेत । 'बगरे सुरधेनु के धौल कलोरे।' कवि० ७.१४४ 
498 
तुलसी शब्द कोर
ध्याइबे : भक०० । ध्यान करने । 'झ्याइवे को गाइबे को सेइबे सुमिरिबे को। __गी० २.३३.३
ध्यान : सं०० (सं.)। चित्त की अविच्छिन्न एकाग्रता। मा० १.३४ (२) योग के आठ अङ्गों में सातवां साधन-दे० धारणा ।
ध्यानरस : आराध्य में एकाग्रनिरुद्ध चित्त की वह दशा जिसमें भक्ति के आनन्द का योग हो और उसी आनन्द में चेतना आराध्य से अखण्ड एकाकार हो जाय। 'मगन ध्यानरस दंड जुग ।' मा० १.१११
ध्याना : ध्यान । मा० ७.११३.७
ध्यानु : ध्यान+कए । एकमात्र ध्यान साधना । 'ध्यान प्रथम जुग मखबिधि दूजें।' मा० १.२७.३ 
Vध्याव, ध्यावइ : (सं० ध्यायति>प्रा० धिआयइ) आ०प्रए । ध्यान करता है। __कोउ ब्रह्म निरगुन ध्याव ।' मा० ७.११३.७ 
ध्यावहि, ही : आप्रब० । ध्यान में लाते हैं । 'जोगी...बिमल मन जेहि ध्यावहीं।' मा० १५१ छं०
ध्रुवं : ध्रुव ने । 'ध्र सगलानि जपेउ हरि नाऊँ ।' मा० १.२६.५
ध्रुव : सं०० (सं.)। उत्तानपाद की बड़ी रानी सुनीति का पुत्र, जिसने विमाता के कहने से पिता द्वारा अपमानित होकर बाल्यकाल में तप किया था। मा० १.८४.४ (२) पुराणों के अनुसार उन्हीं ध्र व को अचल नक्षत्र के रूप में प्रतिष्ठा मिली।
भ्रू : ध्रव । 'सुनी न कथा प्रहलाद न धू की।' कवि० ७.८८
ध्वज : सं०० (सं०) । बड़ा झण्डा । मा० १.१६४.१
ध्वजा : ध्वज । मा० ६.८०.५
ध्वान्त : सं०० (सं०) । अन्धकार । मा० ३ श्लो० १
ध्वान्तचर : निशाचर । 'ध्वान्तचर सलभ संहार कारी।' विन० २७.१
ध्वहौं : आ०भ० उए० (सं० धाविष्यामि>प्रा० धोइहिमि>अ० धोइहिउँ)। धोऊँगा। तो जननी जग में या मख की कहाँ कालिमा ध्वहौं ।' गी० २.६२.१ . .. . . . .. . ... ... 
न : (१) निषेधार्थक अव्यय । (२) 'नाहिन' में निश्चयार्थक अव्यय । 
नंहि, ही : नाचहिं । मा० ६.८८.७; ३.२० छं० २
नंद : सं०० (सं०) (१) गोपमुख्य जिनके कृष्ण पालित पुत्र थे। कृ० २१ (२) पुत्र । 'रघुनंद' । मा० ७.१४ छं० १० . ... ... ...
..:. . . . . . ... ... ...... दुलसी शब्द कोश 
499 
नंदन : सं०० (सं.)। आनन्द देने वाला (१) पुत्र । 'अंजनी को नंदन प्रताप भूरि भानु सो।' हनु० ८ (२) सन्तति (गोत्रापत्य)। 'निसिचर निकर दले रघुनंदन ।' मा० १.२४.८
नंदनु : नंदन+कए । अद्वितीय पुत्र । 'दसरथ को नंदन बंदि कटैया ।' कवि० ७.५१
नंदलला : कष्ण । क० १२
नंदलाल : कृष्ण । कृ० ३४
नंदिगांव : नंदिग्राम । मा० २.३२४.२
नंदिग्राम : सं०० (सं०) ! अयोध्या के समीप एक गाँव । गी० २.७६.१
नंदिनि : (सं० नन्दिनी) । पुत्री (के अर्थ में प्रयुक्त)। मा० १.३६.१३
नंदीमुख : सं.पु. (सं० नान्दीमुख)। शुभ कर्मों में प्रथम कर्तव्य श्राद्धविशेष । मा० १.१६३
नः : सर्वनाम (सं.)। हमारा-री-रे । हमको। मा० ४ श्लो० १
नइ : (१) नई। नवीना। 'यह नइ रीति न राउरि होई।' मा० २.२६७.६ (२) पूकृ० (सं० नत्त्वा>प्रा० नविअ>अ० नवि)। झुक कर, नम्र होकर । बैंचि लेइ नइ नीचु ।' दो० ४७६
नई : नई.. पर । 'नई नाव सब मातु चढ़ाई ।' मा० २.२०२.८
नई : (१) वि०स्त्री० (सं० नवा>प्रा० नई)। नवीना । 'विस्व कल कीरति नई ।' मा० १.३२४ छं० ४ (२) भूकृ०स्त्री० (सं० नता>प्रा० नई) । झकी। 'सोहत सकोच सील नेह नारि नई है।' गी० १.८५.३ (जिस प्रकार 'नई नारि=नववधू संकोचादि से शोभा पाती है, उसी प्रकार झुकी हुई ग्रीवा 'नारि', सुशोभित हुई)।
नउनिया : नाउनि । रान० ८
नए : (१) वि०पू०ब० । नवीव । 'सींचत बिरह उर अंकुर नए ।' मा० २.१७६ छं० (२) अपूर्व । 'निमिष निमिष उपजत सुख नए।' मा० ७.८.६ (३) भृकृ००ब० । झुके, नत हुए । 'सानुज भरत सप्रेम राम पायन्ह नए।' जा०म०३०
नकबानी : सं०स्त्री० । नाक से बोलने या पानी पीने की क्रिया जब कण्ठरोध की स्थिति होती है । (मुहावरा) संकट दशा (नाक चना), विकट उलझन । 'तिन रंकन को नाक सँवारत हौं आयों नकबानी।' विन० ५.३
नकीब : सं०० (अरबी-नकीब)। सेना का अग्रणी जो सावधान एवं शूर-वीर होने के साथ (स्वराष्ट्र तथा परराष्ट्र) के लोगों की पूरी जानकारी रखता हो। 'बोलत पिक नकीब ।' क० ३२ 
500 
_______________________________________________
नकुल : सं०० (सं.)। नेवला । मा० १.३०३.३
नक : सं०० (सं.)। मगर (जलजन्तु विशेष)। मा० ६.४.५
नख : सं०० (सं०) । नाखून । मा० १.१०६.७
नखत : सं०० (सं० नक्षत्र>प्रा० नक्खत्त) । तारागण । मा० १.२३६.१ (२) ज्योतिष गणना में चन्द्रमा के सत्ताईस नक्षत्र =अश्विनी आदि।
नखतु : नखत+कए। सत्ताईस में से उपयुक्त शुभ नक्षत्र । 'ग्रह तिथि नखतु जोगु बर बारू ।' मा० १.३१२.६ ।
नखन्हि : नख-+संब० । नखों (से) । 'नखन्हि लिलार बिदारत भयऊ ।' मा० ६.९८.६
नखसिख : क्रि०वि० (सं० आनख-शिखम्) । नखों से शिखा पर्यन्त =सर्वाङ्ग प्रत्यङ्ग (देवों के लिए नीचे के अङ्ग= चरण से आरम्भ करके वर्णन शिखा तक चलता है-इस क्रम के आधार पर यह शब्द बना है)। नख सिख निरखि राम के सोभा ।' मा० १.२३४.४
नग : सं०पु० (सं०) । हीरा, रत्न । 'सोभा सिंधु संभव से नीके नीके नग हैं।" गी० २.२७.२ (२) मुक्ता। निज गुन घटत न नाग-नग परखि परिहरता कोल ।' दो० ३८५
नगन : वि० (सं० नग्न) । निर्वसन । मा० ५.११ ४
नगफंग : (दे० फंग) छली लुच्चे का फन्दा। धूर्त-जाल (सं० नग्न =निर्लज्ज, धूर्त, क्षपणक>प्रा० नग्ग>नग+फंग) । कठिन फंसाव । 'हो भले नगफैग परे गढ़ोवै ।' कृ० ११ (इसे 'नाग' का फन्दा भी माना जा सकता है- अजगर आदि का बन्धन ।)
नगनियाँ : सं०स्त्री०ब० । सर्प-फणाकार (या ताम्बूलाकार) कर्णाभरण । 'काननि नगनियाँ ।' गी० १.३४.४
नगर : सं०० (सं०) । पुर, शहर। मा० १.३६
नगरबासिन्ह : नगरबासी+संब० । पुर-वासियों (को) । 'सकल नगर-बासिन्ह सुख दीन्हा ।' मा० १.२००.७
नगरी : सं०स्त्री० (सं.)। नगर । कवि० ७.१६९
नगर : नगर+कए । 'जाइ देखि आवहु नगरु । मा० १.२१८
नधुषु : नहुष>नघुष+कए। राजा नडुष । 'ससि गुरतिय गामी, नघुषु चढ़ेउ भूमि सुजान ।' मा० २-२२८
नचत : नाचत । 'किलकि सखा सब नचत मोर ज्यों।' क० १६
नहि : नाहिं । नचाहिं मोर ।' गी० २४७१३ तुलसी शब्दकोश 
501 
नचाइ : पूर्व० (सं० नर्तयित्वा>प्रा० नच्चाविष>अ० नच्चावि) । नचाकर, नाच करवा कर । 'छाड़हि नचाइ हाहा कराइ ।' गी० ७.२२.७
नचाइहि : आ०भ०प्रए० (सं० नर्तयिष्यति>प्रा० नच्चाविहिइ) । नचाएगा-गी । 'निगानांग करि नितहिं नचाइहि नाच ।' बर० २४
नचायो : नचावा+कए० । नचाया। 'ग्वाल जुबतिन्ह सोइ नाच नचायो ।' विन १८.३
नचाव : नचावइ । 'जनु बर बरहि नचाव ।' मा० १.३१६ /नचाव
नचावह : (सं० नर्तयति>प्रा० नच्चावइ) आ०प्रए० । नचाता-ती है। 'भकुटि बिलास नचावइ ताही ।' मा० १.२००.५
नचावत : वकृ०० । नचाता, नचाते । 'जात नचावत चपल तुरंगा।' मा० १.३१६.५ 
नचावति, ती : वकृस्त्री० । नचाती। 'चुटकी बजावती नचावती कोसल्या माता।' गी० १.३३.४
नचावनिहारे : वि०पु०ब० । नचाने वाले (गति देने वाले)। 'बिधि हरि संभु नचावनिहारे ।' मा० २.१२७.१
नचावहि : आ०प्रब० (सं० नर्तयन्ति>प्रा० नच्चावंति>अ० नच्चावहिं) । नचाते हैं। 'तुरग नचावहिं कुऔर बर ।' मा० १.३०२
नचावा : (१) नचावइ । 'जो माया सब जगहि नचावा।' मा० ७.७२.१ (२) भूकृ० । नचाया, स्वांग कराया। 'जेहिं बहुबार नचावा मोही।' मा० ७५६.६
नट : सं०० (सं०) । (१) नर्तक, अभिनेता, स्वांग करने वाला। 'नाऊ बारी भाट नट ।' मा० १.३१६ (२) संगीत में रागविशेष । 'गावत गोपाल लाल नीके राग नट हैं।' कृ० २०
नटत : वकृ०० (सं० नटत्) । नृत्य करता-करते । 'कूजत बिहग नटत कल मोरा।' मा० १.२२७.६
नटनागर : नाट्य-कुशल श्रीकृष्ण । 'जो बरी नटनागर हेरि हलाको ।' कवि० ७.१३४
ननि : सं०स्त्री० । नृत्यक्रिया, नर्तन । 'किलकनि नटनि चलनि चितवनि ।' गी० १.६.३
नटी : दे० नाक नटी।
नटी : सं०स्त्री० (सं०) । अभिनेत्री, नर्तकी । मा० ७.७२.२
'नटु : नट+कए० । नर्तक । अनुहरि ताल गतिहि नटु नाचा।' मा० २.२४१.४
नटया : सं-स्त्री० । नट्टी, गला । 'लै चलिहैं भट बांधि नटया।' कवि० ७.५१ 
502 
तुलसी सन्दकोश 
नत : (१) (न+त) नहीं तो । 'सीता देइ मिलहु नत मावा काल तुम्हार ।' मा० ५.५२ (२) वि०० (सं.)। विनत, प्रणत, शरणागत । 'बहुतै नत पाले।" हनु० १७
नतग्रीव : वि० (सं०) । गर्दन झुकाये हुए । विन० २७.२
नतपाल : वि०पू० (सं०) । शरणागतों का पालनकर्ता । 'बाल ज्यों कृपाल नतपाल पालि पोसो है ।' हनु० २६
नतपालक : नतपाल । 'नतपालक पावन पनी।' गी० ५.३६.४
नतपाल : नतपाल+कए । एकमात्र प्रणत-रक्षक । 'समरथ कृपालु नतपालु ।' विन० १६३.७
नतमात्र : वि० (सं.)। केवल नमन किये हुए । विन० ४४.६
नतरु : अव्यय । नहीं तो, अन्यथा । 'नतरु जनम जग जायें ।' मा० २.७०
नति : सं०स्त्री० (सं०) । प्रणति, नमन । 'पितु पद गहि कहि कोटि नति ।' मा० १.६५
नतु : नत (सं०) । नहीं तो। 'न तु लै मिलु सीय चहै सुख जो रे ।' कवि० ६.१२
नथुनियाँ : सं०स्त्री० । नथ, नथुनी, नासाभरण । गी० १.३४.३
नद : सं०पू० (सं.)। बड़ी नदी । मा० २.६२.७
नविहि : नदी को। 'नदिहि सिरु नावा । मा० २.२२१.४
नदी : नदी+ब० । नदियाँ । 'सब सर सिंधु नदी नद नाना ।' मा० २.१३८.५
नवी : सं०स्त्री० (सं०) । सरिता । मा० १.३५.२
नदीस : सं०पू० (सं० नदीश) । समुद्र । मा० ६.५
ननिअउरें: (सं० नानिकापुरे>प्रा० नाणिअउरेण) ननिहाल में। 'पठए भरतु भूप ननिअउरें।' मा० २.१८.२
नपुंसक : सं०० (सं०)। स्त्रीत्व तथा पुस्त्व दोनों से रहित व्यक्ति । मा० ७.८७ क
नफीरि : सं-स्त्री० (अरबी-नफीर)। बड़ी बाँसुरी, करनाय नाम का बाजा। 'बाजहिं भेरि नफीरि अपारा ।' मा० ६.४१.३ 
नबीन, ना : वि० (सं० नवीव) । नूतन । मा० २.१९८; १.१२६.४
नबीने : नबीन+ब० । नये । 'काटतहीं पुनि भए नबीने ।' मा० ६.६२.११
नम : सं.पुं० (सं० नमस्) । आकाश । मा० १.८.१
नभग : सं०० (सं० नभोग) । आकाशगामी-पक्षी । मा० ७.७०.१
नभगामी : नभग । मा० ७.६४.१
नभ-गिरा : आकाशवाणी । मा० ७.११४.७
नभगेस : (नभग+सं० ईश>प्रा० ईस) । पक्षिराज गरुड़ । मा० ७.२१ सुलसीद-कोशः 
503: 
ममचर : नभगामी। (सं० नभश्चर) । पक्षी । मा० १.३.४
नमतल : सं०पु० (सं० नभस्तल)। आकाश भाग, व्योम मण्डल । 'फलंग फलांगहू तें धाटि नभतल भो।' हनु० ५
नमबानी : आकाशवाणी । मा० १.१७४.६
नभु : नभ+कए । 'धूप धूम नभु मेचक भयऊ ।' मा० १.३४७.१
नमत : (१) वकृ०० (सं० नमत् >प्रा० नमंत)। प्रणत होता-होते । 'जे न नमत हरि गुर पदमूला।' मा० १.११३.४ (२) प्रणाम करते हो। 'नमत नर्मद भुक्ति-मुक्ति-दाता।' विन० ४०.४
नमामहे : मा० उब० (सं० नमामः) । हम प्रणाम करते हैं । मा० ७.१३ छं० १-२-५ 
नमामि, मी : आउए० (सं० नमामि) । प्रणाम करता हूँ। 'राम नमामि नमामि 
__ नमामी।' मा० ७.१२४.७
ममि : पूकृ० । झुकर कर, नत होकर । ‘फल भारन नमि बिटप सब रहे भूमि निअराइ।' मा० ३.४०
नमित : भूकृ०० (सं०) । झुकाया हुआ, झुकाये हुए । 'बैठि नमित मुख सोचति सीता ।' मा० २.५८.२
नमिहै : आ०भ०प्रए । झुकेगा। 'नाम के प्रसाद भारु मेरी ओर नमिहै ।' कवि० ७७१
नम्र : वि० (सं.)। विनत, प्रणत (झुका हुआ), नमनशील । 'बाहिज नम्र देखि मोहि साईं। बिप्र पढ़ाव पुत्र की नाई।' मा० ७.१०५.६
नय : (क) सं०पु० (सं.)। (१) पद्धति, रीति, व्यवहार (२) उचित आचार 
(३) दूरदर्शिता, विवेक (४) नीति, राजनीति (५) योजना (६) सिद्धान्त (७) मत, सम्मत, प्रस्थान, सम्प्रदाय (८) दार्शनिक मतवाद (8) न्याय । 'बोले बचन राम नय नागर ।' मा० २.७०.७ (ख) वि० (सं० नव) । नवीन । 
'नय नगर बसाए।' गी० २.४६.२
नयऊ : नय+कए। नया, नवीन । 'हर गिरिजा बिहार नित नयऊ ।' मा० १.१०३.६
नयन : सं.पु. (सं.) । नेत्र । मा० १.२.१ नयनन, नि 
नयनन्ह, न्हि : नयन+संब० । नेत्रों। 'निज नयनन्हि देखा चहहिं ।' मा० १८८
नयनफलु : नेत्रों का परम प्रयोजन, आंख पाने की सार्थकता । 'पाइ नयन-फलु होहिं सुखारी।' मा० २.११४.३
नयनवंत : वि० (सं० नयनवत् >प्रा० नयणवंत) । नेत्रधारी । मा० २.१३६.१
नयना : नयन । मा० ३.११.२० 
504 
_______________________________________________
नयनानंद : नेत्रसुख, दर्शन लाभ का आनन्द । मा० ५.४५.२
नयनी : (समासान्त में) वि०स्त्री० । नेत्रों वाली । 'मृग नयनी ।' मा० २.११७.४ (मग तुल्य नेत्रों वाली)
नयपाल : वि०पू० (सं.) । नीति-रक्षक । दो० ४४२
नयवान : वि०पु० । नीतिशाली । रा०प्र० ७.७.३
नयसाली : वि० सं० नयशालिन) । नीति पूर्ण । मा० २.२६७.८ 
नयसील, ला : (दे० नय) वि० (सं० नयशील)। नय निभाने वाला। 'जामवंत मारुति नयसीला।' मा० ६.१०६.२
नये : नए।
नयो : (१) नयऊ। नवीन । 'जसु तुम्हरो नित नयो।' मा० ६.१०६ ० (२) भूकृ०पु०कए० (सं० नतः>प्रा० नओ>अ. नयउ)। झुका, प्रणत हुआ। बहोरि प्रभु चरनन्हि नयो।' मा० ६.८४ छं०
नर : सं०० (सं०) । (१) पुरुष । मा० १.३४३.८ (२) विष्णु के अवतार 'नर' जो नारायण के सहोदर कहे गये हैं। 'नर नारायण की तुम्ह दोऊ ।' मा० ४.१.८ (३) नारायण के बन्धु नर के अवतार अर्जुन-दे० नर नारि ।
नरक : सं०पु० (सं.)। यमलोक के कुम्भीपाक, रोख आदि निरय। मा० 
नरका : नरक । मा० ७.१००.४
नरकु : नरक+कए । 'सरगु नरकु अपबरगु समाना ।' मा० २.१३१.७
नरकेसरी : सं०+वि०० (सं०) । (१) मनुष्यों में सिंहवत् सर्वोपरि ; वीरोत्तम । (२) नृसिंह भगवान् । 'राम नाम नरकेसरी कनककसिपु कलिकाल ।' मा ० १.२७ नरके
हरि : नरकेसरी । 'प्रगटे नरके हरि खंभ महाँ।' कवि० ७.८
नरदेव : राजा । गी० १.६.२२
नरनाथ : राजा । मा० १.२८६७
नरनायक : राजा।
नरनायक : नरनायक+कए० । मा० २.४२.५
नरनारि : नरनारी। (१) स्त्री-पुरुष। 'प्रनवउँ पुर नर-नारि बहोरी।' मा. १.१६ २ (२) (दे० नर) नरावतार अर्जुन की पत्नी द्रौपदी। 'नर-नारि उधारि सभा महुँ होति ।' कवि० ७.६
नरनारी : (१) पुरुष तथा स्त्री । 'नृपहि सराहत सब नरनारी ।' मा० १.२८.७ (२) द्रौपदी । 'भूपसदसि सब नृप बिलोकि, प्रभु राखु, कह्यो नर-नारी।' विन० ६३.४ 
_______________________________________________
505 
नरनाह : राजा ने । 'तब नरना, बसिष्ठु बोलाए ।' मा० २.६.१ . 
नरनाह, हा : नरनाथ (प्रा०) । राजा । मा० १.२४८.७ 
नरनाहु, हू : नरनाह+कए० । मा० २.१५२.२ ‘जद्यपि नीति-निपुन नरनाहू।' मा० २.२७.७
नरपति : राजा । मा० २.२५.२
नरपसु : (सं० नरः पशुरिव =नरपशुः) । पशु तुल्य मूढ पुरुष । 'करहु कतारथ जन्म, होहु कत नरपसु ।' जा०म० ६२
नरपाल : राजा । मा० २.२६१
नरपाल : नरपाल+कए० । 'बिबरन भयउ निपट नरपाल ।' मा० २.२६.६
नरबर : श्रेष्ठ पुरुष । मा० २.७२.२
नरभूषन : पुरुषों में अलंकरण के समान प्रथम । श्रेष्ठ पुरुष । मा० १.२४१.८
नरम : वि० (फा० नर्म) । कोमल, मुलायम । 'करिबे कह कटु कठोर सुनत मधुर नरम ।' विन० १३१.२
नरराज : मनुष्यों का राजा । मा० २.१२६ छं.
नरलीला : मनुष्य रूप में अवतीर्ण भगवान की लीला । मा० ३.२४.१
नरलोफ : मर्त्यलोक, पृथ्वीलोक । 'नाक नरलोक पाताल ।' कवि० ६.४५
नरवइ : नरपति (प्रा.) । राजा । 'भयउ न, होइहि, है न जनक सम नरवइ ।' जा०म० ७
नरहरि : सं०० (सं०) । नृसिंह भगवान् । मा० १.१२२.८
नरहरी : नरहरि । मा० ५.४.१
नराणां : (सं० पद) मनुष्यों का-की-के । मा० ७.१०८.१३
नरादरेण : (नर+आदरेण) मनुष्य आदर से । मा० ३.४ छं०
नरु : नर+कए । कोई मनुष्य । 'सबकी सुधरै जो करै न पूजो।' कवि० ७.५
नरेषु : (सं० पद) मनुष्यों में । 'मतिमंद सकल-नरेषु ।' गी० ७.६.६ 
नरेस, सा : सं०० (सं० नरेश) । राजा । मा० १.१६७; १६४.१ 
नरेसु, सू : नरेस+कए । 'संकट परेउ नरेसु ।' मा० २.४०; १.१५३.२
नरों : परसों के बाद का दिन =नरसों। 'आजु कि कालि परों कि नरों ।' कवि० ७.१७६
नरो : नर+कए० (सं०
नर:>प्रा० नरो) । विन० २२६.४
नर्तक : सं०० (सं.)। (१) नट, नचनिया, नृत्यकला-कुशल । (२) भांड़ जाति जो वेश्या और धोबी का संकरवर्ण है । 'नर्तक नृत्यसमाज ।' मा० ७.२२ (नत्य कुशल ही नर्तक थे, रामराज्य में संकर जाति के नर्तक न थे) ।
नर्तकी : सं०स्त्री० (सं.)। नटी, नृत्य करने वाली (अभिनेत्री) । 'माया खल नर्तकी बिचारी।' मा० ७.११६.४ 
506 
_______________________________________________
नर्म : सं०पू० (सं० नर्मन्) । विनोद, विहार, सुख, रञ्जन ।
नर्मद : वि.पुं० (सं०) । सुखद, रञ्जक, आनन्दप्रद । धर्म कर्म नर्मद गुणग्रामः ।' मा० ३.११.१६
नल : सं०० (सं०) । (१) एक वानरयूथप । मा० ५.६०.१ (२) निषध देश महाभारत-प्रसिद्ध राजा का नाम ।
नलिन : सं.पु (सं०) । कमल । 'नलिन नयन भरि बारि ।' मा० ६.११४ ख
नलिनी : सं०स्त्री० (सं.)। कमलिनी, कमल वृक्ष या कमल पुष्प । 'कबहुं कि नलिनी करई बिकासा।' मा० ५.६.७
नल : नल+कए। (१) वानरयूथप विशेष । कवि० ५.२६ (२) राजा नल । "बिगत बिषाद भए पारथ नलु ।' विन० २४.३
नव : (१) संख्या (सं० नवन) । नौ। 'सात दीप नव खंड लौं।' वैरा० ५० (२) वि० (सं०)। नवीन । 'नव पल्लव फल सुमन सुहाए । मा० १.२२७.५ (३) नवइ । झुकता है, नम्र पड़ता है। 'डाटेहि पै नव नीच।' मा० ५.५८ नव
नवइ : (सं० नमति >प्रा० नमइ= नवइ) आ०प्रए । प्रणत होता है, झुकता है । 'नवे नाथ नाक को।' हनु० १२
नवगन : (१) यज्ञोपवीत के ३४३-६ सूत्र (गुण) (२) ब्राह्मण के
नव-धर्म: शम, दम, तप, शोच, क्षमा, ऋजुता, ज्ञान, विज्ञान और आस्तिकता । (गी० १८.४२) । 'नाथ एक गुन धनुष हमारें। नवगुन परम पुनीत तुम्हारें। मा० १.२८२.७
नवद्वार : नौ छिद्रों (द्वारों) वाला । 'नवमी नवद्वार पुर बसि जेहिं न आपु मल कीन्ह ।' विन० २०३.१० (अथर्व० में शरीर को नव द्वारों की अयोध्यापुरी कहा गया है- 'अष्टाचा नवद्वारा देवानां पूरयोध्या।' और गीता में भी 'नवद्वारे पुरे देही' आता है । नाक, कान, नेत्र, मुख, मूत्राङ्ग तथा मलत्यागाङ्ग के नव छिद्र ही इस नगर के नव द्वार हैं)।
नवधा : वि०स्त्री० (सं०) । नौ प्रकार की (भक्ति)। नवधा भक्ति के नौ अङ्ग हैं-सत्संग, कथाश्रवण, गुरुसेवा, गुणकीर्तन, जप, विषय-विराग, समशिता, सन्तोष और निश्छल समर्पण। मा० ३.३५-३६ .
नवनि : सं०स्त्री० । नति, नम्रता, झुकने की क्रिया। नवनि नीच के अति दुखदाई।' मा० ३.२४.७
नवनिद्ध : नवनिधि ।
नवनिधि : (सं०-महापद्मश्च पद्मश्च शङ्खो मकर-कच्छपी। मुकुन्द-कुन्दनीलाश्च खर्वश्च निधयो नव ।) 'हरषे जन नवनिधि घर आई।' मा० २.१३५.१ (यहाँ तुलसीद-कोश 
507 
दो अर्थ हैं-(१) अपूर्व निधि या अद्भुत धनागार (२) नवसंख्यक निधियो 
महापा, पा, शङ्क, मकर, कच्छप, मकुन्द, कुन्द, नील और खवं.)
नवनीत : सं०पु० (सं०) । मक्खन । नैन । 'संत हृदय नवनीत समाना।' मा० ७.१२५.७
नवनीता : नवनीत । मा० ७.१२५.८
नवम : वि.पु. (सं०) । नोवा । मा० ३.३६.५
नवमी : वि०+सं०स्त्री० (सं०) । (१) नवीं बात (२) पाख की नवी तिथि । 
__ विन० २०३.१०
नवरत्न : मुक्ता, माणिक्य, बिल्लोर, गोमेद, हीरा, विद्रुम (लाल मुंगा), पद्मराग, मरकत और नीलम ये क्रमशः मूल्यवान रत्न हैं। 'मुक्ता-माणिक्य-वैदूर्य-गोमेदा वन-विद्रुमौ । पद्मरागो मरकतं नीलश्चेति यथाक्रमम् ।' मा० ७.२३.६
नवरस : शृङ्गार, वीर, करुण, अद्भुत, हास्य, भयानक, बीभत्स, रौद्र और शान्त । 'तौ षटरस नवरस रस अनरस हर जाते सब सीठे।' विन० १६६.१
नवल : वि० (सं०) । अत्यन्त नवीन, सद्यस्क । मा० १.२४८.२
नवला : वि०स्त्री० (सं.) । नवयुवती, नबेली। 'का घूघट मुख मूदह नवला नारि । बर० १७
नवग्रह : सूर्य, चन्द्र, मङ्गल, बुध, बृहस्पति, शुक्र, शनि, राहु और केतु-ग्रह। विन० ६२.७
नवसत : नवसप्त । 'नवसत सँवारि सुंदरि चलीं।' गी० ७.१८.४
नवसप्त : संख्या (सं.) । सोलह (षोडश शृङ्गार) । मा० १.२२२ छं.
नवसात : नवसप्त । राजति बिन भूषन नवसात ।' गी० २.१५.३
नवहिं : (१) नौ से। . वहिं बिरोधे नहिं कल्याना ।' मा० ३ २६.३ (२) आप्रब० । झुकते हैं, नत होते हैं। 'पर उपकारी पुरुष जिमि नवहिं सूसंपति पाइ।' मा० ३.४०
नवहीं : नवहिं । नत होते हैं । 'मुनि रघुबीर परसपर नवहीं।' मा० २.१०८.४
नवावहिं : आ०प्रब० (सं० नमयन्ति'>प्रा० नवावंति>अ० नवावहिं) । झुकाते हैं। 'प्रभु कर जोरें सीस नवावहिं ।' मा० ७.३३.४
नवावौं : आ० उए । झुका दू, झुका सकता हूं। 'का बापुरो पिनाक, मेलि गुन ___मंदर मेरु नवावौं।' गी० १.८६.८
नवे : नवइ ।
नस : सं०स्त्री (सं० स्नसा>प्रा० नसा>अ० नस)। स्नायु, नाड़ी। 'अस्थि सैल, सरिता नस जारा।' मा० ६.१५.७ निसा 
नसाइ, ई : (सं० नश्यति>प्रा. नासइ) आ०प्रए । (१) मिटता है । 'सुनि कलि कलुष नसाइ ।' मा० १.२६ ग (२) अदृश्य होता-ती है। कहत 
508 
_______________________________________________
'जेहि बिधि सोकु कलंकु नसाई ।' मा० २.५०.८ 
नसाइए, ये : आ०कवा०प्रए । (सं० नाश्यते>प्रा. नसावीअइ)। नष्ट किया जाय, मिटाया जाय । 'पाप रासि नसाइये ।' विन० १३६.१०
नसाइहि : आ०भ०प्रए० (सं० नंक्ष्यति>प्रा० नासिहिइ)। नष्ट होगा, बिगड़ 
__ जायगा । 'काजु नसाइहि होत प्रभाता।' मा० ६.६०.५
नसाइहौं : आ०भ० उए० (सं० नाशयिष्यामि>प्रा० नसाविहिमि>अ० नसाविहिउँ) । मिटाऊँगा-गी। 'डिढि मुठि निठुर नसाइहौं ।' गी० १.२१.२
नसाई : (१) नसाइ । (२) पू० । नष्ट होकर । 'जाइ लोक परलोकु नसाई।' मा० २.२६३.७ (३) भूकृ०स्त्री० । नष्ट कर दी। 'निकाई सो नसाई है।' कवि० ७१८१ 
नसाउ, ऊ : आ०--संभावना--प्रए० (सं० नश्यतु>प्रा० नासउ) । चाहे नष्ट हो जाय । 'सुकृतु सुजसु परलोकु नसाऊ। 'तुम्हहि जान बन कहिहि न काऊ।' मा० २.७६.४
नसाए : भूकृ००० । (सं० नाशित>प्रा० नसाविय) । नष्ट किये । 'सिय निदंक अघ ओघ नसाए ।' मा० १.१६.३
नसातो : क्रियाति पु०ए० (सं०) अनंक्ष्यत् >प्रा० नासंतो) । (यदि तो) नष्ट हो जाता । 'तुलसी राम प्रसाद सो तिहुं ताप नसातो।' विन० १५१.६
नसाना : भूकृ०पू०ए० । नष्ट हो गया। 'स्वरथ रत परलोक नसाना ।' मा० ७.४१.४
नसानी : भूकृस्त्री० । (१) नष्ट हुई। 'प्रथम अबिद्या निसा नसानी।' मा० ७.३१.३ (२) बिगड़ी । 'सुधरै सबै नसानी।' कृ० ४६
नसायो : भूकृ०० कए. (सं० नाशितम् >प्रा० नसावियं>अ० नसावियउ)। नष्ट किया। 'दुख..'तुम्हई नसायो।' मा० ६.११०.८ निसाव
नसावइ : (सं० नाशयति>प्रा० नसावइ) आ०प्रए० । (१) मिटाता है। 'पाप ताप सब सूल नसावै ।' वैरा० २२ (२) अपने को मिटा है-मिट । है (नसाइ)। 'न बिपति नसावै।' विन० १२३.३
नसावन : वि०० । नाशक, उच्छेपनशील । 'नाम अखिल अघपूग नसावन ।' मा० ७.६२.२
नसावनि : वि.स्त्री० । नष्ट करने वाली। भगति ..... भवदाप नसावनि ।' मा० ७३५.१ 
नसावहि, हीं : आ० भ० प्रब० (सं० नाशयन्ति>प्रा० नसावंति>अ० नसावहिं) । नष्ट करते हैं। 'उभय लोक निज हाथ नसावहिं।' मा० ७.१००.७