_______________________________________________
921
राति, राती : सं०स्त्री० (सं० रात्रि, रात्री>प्रा० रत्ति, रत्ती)। निशा । मा० १.१०८.७, २.११.७७
रातिचर : निशाचर । 'मारे रन रातिचर ।' कवि० ६.५८
रातिचरराज : राक्षसराज, रावण । 'सेना सराहन जोगु रातिचर-राज की।' कवि.
राते : राता+ब। (१) रक्तवर्ण, लाल । 'नयन रिस राते ।' मा० १.२६८.६ (२) रंगे हुए-+अनुरक्त । 'जो पै जानकी नाथ के रंग न राते।' कवि० ७.४४
रातो: राता+कए० । अनुरक्त हुआ (होता-क्रियाति पु०ए०) । 'जो मन प्रीति प्रतीति सो राम नामहि रातो।' विन० १५१.६
रात्यो : रातो। अनुक्त हुआ । 'मोह मद मात्यो रात्यो कुमति कुनारि सों।' कवि० ७.८२
राधो : भूकृ.पु.कए० (सं० राद्धः>प्रा० रद्धो) । आराधित किया। 'जो पै राधो नहीं पति पारबती को।' कवि० ७.१५६
रानि : रानी । मा० २.१३.७७
रानिन, रानिन्ह : रानी+संब० । रानियों। 'रानिन्ह कर दारुन दुख दावा ।' मा० १.२६०.६
रानीं : रानी+ब० । रानियाँ । 'मंदिर महें सब राजहिं रानी' मा० १.१६०.७
रानी : संस्त्री . (सं० राजी>प्रा० राणी)। राज पत्नी । मा० १.४०
राम : (१) सं०+वि.पु. (सं0-रमन्ते योगिनो यस्मिन् स रामः)। योगियों तथा भक्तों का आनन्दमय विश्रामस्थल । (२) परमात्मा। 'राम सच्चिदानंद दिनेसा ।' मा० १.११६.५ (३) कोसल्यापुत्र (अवतार रूप). राम । मा० २.१३.२ (४) 'राम' शब्द । 'मुखन ते धोखेउ निकसत राम ।' वैरा० ३७ (५) परशुराम । 'कहा राम सन राम ।' मा० १.२८२ (६) कृष्ण के अग्रज (बल)। कृ० २६ (७) यक्षर 'राम' मन्त्र ।
रामघाट : वह गङ्गा तट जहाँ शृंगवेर पुर में रह कर राम ने स्नान किया था। मा० २.१६७.४
रामचंद : रामचंद्र । मा० २.१.६
रामचंदु : रामचंद+कए । 'रामचंदु पति सो बैदेही ।' मा० २.६१.७
रामचंद्र : चन्द्रमा के समान आह्लादकारी भगवान् राम । मा० २.१६७.६
रामचरित : राम की सम्पूर्ण जीवनचर्या । मा० १.११ ।।
रामचरितमानस : काव्य का नाम । (१) शिव के मन में रक्षित राम का चरित । (२) मानस सरोवर के समान हृदय का आह्लादकारी रामचरित । (३) राम चरित रूपी मानस सरोवर । :रचि महेस निज मानस राखा। ....."तातें रामचरितमानस बर।' मा० १.३५.११-१२ (मानस सरोवर की तुलना का लम्बा रूपक है। मा० १.३५-४३) ।
रामचरित्रमानस : रामचरितमानस । मा० ७.१३० श्लो० २
रामघाम, पद : (१) रामचन्द्र का आवास गृह । 'रामधाम सिख देन पठाए ।' मा० २.६.१ (२) साकेत लोक=राम ब्रह्म से सायुज्य की दशा जिसमें जीव सदा अपने को रामाकार हुआ (मुक्त) अनुभव करता है । गी० ३.१७.८
रामपद : रामधाम । जीव-ब्रह्म की सायुज्यदशा । मा० १.४४.१
रामबनु : रामबन+कए० । चित्रकूट का वनविशेष जहाँ राम रहे थे। मा०. २.१३८.३
रामबोला : वि.+सं००। (१) 'राम' का उच्चारण करने वाला। (२) गोस्वामी जी का नाम । 'राम-बोला नाम ही गुलाम राम साहि को।' कवि० ७.१००
रामभगति : (दे० भगति)। रामाकार चित्तवृत्ति से राम की उपासना जो दास्यरूप में मुख्य होती है । मा० १.४०.१
रामभद्र : रामचन्द्र । कल्याणगुण सम्पन्न राम । विन० १५०.१
राम-मंत्र : 'राम' शब्दरूप यक्षर मन्त्र । मा० ७.११३.६
राममय : वि.पु. (सं.)। रामरूप तथा राम से व्याप्त (ब्रह्म-राम अंशी हैं और जड़-चेतन विश्व उनका अंश है अतः समस्त प्रपञ्च राम का ही रूपावतार है; अन्तर्यामी रूप से राम सब में व्याप्त भी हैं)। 'जड़ चेतन जग जीव जत सकल राममय जानि ।' मा० १.७ ग
रामा : (१) राम । मा० १.१९८.६ (२) सं०स्त्री० (सं.)। सुन्दरी, स्त्री। 'रामासि वामासि वर बुद्धि वानी।' विन० १५.३ (३) लक्ष्मी, सीता । 'रामा रमन रावनारी ।' विन० ५५.२
रामाकार : द्रवीभूत चित्त की दशा जो राममय हो जाती है, जागतिक विषयों के स्थान पर चित्त में राम का आकार प्रविष्ट हो जाता है। राममय । 'रामाकार भए तिन्ह के मन । मुक्त भए छूटे भवबंधन ।' मा० ६.११४७
रामाख्य : राम नाम वाला (आख्या=नाम) । मा० ५ श्लो० १
रामानुज : राम के अनुज-लक्ष्मण । मा० ४.२०
रामायण : सं०० (सं.)। आदि कवि वाल्मीकि द्वारा रचित महाकाव्य । मा० ७.१३० श्लो०१
रामायन : रामायण । (१) आदिकाव्य । 'बंदउँ मुनिपद कंज रामायन जेहिं निरमयउ।' मा० १.१४ (२) रामकथा, रामचरित । (रामायन सतकोटि अपारा।' मा० १.३३.६
_______________________________________________
923
रामायुध : (१) धनुष-बाण । (२) धनुष बाण के रेखाचित्र (जो रामानन्दी वैष्णव अपने शरीर आदि पर अडिकत कराते हैं)। 'रामायुध अंकित गृह ।' मा० ५.५
रामु, रामू : राम+कए । रामु सहज आनंद निधान ।' मा० २.४१.५; १.२६६
रामेस्वर : सं०० (सं० रामेश्वर) । समुद्र तट पर रामचन्द्र द्वारा स्थापित शिव । ___ मा० ६.३.१
रामै : रामहि । राम के । 'दूसरो न देखतु साहिब सम राम ।' गी० ५.२५.१
रायँ : राजा ने । 'तबहिं राय प्रिय नारि बोलाई।' मा० १.१६०.१
राय : (क) सं०० (सं० राजन >प्रा. राया) । (१) राजा । 'राय रजायसु सब कह नीका।' मा० २.१८१.३ (२) (समासान्त में) राजा । 'कोसलराय'। मा० २.१३५ (३) (समासान्त में) श्रेष्ठ । 'मुनिराय' । मा० २.१२६.१ 'धनुधर-राय ।' गी० २.२८.४ (४) राव सामन्त । ऊँचे नीचे बीच के धनिक रंक राजा राय ।' कवि० ७.१७५ (ख) सं०स्त्री० (सं० रै-राय:) धन । रंकन्ह राय रासि जनु लूटी।' मा० २.११७.८
रायमुनीं : सं०स्त्री०ब० । ललमुनिया = लाल रंग की विशेष चिड़ियाँ। मा० ६.१०३ छं०
राया : (१) राय । राजा । मा० १.१६६.४ (२) स्वामी । 'बोले बिसि चराचर राया।' मा० १.१२८.६
रारि, रारी : सं०स्त्री० (सं० राटि>प्रा० राडि, राडी)। युद्ध, कलह । 'तो न बढ़ाइअ रारि।' मा० ६.६; १.४२.५
राव : राउ । राजा या सामन्त । रिंकहू को रावहू को सुलभ ।' विन० २५५.२
रावन : सं०० (सं० रावण) । लङ केश्वर, दशग्रीव। मा० १.७६
रावनारि, रावनारी : (सं० रावणारि) रावण के शत्रुराम । मा० ३.४६ क
रावनु : रावन+कए० । 'भयउ रोषु रन रावन मारा।' मा० १.४६.८
रावनो: (१) रावनु । 'सबिषाद कहै रावनो।' कवि० ५.६ (२) रावण भी।  'अकुलाइ उठो रावनो।' कवि० ५.८
रावरि, रावरी : (दे० राउर) वि०स्त्री० । आपकी। 'रघुबर रावरि यहै बड़ाई।' विन० १६५.१, मा० १.२६
रावरिय, रीऐ, रीये : आपकी ही। 'मेरे रावरियै गति ।' विन० १५३.१ 'आस रावरीय दास रावरो बिचारिय।' हनु० २१ ।
रावरें : आपके.. से। 'संबंध राजन रावरें हम बड़े अब सब बिधि भए।' मा० १.३२६ छं० २
रावरे : (दे० राउर) । (१) आपके । 'साँवरे से सखि रावरे को हैं।' कवि. २.२१ (२) आप लोग । 'बावरे ही रावरे ।' कवि० ५.८ हैं
924
_______________________________________________
रावरेई : आपके ही । 'आगम निगम कहैं रावरेई गुन ग्राम।' विन० ७७.३
रवरेऊ : आप भी। 'रावरेऊ जानि जिय कीजिए ज अपने ।' कवि० ७.७८
रावरो : रावर+कए० (दे० राउर) । आपका । 'सीलु सनेहु जानत रावरो।' मा० १.२३६ छं०
रावरोई : आपका ही। 'रावरो भरोसो तुलसी के रावरोई बल ।' हनु० २१
रास : सं०० (सं.)। (१) कोलाहल, शब्द । (२) नत्यविशेष (जो कृष्ण ने गोपियों के साथ रचाया था); रासलीला । 'ब्रज बसि रास बिलास, मधुपरी चेरी सों रति मानी ।' कु. ४७
रासभ : सं०० (सं.)। गधा । मा० ३.२६.५
रासभी : संस्त्री० (सं०) । गधी। 'बेचिए विबुध-धेनु रासभी बेसाहिए।' कवि० ७.७६
रासि, रासी : संस्त्री० (सं० राशि>प्रा० रासि, रासी)। ढेरी, पुज। मा० ३.२२ ६ 'सिव भगवान ग्यान गुन रासी।' मा० १.४६.३
रासिन्ह : रासि+संब० । राशियों, ढेरों। 'जनु अंगार रासिन्ह पर ।' मा० ६.५३
राहु, राहू : सं०पू० (सं.)। (१) पृथ्वी की छाया जो अष्टमग्रह के रूप में मान्य है और ग्रहण का कारण है। (२) पुराणों में एक असुर जिसे समुन्दमन्थन में अमृत-पान करते हुए विष्णु ने सुदर्शन चक्र से काट दिया तो सिर भाग राहु और धड़ केतु बन गये । मा० १.७०
राहू : राहु । मा० १.७.६
राहुमातु : राहु की माता=सिंहिका (राक्षसी) । हनु० २१
रिगु : सं०० (सं० ऋग्-स्त्री०)। ऋग्वेद । विन० १५५.२
रिच्छ : सं०पु० (सं० ऋक्ष) । भालू । गी० ६.१६.३
रिच्छेस : (सं० ऋक्षेश)। भालुओं के राजा =जाम्बवान् । मा० ६.३९.३
रिछेसा : रिच्छेस । मा• ४.२६.७
रिझये : भूक००ब० । रिझाये हुए, आसक्त । 'खेलन लगे खेल रिझये री।' गी. १.४५.२
रिझयो : भूकृ००कए। रिझाया, तल्लीन किया। 'कलगान तान दिनमनि रिझयो री।' गी० ७.७.२
रिझवै : आ०प्रए० (रीझ+प्रेरणा)। रिझाता-ती है, अनुरक्त करता-ती है; अनुकूल करता-ती है । 'सो कमला.. रिझर्व सुरमौरहि ।' कवि० ७.२६
रिझाइ : पू० । रिझा कर, फुसला कर । 'बातन्ह मनहि रिझाइ सठ जनि घालसि कुल खीस ।' मा० ५.५६
रिभाइबो : भक००कए । रिझाना, अनुकूल बनाना। 'तुलसी लोग रिशाइबो करषि कातिबो नान्ह ।' दो० ४६२
_______________________________________________
925
रिझाई : रिझाइ । मा० ६.२४.२
रिझाएँ : क्रि०वि० । रिझाने से, अनकल एवं सन्तुष्ट करने से । 'कहहु कवनि सिधि लोक रिझाएँ ।' मा० १.१६२.२ ।।
रिझावौं : आ० उए । रिझाऊँ, अनुकूल करूं, मनाऊँ । 'तुलसिदास प्रभु सो गुन नहिं जेहिं सपनेहुँ तुमहि रिझावौं ।' विन० १४२.११ ।।
रितई : भूकृ०स्त्री० । रिक्त कर दी, छछी कर डाली । 'मही मोद मंगल रितई है।" विन० १३६.६
रितएँ : क्रि०वि० । रिक्त करने पर । 'को भरिहै हरि के रितएँ।' कवि० ७.४७
रितए : भकृ००ब० । रिक्त किये । 'देत सबनि मंदिर रितए।' गी० १.३.६
रितए : आ०प्रए० (सं० रिक्तयति-रिक्तं करोति>प्रा० रित्तवइ)। छूछा (रिक्त) करता या कर सकता है । 'रितवं पुनि को हरि जौं भरिहै ।' कवि०. ७.४७
रितवहिं : आप्रब० (सं० रिक्तयन्ति>प्रा. रितवंति>अ० रित्तवहिं)। छूछा करते हैं (उडेलते हैं) । 'कलस भरहिं अरु रितवहिं।' जा०म०८०
रितु : सं००+ स्त्री० (सं० ऋतु)। वर्ष का छठा भाग जो दो मास का होता है-बसन्त-चैत्र-वैशाख, ग्रीष्म-ज्येष्ठ-आषाढ़, वर्षा-श्रावण-भाद्रपद, शरद् =आश्विन-कार्तिक, हेमन्त =मार्गशीर्ष-पोष, शिशिर=माघ-फाल्गुन । मा० १.१६
रितुन्ह : रितु+संब० । ऋतुओं (में) । 'सकल रितुन्ह सुखदायक ।' गी० ७.२१.२
रितुराज, रितुराजा : बसन्त ऋतु । मा० २.१३३, १.८६.६
रितुराजु, रितुराजू : रितुराज+कए । अद्वितीय बसन्त । 'सो मुद मंगलमय रितुराजू ।' मा० १.४२.३
रितो : आ०-आज्ञा-मए० (सं० रिक्तय-रिक्तं कुरु>प्रा० रित्तव) । तू रीता कर, उडेल कर खाली कर ले । 'सांवर रूप सुधा भरिबे कह नयन कमल कल कलस रिती री।' गी० १.७७.२
रिद्धि : सं० स्त्री० (सं० ऋद्धि)। ऐश्वर्य । रिद्धि सिद्धि संपत्ति सुख ।' मा० १.६५. (विकास, सफलता, सम्पत्ति, प्रचुरता, सौभाग्य, औदात्य, महिमा, लोकोत्तरता, पूर्णता-इतने अर्थ समूह को 'ऋद्धि' कहते हैं । पार्वती और लक्ष्मी को भी इस नाम से जाना जाता है। 'ऋद्धि' और 'सिद्धि' गणेश-पत्नियां भी कही गयी
रिधि : रिद्धि । मा० १.३४५.२
रिन : (१) सं०० (सं० ऋण>प्रा० रिण) । ब्याज पर लिया हुआ धन । 'रिपु रिन रंच न राखब काऊ ।' मा० २.२२६.२ (२) धर्मशास्त्र में तीन ऋण =ऋषिः ऋण, देव ऋण और पित ऋण ।
926
_______________________________________________
रिनिया : वि०पु० (सं० ऋणिक>प्रा० रिणिय) । जिस पर ऋण हो= अधमर्ण = कर्जी । दो० १११
रिनी : रिनिया (सं० ऋणिन् >प्रा० रिणी)। 'तेरो रिनी ही कह्यो कपि सों।' विन० १६४.६
रिनु : रिन+कए। एकमात्र ऋण । 'गुर रिन रहा सोच बड़ जी के ।' मा० १.२७६.२ (गुरु-ऋण =ऋषि ऋण)।
रिपु : सं०पु+स्त्री० (सं०) । शत्रु । मा० १.१४ क
रिपुदमन : शत्रुओं का दमन करने वाला शत्रुघ्न ।
रिपुदमनु : रिपुदमन+कए । शत्रुघ्न । मा० २.१३
रिपुदवन : रिपुदमन । रा०प्र० ४.१.७
रिपुदवनू : रिपुदमनु । मा० २.२४३.१
रिपुसूदन : (१) शत्रु संहारक । (२) शत्रुघ्न =दशरथ के यविष्ठ पुत्र । मा० १.१७.६
रिपुसूदनु : रिपुसूदन+कए० । मा० २.७१.२
रिपहन : रिपुसूदन (सं० रिपुघ्न) । मा० २.१६३.७
रिपुहि : शत्रु को। रिपुहि जीति आनिबी जानकी।' मा० ५.३२.४
रिरिहा : वि० । रिरियाने वाला, दन्यवश 'री-री' करने वाला । 'रटत रिरिहा; आरि और न, कोरही तें काजु ।' विन० २१९.१
रिषयँ : ऋषि ने । 'पठए रिषय बोलाई ।' मा० २.२५३.८
रिषय : रिषि (सं० ऋषयः) । 'सही होइ मुनि रिषय समाजा।' मा० १.४४.७
रिषि, रिषी : सं० (सं० ऋषि) । वेद मन्त्रों का द्रष्टा, तत्त्वदर्शी । मा० १.२४.४; विन० १८०.४
रिषिन्ह : रिषि+संब । ऋषियों । 'तब प्रभु रिषिन्ह समेत नहाए।' मा० १.२१२.३
रिषिहि : ऋषि को। 'सौंपे भूप रिषिहि सुत ।' मा० १.२०८ क
रिषीस, रिषीसा : (सं० ऋषीश) श्रेष्ठ ऋषि । मा० १.७५.४
रिष्ट : (१) वि० (सं०) । सम्पन्न । (२) (सं० हृष्ट) प्रसन्न ।
रिष्ट-पुष्ट : सम्पन्न+प्रसन्न तथा स्वस्थ । मन तथा शरीर से स्वस्थ । 'रिष्ट-पुष्ट कोउ कोउ अति खोना ।' मा० १.६३.८
रिष्यमक : सं०० (सं० ऋष्यमूक)। पम्पातटवर्ती पर्वतविशेष । मा० ४.१.१
रिस : सं०स्त्री० (सं० रिष्) । रोष, क्रोध । मा० १.८७.२
रिसाइ, रिसाई : पू० । क्रुद्ध होकर । 'सुनि रिसाइ बोले मुनि कोही ।' मा० १.२७१.२, ५.४१.२
रिसात : वकृ.पु । क्रुद्ध होता-होते । बिधि सों बहुत रिसात।' ६० ४१३
_______________________________________________
927
रिसाते : वकृ.पु०ब० । क्रुद्ध होते । 'सहजडं चितवत मनहुँ रिसाते।' मा० १.२६८.६
रिसान, रिसाना : भूकृ०पू० । क्रुद्ध हुआ। 'सुनि दसकंठ रिसान ।' मा० ६.५६ ।
रिसानि, रिसानी : (1) भक०स्त्री०। ऋद हुई। केहि हेत रानि रिसानि ।' मा० २.२५ छं० 'प्रानप्रिया केहि हेतु रिसानी।' मा० २.२५.८ (२) संस्त्री० । रिस करने की क्रिया । 'घोर धार भगुनाथ रिसानी।' मा० १.४१.४
रिसाने : क्रि०वि० । क्रुद्ध होकर (होते हुए) । कवि० ७.१६३
रिसाने : रिसाने । क्रुद्ध होने से । 'टूट चाप नहिं जुरिहि रिसाने ।' मा० १.२७८.२
रिसाहिं : आ०प्रब० । क्रोध करते हैं। निज अपराध रिसाहिं न काऊ।' मा० २.२१८.४
रिसिआइ : पू० । रुष्ट होकर । 'कबहूं रिसिआइ कहैं ।' कवि० १.४
रिसोहैं : क्रि०वि०+वि०पुब० । ऋद्ध से । “रदपट फरकत नयन रिसोहैं।' मा० १.२५२.८
री : स्त्री० सम्बोधन (सं० अली>अरी>री)। हे सखी। 'को मरिहै री माई।' कृ० ५१
रीछ, रीछा : रिच्छ । मा० १.१८.१, ६.५०.७
रीछपति : रिछेस -जाम्बवान् । मा० ४.३०.३
रीछराज : रीछपति । गी० ५.३२.१
रोझि : रीमि। रुचि । 'बावरे बड़े की रीझ बहन बरद की ।' कवि० ७.१५८
रीझत : व.पु(सं० ऋध्यत्>प्रा० रिज्झंत) । अनु रक्त+अनुकूल होता-होते। 'रीझत राम सनेह निसोतें।' मा० १.२८.११
रीझहु : आ०मब० (सं. ऋध्यथ>प्रा० रिझह>अ० रिझह)। रीझते हो, अनुकूल हो जाते हो। 'तुम्ह रीझहु सनेह सुठि थोरें ।' मा० १.३४२.४ रीभिः (१) पू० । रीझ कर, आसक्त होकर। रोष न प्रीतम दोष लखि तुलसी रागहि रीझि ।' दो० २८४ (२) सं०स्त्री० । रीझने की क्रिया, रुचि, अनुरक्ति, प्रीति । 'तुलसी चातक जलद की रीझि बूमि बुध काहु ।' दो० २६२
रीझिअ : आ० भावा० । रीझा जाय, प्रसन्न एवम् अनुकूल रहा जाय । काहे को खोसिन, रीमिअप' कवि० ७.६३
रीझिबे : भकृ. पु रीझने (को) । 'राम रीशिबे जोग।' दो० ८५'
रीझिहि : आ०म०प्रए । रीझेगा-गी; आकृष्ट होगी। रीझिहि राजकुअरि छबि देखी।' मा० १.१३४.४
रीझिहु : आ०-भूक स्त्री०+मब० । तुम रीझ गई हो। कहहु काह सुनि रीशिहु बर अकुलीनहि।' पा०म० ४९
928
_______________________________________________
रीझें : रीझने से अनुरक्त होने से । 'राम नाम ही सों रोझें सकल भलाई है।" ___ कवि० ७.७४
रीझे : (१) भूकृपु । प्रसन्न तथा अनुकूल हुए। ‘रीझे ह्व हैं, राम की दोहाई, रघुराय जू ।' कवि० ७.१३६ (२) रीझें। रीझने पर । रीझे बस होत ।' विन ७१.६
रीझेउँ : आ०-भूक-पु+उए । मैं रीझ गया-वशीभूत हो गया। रीझेउँ देखि तोरि चतुराई ।' मा० ७.८५.५
रीझै : आ०ए० (सं० ऋध्यति>प्रा० रिज्झइ) । रीश जाय, मुग्ध हो उठे । 'जो बिलोकि रीझ कुरि।' मा० १.१३१
रीति : सं०स्त्री० (सं०) । (१) गति (२) मार्ग (३) सीमारेखा (४) ढङ्ग, शैली। 'समझि सो प्रीति की रीति स्याम की।' कृ० ३८ (५) चलन, आचरण । 'सुनत जरहिं खल रीति।' मा० १.४ (६) परम्परा, मर्यादा, प्रथा। 'नग सहित सब रीति निबेरौं ।' मा० १.३२५.७ (७) काव्य-शैली = रस निर्वाहोपयोगी पद-संघटना (वैदर्भी, गोड़ी, पाञ्चाली अथवा सुकुमार मार्ग, पुरुष मार्ग, मध्य मार्ग)। दे० रस रीति ।।
रीतिमारिषी : (सं० आर्षी रीति-रीतिमार्षी)। ऋषियों की रीति । 'लोक लखि बोलिए पुनीत रीतिमारिषी।' कवि० १.१५
रीतीं : रीति+ब० । रीतियाँ । 'करि लौकिक बैदिक सब रीतीं।' मा० १.३२०.१
रीती : (१) रीति । 'काक समान पाकरिपु रीती।' मा० २.३०२.२ (२) वि०स्त्री० (सं० रिक्ता>प्रा० रित्ती)। छूछी; अन्तःशून्य । 'जोगिजन मुनि मंडली मो जाइ रीती ढारि ।' कृ० ५३
रीते : वि.पु. (सं० रिक्त>प्रा. रित्त=रित्तय) । छूछे। सारहीन । 'भए देव सुख संपति रीते।' मा० १.८२.६
रुंड : सं.पुं० (सं.)। धड़, कबन्ध, शिरोहीन काय । मा० २.१९२.२
रुंडन : रंड+संब० । रुंडों। 'रुंडन के झुंड ।' कवि० ६.३१
रुख : (१) सं०० (फा० रुख)। चेहरा, मुखाकार। निरखि राम रुख सचिव सुत...।' मा० २.५४ (२) मुख-संकेत, निर्देश, इङ्गित । 'लोकप करहिं प्रीति रुख राखें ।' मा० २.२.३ (३) मुख की ओर (अपनी ओर)। निज निज रुख सब रामहि देखा।' मा० १.२४४.७ (४) ओर, सामने । रबि रुख नयन सकइ किमि जोरी।' मा० २.५६.८ (५) मनोभाव (जो मुखाकार से प्रकट होता हो)। 'लखी राम रुख रहत न जाने ।' मा० २.७८.२
रुच रुचह : आ०प्रए० (सं० रोचते>प्रा० रुच्चइ-रुच दीप्तिी अभिप्रीतो च)। (१) प्रीतिकर लगता है (रुचता है)। 'दुइ में रुचे जो सुगम सो तुलसी कीबे तोहि ।' दो० ७८ (२) सोहता है, फबता है। 'रुचे मागनेहि मागिबो ।' दो० ३२७
रुचि : संस्त्री० (सं.)। (१) किरण, आभा, द्युति । एतेहु पर रुचि रूप लोभाने ।' कृ० ३८ (२) स्वाद, आसक्ति । ‘ये सनेह सुचि अधिक अधिक रुचि ।' कृ० ३७ (३) इच्छा । ‘देबि मागु बर जो रुचि तोरें।' मा० १.१५०.३ (४) वि० (सं० रुच्य) । रुचिर, सुन्दर । 'रचि रुचि जीन तुरग तिन्ह साजे ।' मा० १.२६८.४
रुचिर : वि० (सं०) । रुचिकर, सुन्दर, प्राञ्जल, पवित्र । 'प्रगटेसि तुरत रुचिर रितु राजा।' मा० १.८६.६ (२) प्रकाशपूर्ण । 'रुचिर रजनि ।' मा० १.२२६.२
रुचिरताँ : रुचिरता से । 'रुचिरतां मुनि मन हरे।' मा० १.३२० छं०
रुचिरता : सं०स्त्री० (सं.)। स्वच्छता, सुरुचि-सम्पन्नता, सुन्दरता । माछ १.३२७.६
रुचिराई : रुचिरता । मा० ७.२६.७
रुचिराकर : (रुचिर+आकर) उत्तम खानि । 'रामकथा रुचिराकर नाना ।' मा ७.१२०.१३
रुचीं : भूक० स्त्री०ब० । प्रीतिकर लगीं-भाईं। 'चातक बतियां ना रुचीं।' दो ३१०
रुची : भक स्त्री० । प्रीतिकर लगी। रुची न साधु समीति ।' विन० २३४.३
रुचै : रुचइ। (१) रुचता है, अच्छा लगता है। 'रुचे समाज न राजसुख ।' रा०प्र० ६७.२ (२) रुचे, अच्छा लगे । 'जेहि जो रुचै करो सो।' विन० १७३.२
रुज : रुजा । मा० १.१.२
रुजा : सं०स्त्री० (सं.)। रोग, व्याधि । मा० ७.१४.३
रुजाली : सं०स्त्री० (सं०) । व्याधि-समूह । 'दहन दोष दुख दुरित रुजाली। विन० २.२
रुदन : रोदन (सं०) । मा० १.१६३.१
रुदनु : रुदन+कए । 'घर घर रुदन करहिं पुरबासी ।' मा० २.१५६.५
रुदहिं : आ०प्रब० । रोते-ती हैं । 'प्रतिमा रुदहिं ।' मा० ६.१०२ छं.
रुदित : भूकृ.वि० (सं.)। रोया हुआ, रुआंसा । 'रुदित मुख।' जा०म०/० १३
रुद्र : (१) सं०पू० (सं.)। प्रलयंकर, शंकर। मा० १.१३३ (२) एकादश रुद्र जो शिवगणविशेष हैं।
रुद्राग्रणी : (रुद्र+अग्रणी) ग्यारह रुद्रों में श्रेष्ठ-हनुमान् । विन० २७.३
रुद्राष्टक : सं०० (सं.)। रुद्रस्तुति के आठ श्लोकों का समूह । मा० ७.१०८.६
रुधिर : सं०० (सं.)। रक्त खुन । मा० २.१६३.५
930
रुधिरोपल : (रुधिर+उपल) खून और पत्थर । 'बृष्टि होइ रुधिरोपल छारा ।' मा० ६.४६.११
रुनझुन : ध्वनिविशेष = रणन । गी० १.२७.२
रुह : (समासान्त में) सं०० (सं.)। उत्पन्न, जात । जलरुह =कमल, थलरुह वृक्ष, शिरोरुह =केश, तनूरुह = रोम आदि। 'उकठेउ हरित भए जल-थल-रह।' गी० २.४६.३
रूँधहु : आ० मब० (सं० रुघ>प्रा० रुंधह>अ. रुंधह)। रूँधो, बाड़ आदि से घेरकर सुरक्षित करो। 'सँधहु करि उपाउ बर बारी।' मा० २.१७.८
रूँध्यो : भूक००कए० (सं० रुद्धम् >प्रा० रुधिअं>अ० कंधियउ)। रूँधा, बाड़ लगाकर घेरा । 'तुलसी दल रूँध्यो चहैं सठ साखि सिहोरे ।' विन० ८.४
रूख, रूखा : सं०पु+वि० (सं० रूक्ष = नीरस+वृक्ष>प्रा० रुक्ख) । (१) वृक्ष । मा० १.२८७.५; ५.१७.७ (२) नीरस, शुष्क । 'रूख बदन करि ।' मा० १.१२८
रूखी : वि०स्त्री० (सं० रूक्षा>प्रा. रुक्खी) । निःस्नेह । 'उतरु न देइ दुसह रिस रूखी।' मा० २.५१.१
रूखु : रूख+कए । एक वृक्ष । 'काटिये न नाथ बिषहू को रूखु लाइ के।' कवि० ७.६१
रूखे : रूखा+ब० (प्रा० रुवखय) । नीरस, उदासीन । 'बिषय रस रूखे ।' मा० - २.५०.३
रूच रूचइ : रुचइ । 'सूर सकल रन रू चइ रारी।' मा० २.१६१.३
रूझै : आ०प्रए० (सं० रुध्यते>प्रा० रुज्झइ) । उलझता है, आसक्त होता है। _ 'निज अवगुन, गुन राम रावरे लखि सुनि मति मन रूझ ।' विन० २३८.२
रूठनि : संस्त्री० । रूठने की क्रिया, रुष्ट होने की रीति । गी० १.३०.३
रूठहिं : आप्रब० । रुष्ट होते हैं । रूठहिं काज बिगारि।' दो० ४७६
रूठा : भूकृ०० (सं० रुष्ट>प्रा० रुटु) । कुपित । 'अजहं सो देव मोहि पर रूठा।' मा० ६.६६.७
रूठि : पूकृ० । रुष्ट होकर । 'को अब..'रूठि चलेगो माई ।' गी० २.५४.३
रूप : संपु० (सं०) । (१) दृश्यमान द्रव्यों का चाक्षुष प्रत्यक्षीय गुण (जो तेज तत्त्व का धर्म है)। 'जिमि बिनु तेज न रूप गोसाई।' मा० ७.६०.६ (२) आकार । 'धरि सीता कर रूप ।' मा० १.५२ (३) पदार्थ (शब्द बोध्य अर्थमात्र) । 'नाम रूप दुइ ईस उपाधी।' मा० १.२१.२ (४) स्वरूप, यथार्थ गुण-धर्म । 'गुप्त रूप अवतरेउ प्रभ ।' मा० १.४८ क (५) सौन्दर्य । 'देखि रूप मुनि बिरति बिसारी।' मा० १.१३१.१ (६) अभिन्न, तदात्म । परम प्रकास रूप ।' मा० ७.१२०.३ (७) (सं० रूप्य, रुक्म>प्रा० रुप्प)। सुवर्ण । 'खोयो सो अनूप रूप।' विन० ७४.२
रूपमय : वि०+सं०० (सं०) । रूप-प्रसार । परमरूपमय कच्छप सोई।' मा० १.२४७.७
रूपा : रूप । 'अकथ अनामय नाम न रूपा ।' मा० १.२२.२
रूपादि : रूप आदि पांच ज्ञानेन्द्रियों के विषय+तन्मात्र या सूक्ष्मभूत (जिनसे महाभूत बनते हैं) रूप, रस, गन्ध, स्पर्श और शब्द । विन० ५९.७
रूपिन् : वि०पू० (सं.)। मूर्त, तदकार, रूपधारी । 'रूपिणम् ।' मा० १ श्लो० ३ ___ 'रूपिणी ।' मा० २ श्लो० २
रूपी : रूपिन् । रूपधारी, तदात्म । 'रामरूपी रुद्र ।' विन० ११.८
रूपु : रूप+कए । एकमात्र वह रूप (सौन्दर्य)। 'श्री बिमोह जिसु रूपु निहारी।' मा० १.१३०.४
रूरीं : रूरी+ब० । गी० १.३१.४
रूरी : वि०स्त्री० (१) सं० रूपिणी>प्रा० रूइरी, (२) (सं० रुचिरा>प्रा०  रुइरी) । सुन्दर, रुचिपूर्ण । 'कीरति सरित छहूं रिन रूरी।' मा० १.४२.१।
रूरे : वि०पू०ब० (सं० रूपिन् >प्रा० रूइरय) । सुन्दर, मनोहर । 'मनि कोपर रे।' मा० १.३२४.५
रूरो : वि०पू०कए० (सं० रूपवान् >प्रा० रूइरो)। उत्तम, सुन्दर । “पवन को पूत रजपूत रूरो।' हनु० ३
रेंगाई : भूकृ स्त्री० (सं० रिङ्गिता-रिगि गतौ>प्रा० रेंगाविआ)। चलाई, सिकलाई, धीमे-धीमे गति कराई। 'अस कहि सन्मुख फौज रेंगाई ।' मा० ६.७६.१४
रेंगाए, रेंगाये : भकृ००ब० । धीरे चलाये । गी० १.३२.२
रेंड़ : सं०० (सं० एरण्ड) । रेंडी का वृक्ष । 'कामतरु. बिहाइ के बबूर रेंड गोडिए।' कवि० ७.२५
रे : अरे (सं०) । खेद, क्रोध, विस्मय, हर्ष, आह्वान आदि का सूचक सम्बोधनार्थक अव्यय । ‘रे नृप बालक ।' मा० १.२७१
रेख, रेखा : संस्त्री० (सं० रेखा) । (१) लकीर, लीक । 'तिलक रेख सोभा जनु चांकी ।' मा० १.२१६.८ (२) सामुद्रिक शास्त्र में विचारणीय अङ्गों की लकीर । 'परी हस्त असि रेख ।' मा० १.६७ (३) चिह्न । 'चरन रेख रज आँखिन्ह लाई ।' मा० २.१६६.२ (४) सत्यापन । 'रेख बँचाइ कहउँ बलु भाषी ।' मा० २.१६.७ (५) गणना । 'तिन्ह महँ प्रथम रेख जग मोरी।' मा० १.१२.४ (६) दृढ़ निष्ठा । 'अबिचल हृदय भगति के रेखा।' मा० १.७६.४
रेखें : रेख+ब० । रेखाएँ । 'रेखें रुचिर कंबु कल गीवाँ ।' मा० १.२४३.८
932
_______________________________________________

रेत, रेता : (१) सं०० (सं० रेत्र>प्रा० रेत्त) । चूर्ण, बालू । 'उतरि ठाढ़ भए सुरसरि रेता।' मा० २.१०२.१
(प्राय: जल के पास सैकत भाग का अर्थ देता है।) मा० ६.८७ छं० (२) (सं० रेतस् = रेत्र) वीर्य, शुक्र । जैसे, 'ऊर्ध्वरेता।" विन० २६.३
रेते : भूकृ०पुब० (सं० रेत्रित>प्रा० रेत्तिय) । चूणित, चकनाचूर, दलित, चूर चूर, परिश्रान्त । 'पीसत दांत गये रिस रेते ।' विन० २४१.२
रेनु, रेनू : सं०स्त्री० (सं० रेणु)। (१) धूलि । मा० १.१४ च 'बिधि हरि हर बंदित पद रेनू)।' मा० १.१४६.१ (२) चूर्ण (पाउडर) । “छिरकै सुगंध भरे मलय रेनु ।' गी० ७.२२.३ (३) पराग । 'बह सहित सुमन रस रेनु बद ।' गी.. २.४८.४
रेवती : संस्त्री० (सं०)। (सत्ताइस नक्षत्रों में) एक नक्षत्र । दो० ४५६
रेवा : सं०स्त्री० (सं०) । नर्मदा नदी । गी० २.८६.४
रेसू : रेस+कए० (सं० रेष: -रिष हिंसायाम् +घन >प्रा० रेसो>अ० रेसु) । रिस, क्रोध, रोष, डाह । 'कबहुं न कियह सौतिआ रेसू।' मा० २.४६.७ (संस्कृत में रिष-रुष दोनों धातु एकार्थक है अतः ‘रोष' के समान रेष' भी कृदन्त संज्ञा बनेगा)।
रैअत : सं०स्त्री० (अरबी)। प्रजा, जनता। दो० ५२१
रैन : रैनि ।
रैनि, रैन : रजनि (प्रा. रयणि) । रात । मा० २.१५६.८
रोइ : पूकृ० (सं० रुदित्वा>प्रा० रोइअ>अ० रोइ)। रोकर । 'दीन्ह बाल जिमि रोइ।' मा० २.६४
रोइए : आ० भावा० । रोया जाय, रोना पड़े। कवि० ७.८३
रोइबो : भूकृ.पु.कए० (सं० रोदितव्यम् >प्रा० रोइअव्वं>अ. रोइन्वउ). रोना । 'उचित न होइ रोइबो ।' गी० २.८३.३
रोइहै : आ०मए । तू रोएगा । 'जनम जनम जुग जुग रोइहै ।' विन० ६८.३
रोई : (१) रोइ। रोकर । 'निज संताप सुनाएसि रोई।' मा० १.१८४.८ (२) भूक०स्त्री० । 'चोर नारि जिमि प्रगटि न रोई।' मा० २.२७.५
रोकन : भकृ० अव्यय । रोकने, रोक । तासु पंथ को रोकन पारा ।' मा० ६.५६.४
रोकहिं : आ०प्रब० । रुद्ध करते-ती हैं। मंगल जानि नयन जल रोकहिं ।' मा०. ६.७.३
रोकहु : आ०मब० । रुद्ध कर दो । 'होहु संजोइल रोकहु घाटा ।' मा० २.१६०.१
रोकि : पूक० । रुद्ध करके । 'जनि रिस रोकि दुसह दुख सहहू ।' मा० १.२७४.७
रोकिए : आ०कवा०प्रए । रोका जाए, निवारण किया जाय । 'सोई सतराइ जाइ जाहि जाहि रोकिए।' कवि० ५.१७
_______________________________________________
933
रोकिहौं : आ० भ० उए । रोकंगा-गी, निवारण करूंगा-गी। 'रोकिहौं नयन बिलोकत औरहि ।' विन० १०४.३
रोकी : (१) भूक स्त्री०। रुद्ध की। सकल भुवन सोभी जन रोकी।' मा० १.२१३.८ (२) रोकि । 'सहउँ रिस रोकी ।' मा० १.२७३.५
रोकें : रोकने से, रुद्ध करने से । 'उर अनराग रहत नहिं रोके ।' मा० २.२१६.७
रोके : भक००ब० । रुद्ध किये, वजित किये । भए प्रबल रन रहहिं न रोके । मा० ६.५२.८
रोक्यो : भूक०कए। रोक दिया, रुद्ध कर दिया। 'रोक्यो परलोल लोक भारी भ्रम भानि के ।' कवि० ६.२६
रोग : सं०० (सं.)। व्याधि । मा० १.३२.३
रोगदैया : संस्त्री० । विनोद, बालक्रीड़ा (?)। 'खेलत खात परसपर डहकत छीनत कहत करत रोगदैया।' कृ० १६
रोगनि : रोग+संब० । रोगों (ने) ।'धेरि लियो रोगनि।' हनु० ३५
रोगा : रोग । मा० ७.१२१.२८
रोगीं : रोगी ने । 'अमतु लहेउ जन संतत रोगी।' मा० १.३५०.६
रोगी : वि०० (सं० रोगिन्) । व्याधिग्रस्त । मा० १.१३३.१
रोगु, रोगू : रोग+कए । 'भरत दरस मेटा भव रोगू ।' मा० २.२१७.२
रोचन : सं०पू० (सं.)। गोरोचन । मा० ७.३.५
रोचना : रोचन (सं.) । जा०म० २०७
रोचनु : रोचन+कए । 'दूब दधि रोचनु ।' कवि० १.१३
रोटिन : रोटी+संब० । रोटियों । 'कृसगात ललात जो रोटिन को।' कवि० ७.४६
रोटिहा : सं००+वि० । रोटी पर रहने वाला चाकर। 'रोटिहा रोवरो, बिनु ___ मोलही बिकहौं ।' गी० ५.३०.४ ।
रोटी : सं०स्त्री० (सं० रोटिका) । आटे का बना खाद्यविशेष । कवि० ७.६३
रोदति : वकृ० स्त्री० । रोती हुई। 'रोदति बदति · संकर पहिं गई।' मा० १.८७ छं०
रोदन : सं०० (सं.)। रोने की क्रिया । मा० १.१६२.४
रोपहिं : आ.प्रब० (सं० रोपयन्ति>प्रा० रोप्पंति>अ० रोप्पहि)। स्थापित करते हैं। 'थूनि थिर रोपहिं ।' जा०म० ८५
रोपहु : आ०मब० । रोपो, लगाओ, थापो। मा० २.६.६
रोपा : भूकृ.पु. । (१) स्थिर जमाया। 'सभा माझ पन करि पद रोपा ।' मा० ६.३४.८ (२) स्थापित किया=समथित किया, सतर्क पतिपादित किया। "पुनि पुनि सगुन पच्छ मैं रोपा ।' मा० ७.११२.१२
934
_______________________________________________

रोपि, रोपी : पू० । रोप कर, स्थापित कर । 'नाथ कहउँ पद रोपि ।' मा० ७.७१ ___ 'भुजा उठाइ कहउँ पन रोपी।' मा० २.२६९.७
रोपे : भूकृ००ब० । लगाये, स्थापित किये। 'रोपे बकुल कदंब तमाला ।' मा० १.३४४.७
रोप्यो : भूकृ००कए० । रोपा, स्थिर जमाया। 'अति कोप सों रोप्यो है पाउ सभा।' कवि० ६.१५
रोम : सं०० (सं० रोमन्) । (१) रोयां, अंगों में उगने वाले छोटे बाल । मा०. १.१६२.३ (२) ऊन । 'रोम पाट पट अगनित जाती।' मा० २.६.३
रोमराजि, रोमराजी : संस्त्री० (सं०)। रोम-पडित । गी० ७.१७.६
रोमांच : सं०० (सं.) । पुलक = रोंगटे खड़े होने की दशा । विन० २६.५
रोमावलि, रोमावली : रोमराजी (सं.)। मा० १.१०४.२ ।।
रोयो : भूकृ००कए० । रोया, रोदन किया। मैं जग जनमि जनमि दुख रोयो।" विन० २४५.१
रोर : सं०० (सं० रोरव)। कोलाहल, चिल्लाहट । 'कुलिस कठोर तनु जोर पर रोर रन ।' हनु० १०
रोव रोवइ, ई : आ० प्रए० (सं० रोदित>प्रा० रोवइ)। रोता-ती है । 'रोवइ बाल अधीर ।' मा० ७.७४ 'सीस धुनि धुनि रोवई ।' विन० १३६.३
रोवत : (१) वकृ०० । रोता-रोते। 'पालने झुलावतहू रोवत राम मेरो।' गीर १.१२.१ (२) रोते हुए । 'रोवत करहिं प्रताप बखाना ।' मा० ६.१०४.४
रोवति : वकृस्त्री० । रोती। रा०प्र० ३.२.२
रोवनि : सं०स्त्री० । रोदन, रोने की क्रिया । गी० १.२१.१
रोवनिहारा : वि.पु.। रोने वाला। 'रहा न कोउ कुल रोवनिहारा ।' मा०
रोवहिं : आ० प्रब० (अ०) । रोते हैं, रोती हैं । 'रोवहिं रानी ।' मा० २.१३३.७
रोवा : रोवइ । रोया जाय (रोती हो)। 'जीवन नित्य केहि लगि तूम्ह रोवा ।" मा० ४.११.५
रोवाइ : प्रकृ० (सं० रोदयित्वा>प्रा० रोवाविअ>अ० रोवावि)। रुलाकर । 'कबहुंक बाल रोवाइ पानि गहि मिस करि उठि उठि धावहिं ।' कृ० ४
रोष : सं०० (सं०) । क्रोध । मा० १.४.५
रोषा : रोष । मा० १.१२७.१
रोषि : पूकृ० । क्रुद्ध होकर । 'रोषि बानु काढ्यो।' कवि० ६.२२
रोषिहैं : आ० भ०प्रब० । क्रुद्ध होंगे। को कुंभकर्नु कीट जब राम रन रोषि हैं । कवि० ६.२
रोषु, : रोष-+कए० । मा० १.४६.८, २८१.५
_______________________________________________
935
रोषें : ऋद्ध होने से । 'काहे को कुसल रोष राम बामदेवह की।' कवि० ५.६
रोषे : भूकृ०० ब० । क्रुद्ध हुए । 'राजा राढ़ रोषे हैं।' गी० १.६५.१
रोष्यो : भूक००कए । क्रुद्ध हुआ। 'रोष्यो रन रावनु ।' कवि० ६.३०
रोस, रोसा : रोष (प्रा.)। कवि० ७.१७२; मा० ३.२६.३
रोसु, रोसू : रोषु । मा० १.२८१ 'मुनि बिनु काज करिअ कत रोसू !' मा० १.२७२.३
रोहिनि : संस्त्री . (सं० रोहिणी)। चन्द्र पत्नी नक्षत्रविशेष । 'जन बुध बिधु ___ बिय रोहिनि सोही ।' मा० २.१२३.४
रौंदि : पूर्व । पैरों से कुचल (कर) । 'भारी भीर ठेलि पेलि रौंदि खोंदि डारहीं।' कवि० ५.१५
रौताई : (दे० राउत) सं०स्त्री० (सं० राजपुत्रता>प्रा० राउत्ताया)। रजपूती, वीरता । 'होइ कि खेम कुसल रीताई।' मा०२.३५.६
रौरव : सं०० (सं.)। (१) अत्यन्त भयानक । (२) नरकविशेष । मा० ७.१०७.५
रोरिहि : (दे० रावरी) । आपकी ही। 'करहिं छोहु सब रोरिहि नाई।' मा ० २.२.४
रोरें : (दे० रउरे)। आपके.. में । 'हित सबही कर रोरें हाथा।' मा० २.२६०.६
रोरेहि : (दे० रउरे)। आपको, आपके विषय में । 'जो सोचइ ससिकल हि सो सोचइ रोरेहि।' पा०म० ५५
# ल
लँगूर : लंगूर । 'दहँ दिसि लंगूर बिराज ।' मा० ६.१०१.८
लँगूल : लंगूर । कवि० ५.७
लँध्यो : लोध्यों । गी० ६.११.५
लंक: (१) लंका । मा० २.८१.४ (२) सं०स्त्री० (सं० लङका) । कटि भाग ।  'लंक मगपति ठवनि ।' गी० ७.५.२
लंकपति : लंकापति । मा० ४.५०.५
लंकाँ : लंका नगरी में । 'कहत राम जसु लंकां आए। मा० ५.५३.२
936
_______________________________________________
लंका : सं०स्त्री० (सं.)। (१) रावण की नगरी जिसमें पहले यक्षों का और उससे भी पूर्व प्राचीन राक्षसों का निवास था। मा० १.१७८.८ (२) एक राक्षसी = लंकिनी । 'पुनि संभारि उठी सो लंका ।' मा० ५.४.५
लंकापति : लडका का राजा । (१) रावण । मा० ७.७.७ (२) विभीषण । मा० ७.८.१
लंकिनी : सं०स्त्री० । लङका की एक राक्षसी । मा० ५.४.२
लंकेस : लंकापति (सं० लङ के श) । (१) रावण । मा० ३.२२.२ (२) विभीषण। मा० ५.४६.१
लंगर : वि० सं०० (सं० लङ्ग =प्रेमा या जार)। लम्पट, व्यभिचारी । ___'लोकरीति लायक न लंगर लबारु है।' कवि० ७.६७
लंगरि : लंगर+स्त्री० । कुलटा, दुष्टास्त्री । 'गनति कि ए लंगरि झगराऊ ।' कृ० १२
लंगूर : सं०० (सं० लाङ्गल) । पूंछ । मा० ६.५८.५
लंघन : सं०+वि००। (१) लांघना (२) लांघने वाला। 'जलधि लंघन सिंह ___ सिंहिका मद मथन ।' विन० २५.४
लंधि : पूकृ० । (अ०)। लाँध कर । कवि० ५.२८
लंघेउ : भूकृ००कए । लांघ गया, कूद कर पार किया। 'तुलसी प्रभु लंघेउ जलधि ।' रा०प्र० ५.१.७
लंपट : वि.पु. (सं.) । विषयभोग की तृष्णा वाला; भोगों में स्वेच्छाचारी। ___ मा० १.११५.२
लंबित : भूक०वि० (सं.)। लटके हुए। 'सोभित स्रवन कनक कुंडल कल लंबित बिबि भुजमूले ।' गी० ७.१२.५
लइ : लेइ । लेकर । 'प्रमुदित मन लइ चलेउ ले वाई ।' मा० २.१६६.८
लईं : भूक०स्त्री०ब० । लीं। 'कुरि लई हकारि के ।' मा० १.३२५ छं० २
लई : भूकृ०स्त्री० । ली । 'ओट राम नाम की ललाट लिखि लई है।' हन० ३८
लएँ : लिएँ । लिए हुए । 'बिनु सुधि लएँ करब का भ्राता ।' मा० ४.२६.२
लए : भक०पू० । लिये, प्राप्त किये, ग्रहण किये। 'सेवक जानिए बिनु गथ लए।' मा० १.३२६ छं० २
लकड़ी : संस्त्री० (सं० लकुटी>प्रा. लक्कुडी) । काष्ठ । दो० ५२६
लकुट : सं०पु० (सं.) । डंडा, लाठी । 'भूतल परे लकुट की नाईं।' मा० २.२४०.२
लकुटी : सं०स्त्री० (सं.)। छड़ी, छोटा डंडा । कृ० १७
लक्ख : संख्या (सं० लक्ष>प्रा० लक्ख) । लाख । 'लक्ख में पक्खर, तिक्खन तेज।' कवि० ६.३६
_______________________________________________
937
लक्खन : सं०पू० (सं० लक्ष्मण>प्रा. लक्खण) । रामानुज । 'ते रन तिक्खन लक्खन लाखन दानि ज्यों दारिद दाबि दले हैं।' कवि० ६.३३ ।।
लक्खनु : लक्खन+कए । अकेले लक्ष्मण । 'जल को गये लक्खन हैं लरिका ।' कवि० २.१२
लक्ष्मण : सं.पु. (सं.) । सौमित्रि, रामानुज । मा० ३ श्लोक २ 'लख
लखइ : आ०प्रए० (सं० लक्षयति>प्रा. लक्खइ)। लक्षित करता है, पहिचानता है (लक्षणों से जानता है)। 'बिप्र बेष गति लखइ न कोऊ ।' मा० १.१३४.२
लखत : वकृ०० । देखता (पहचानता) । कवि० ६.४१
लखन : (१) लक्खन । मा० १.२५३.१ (२) (लक्षण)-राजलखन सब अंग तुम्हारें। मा० २.११२.४
लखनहि : लक्ष्मण के (में) । 'बोलत लखनहिं जनकु डेराहीं।' मा० १.२७८.४
लखनहि : लक्ष्मण को । 'लखनहि भेटि प्रनाम करि ।' मा० २.३१८
लखनु : लखन+कए। केवल लक्ष्मण । 'लखन कि रहिहहिं धाम ।' मा० २.४६
लखब : भूक०० (सं० लक्षयितव्य>प्रा. लक्खिअव्व) । लक्षित करना, जान समझ लेना (चाहिए, होगा)। 'लखब सनेहु सुभाय सुहाएँ ।' मा० २.१६३.१
लखहि : आ०प्रब० (सं० लक्षयन्ति>प्रा० लक्खंति>अ० लक्खहिं)। (१) लक्षित करते हैं, पहचानते हैं । 'लखहिं सुलच्छन लोग।' मा० १.७ (२) ताकते हैं। 'जे पर दोष लखहि सहसाखी ।' मा० १.४.४
लखहि : आ०मए० (सं० लक्षयसि>प्रा. लक्खसि>अ० लक्ख हि) । तू देखता है, लक्ष्य करता है । 'तुलसी अलखहि का लखहि ।' दो० १६
लखहु : आ० मब० (सं० लक्षयथ>प्रा. लक्खह>अ० लक्खह) । लक्षित करते-ती हो; जान पाते-ती हो । 'लखहु न भूप कपट चतुराई ।' मा० २.१४.६
लखा : भूक०० (सं० लक्षित>प्रा० लक्खिअ)। लक्षित किया, देखा-समझा। 'काहुं न लखा सो चरित बिसेखा।' मा० १.१३४.७
लखाइ : कृ० । लक्षित करा, दिखा । किधौं कछु काहूं लखाइ दियो है।' कवि० ७.१५७
लखाई : भक०स्त्री० 1 दिखाई, लक्षित कराई । 'लखी औ लखाई।' गी० ५.२५.३
लखाउ, लखाऊ : सं०पु०कए० । लक्षण, पहचान । 'और एक तोहि कहउँ लखाऊ।' मा० १.१६६.३
लखाए : भू०पू० ब० । दिखाये, लक्षित कराये। 'लता ओट तब सखिन्ह लखाए।' मा० १.२३२.३
लखि : (१) पू० (सं० लक्षयित्वा>प्रा० ललिखअ>अ० लक्खि)। लक्षित कर; देखकर । 'प्रभु पुलके लखि प्रीति बिसेषी ।' मा० १.२६१.४ सहसा लखि न सकहिं नर नारी।' मा० १.३११.६ (२) आ-आज्ञा-मए० (सं० लक्षय> प्रा० लक्ख>अ० लक्खि) । तू देख । 'हम लखि, लखहि हमार, लखि हम हमार के बीच ।' दो० १६
लखिअत : वक०कवा । दिखाई देता देते । दो० ४६७
लखी : भूक स्त्री०ब० । लक्षित की, देखी-जानीं । 'लखीं सीय सब प्रेम पिआसी। मा० २.११८.३
लखीं : भूक०स्त्री० । (१) लक्षित की, चिन्हों से जानी । 'परबस सखिन्ह लखी जब सीता ।' मा० १.२३४.५ (२) समझी । 'मैं न लखी सोति ।' कवि० २.३
लखु : आo-आज्ञा-मए = लखि । तू देख । 'सैल सग भव भंग हेतु लखु । विन० २४.२
लखे : भूक पुब० (सं० लक्षित>प्रा० लक्खिय) । पहचाने, समझे, लक्ष्य किये।  'सुर लखे राम सुजान ।' मा० १.३२१ छं०
लखेउ, लख्यौ : भूक ००कए० (सं० लक्षितम् >प्रा० लविखअं>अ० लक्खियउ)। लक्षित किया, जाना । 'लखन लखेउ रघुबंस मनि ।' मा० १.२५६
लखै : लवइ । 'करषत लख न कोइ।' दो० ५०८
लख्यो : लखेउ । 'जानकी नाह को नेह लख्यो।' कवि० २.१२
लग, लगइ : आ०प्रए० (सं० लगति>प्रा० लग्गइ) । संपक्त होता है, संश्लिष्ट हो जाता है, आसक्त होता है। तुलसी जासों हित लगे। दो० ३१२
लगत : (१) वकृ० । लगता-ती-ते । सिर धुनि गिरा लगत पछिताना ।' मा० १.११.७ (२) लगते ही । 'मुनि तिय तरी लगत पग धूरी।' मा० १.३५७.३
लगति : वकृ० स्त्री० । लगती । सुनत मीठी लगति ।' गी० २.८२.१
लगन : (१) सं० स्त्री० (सं० लगन-पु०)। प्रेम, आसक्ति । 'जोप लगन राम सों नाहीं।' विन० १७५.१ पाही खेती बट लगन ।' दो० ४७८ (२) (सं० लग्न) नक्षत्र राशि जो क्षितिज से लगी उदय ले रही हो, उस राशि की क्षितिज लग्न कला । 'जोग लगन ग्रह बार तिथि सकल भए अनुकूल ।' मा० १.१६० (३) विवाहादि मुहूर्त (जो उक्त लग्न पर होते हैं) । 'राम तिलक हित लगन धराई ।' मा० २.१८.६ (४) विवाह महूर्त के लग्न की पत्रिका । 'लगन बाचि अज सबहि सुनाई ।' मा० १.६१.७
लगनि : सं०स्त्री० (सं० लगन-पू०) । लग्ने (संसक्त होने) की क्रिया । 'नहिं बिसरति वह लगनि कान की।' गी० ५.११.३
लगहिं : आ०प्रब० (सं० लगन्ति>प्रा. लग्गंति>अ० लग्गहिं) । लगते हैं (प्रतीत होते हैं)। 'तेहि लघु लगहिं भवन दस चारी।' मा० १.२८६.७
लगाइ : पूकृ० । लगाकर (आरोपित कर) । 'बहु भांति बिधिहि लगाइ दूषन नयन बारि बिमोषहीं।' मा० १.६७ छं.
_______________________________________________
939
लगाइअ : आ०कवा०प्रए० । लगाया (आरोपित किया) जाय । 'तो कत दोसु लगाइअ काहू ।' मा० १.६७.७
लगाईं : भूक०स्त्री०ब० । रोपी । 'सुमन बाटिका सबहिं लगाई।' मा० ७.२८.१
लगाई : (१) लगाइ। 'कोसल्यां लिए हृदयं लगाई ।' मा० २.१६७.१ (२) भूक०स्त्री० । रोपी। 'तुलसिका' 'मुनिन्ह लगाई।' मा० ७.२६.६
लगाऊ : वि०पू० । लगाने वाला। 'जस जस चलिअ दूरि तस तस निज बास, न भेंट लगाऊ रे ।' बिन० १८६.४
लगाए : भूक०० ब० । (१) संसक्त किये । 'साधु जानि हेसि हृदय लगाए।' कृ.० ६ (२) रोपे । 'तुलसी तरुबर बिबिध सुहाए। कहुं कहुं सिय कहुं लखन लगाए ।' मा० २.२३७.७
लगामु : (फा० लगाम) क ए० । घोड़े की बाग । मा० १.३१६ छं०
लगाय : लगाइ । 'ईंधन अनल लगाय कलप सत औदत नास न पावै।' विन.. ११५.२
लगावत : वकृ०० । लगाता-ते, लिपटाता-ते । 'हृदयं लगावत बारहिं बारा ।' मा० २.४४.५
लगावति : वकृ०स्त्री० । लगाती । (१) संसक्त करती। 'मनहुं जरे पर लोन लगावति ।' मा० २.१६१.१ (२) आरोपित करती। बिनु कारन हठि दोष लगावति ।' कृ० ५
लगावहिं : आ०प्रब० (सं० लगयन्ति>प्रा. लग्गावंति>म. लग्गावहिं) । लगाते ती हैं । (१) आरोपित करते हैं । 'ते नृप रानि हि दोसु लगावहिं ।' मा० २.१२२.३ (२) संसक्त करते हैं। 'नगर गाउँपुर आगि लगावहिं ।' मा० १.१८३.६
लगावा : भूक.पुं० । लगाया। (१) लिपटाया । 'कंठ लगावा।' मा० ४.२०.६ (२) एकाग्र किया । इहाँ आइ बकध्यान लगावा ।' मा० ६.८५.७
लगावै : आ.प्रए० (सं० लगयति>प्रा० लग्गाव इ)। लगाता है, आरोपित करता है । 'बेन करिल श्रीखंड बसंतहि दूषन मषा लगावै ।' विन० ११४४
लगि : पूकृ० । (१) लगकर, संलग्न होकर । (२) लिए, तदर्थ । 'पर अकाजु लगि तन परिहरहीं।' मा०१.४.७ (३) तक, पर्यन्त । 'तब लगि बैठ अहउँ बट छाहीं ।' मा० १.५२.२ (४) संस्त्री० । लग्गी, लम्बा बाँस आदि । 'नाम लगि लाइ, लासा ललित बचन कहि, ब्याध ज्यों बिषय बिहगनि बझावौं ।' विन ० २०८.२
लगिहहु : आ०भ०मब० । लगोगे-गी, एकनिष्ठ होगे-होगी। 'जौं नहिं लगिहह कहें हमारे ।' मा० २.५०.५
940
_______________________________________________
लगीं : भूक०स्त्री०ब० । आरम्भ कर चलीं। 'लगीं देन गारों मृदु बानी।' मा० १.६६.८
लगी : भूकृ०स्त्री० । प्रतीत हुई । 'ससुरारि पिआरि लगी।' मा० ७.१०१.५
लगें : क्रि०वि० । तक, पर्यन्त । 'आजु लगें अरु जब तें भयऊँ।' मा० १.१६७.४
लगे : (१) लगें। 'चीन्हो री सुभाय तेरो आजु लगे माई मैं न।' कृ० १५ (२) भूकृ.पुं० । एकान हुए । अस कहि लगे जपन हरि नामा।' मा० १.५२.८ (३) जुड़ गये, संसक्त हुए । 'लगे संग लोचन ।' मा० १.२१६.२ (४) एक मात्र सहारे तक । 'गिरिज लगे हमार जिवन सुख संपति ।' पा०म० १८
लगेइ : लगे ही, संलग्न ही। 'लगेइ रहत मेरे नैनन आगे।' गी० २.५३.२
लगै : लगइ ! आरोपित हो सके। 'बहोरि न खोरि लग सो कहींगो।' कवि० ७.१४७
लग्यो : भूक०कए । लगा। सिय बियोग सागर नागर मन बूड़न लग्यो।' गी० ५.२१.२
लघु : वि० (सं.)। (१) छोटा । 'लघु देवर ।' मा० २.११७.५ (२) अल्प । ‘बिकल मीन गन जिमि लघु पानी ।' मा० १.३३४.२ (३) हलका । 'उपमा सकल मोहि लघु लागौं।' मा० १.२४७.२ (४) तुच्छ । 'बड़ो लाभ लघु हानी ।' कृ० ४८
लघुता : सं०स्त्री० (सं.)। हल्कापन (क्षुद्रता), छोटाई । 'जद्यपि लघुता राम कहुं तोहि बधे बड़ दोष ।' मा० ६.२३
लघुन्ह : लघु+संब० । छोटों। 'बड़े सनेह लघुन्ह पर करहीं।' मा० १.१६७.७
लघुबयस : वि० (सं० लघुवयस्) । अल्पवयस्क, तरुण (किशोर) । मा० २.११०.७
लधुमति : (१) अल्प बुद्धि । 'लघुमति मोरि ।' मा० १.८.५ (असमस्त)। (२) अल्प बुद्धि वाला, तुच्छ-बुद्धि । गी० ७.१०.५
लच्छ : (१) संख्या (सं० लक्ष) लक्ख । 'चारि लच्छ बर धेनु मगाईं।' मा० १.३३१.२ (२) वि.पु. (सं० लक्ष्य) ! निशाना । 'मनहुं महिप मृदु लच्छ समाना ।' मा० २.४१.२
लच्छन : सं०० (सं० लक्षण) । (१) चिह्न, सूचक । 'राम भगत कर लच्छन एहू ।' मा० १.१०४.६ (२) शुभ सूचक चिह्न । 'सब लच्छन सम्पन्न कुमारी।' मा० १.६७.३
लच्छा : लच्छ । लक्ष, लाख । मा० ६.६८.३
लच्छि : संस्त्री० (सं० लक्ष्मी>प्रा० लच्छी) । (१) विष्णु-पत्नी। 'एहि बिधि उपज लच्छि जब ।' मा० १.२४७ (२) धन, ऐश्वर्य । 'लच्छि अलच्छि रंक अवनीसा ।' मा० १.६.७ (३) महामाया=सीता । मा० १.२८९
लच्छिनिवासा : (सं० लक्ष्मीनिवास) विष्णु । मा० १.१३५.४
_______________________________________________
941
लछिमन : लखन । मा० १.१७.५
लछिमनु : लछिमन+कए । मा० १.५५.५ '
लजा, लजाइ, ई : आ०प्रए० (सं० लज्जते>प्रा० लज्जइ) । लज्जित होता-ती है । 'सो सेवकु ल खि लाज लजाई ।' मा० २.२६६.५
लजाइ : पूक । लज्जित होकर । 'उठ न, चलहिं लजाइ।' मा० १.२५०
लजाएँ : क्रि०वि० । लज्जित किए हुए । 'ठवनि जुबा मृगराजु लजाए। मा० १.२५४.८
लजाए : भूक०'ब० । लज्जित किये । निज संपति सुर रूख लजाए।' मा० १.२२७.५
लजात : वकृ०० । लज्जित होता-होते । दो० ४१३
लजातो : क्रियाति०पू०ए० । (यदि) लज्जित होता। 'जो पै चेरई राम की करतो, न लजातो।' विन० १५१.१
लजान : भूक.पु । लज्जित हुआ। 'बल उ लजान ।' जा०म ६०
लजानीं : लजानी+ब० । लज्जित हुई । 'कलकंठि लजानी ।' मा० १.२६७.३
लजानी : भूक०स्त्री० । लज्जित हुई। मा० १.२६६.६
लजाने : भक००ब० । लज्जित हुए। मा० ६.४२.६
लजायो : भक००कए० । लज्जित कर दिया । 'मारुत नंदन. 'खगराज को बेगु लजायो।' कवि० ६.५४ ।
लजारु, लजारू : सं००+स्त्री० (सं० लज्जाल) । एक पौधा जिसकी पत्तियां छूते ही सिमट जाती हैं=अलंबुषा । 'जनक बचन सुने बिरवा लजारू के से बीर रहे सकल सकुचि सिर नाइ के ।' गी० १.८४.६
लजावन : वि०पू० । लज्जित करने वाला। 'सोभा कोटि मनोज लजावन ।' मा०. १.३२७.१
लजावनिहारे : विपुब । लजावन । मा० २.११७.१
लजावहि : आ०मए । तू लज्जित कर । नर मुख सुन्दर मंदिर पावन बसि जनि ताहि लजावहि ।' विन० २३७.२
लजावहु : आ०मब० । लज्जित करो। बिधि बस बलउ लजान, सुमति न लजावहु ।' जा०म०६०
लजावै : आ०प्रब० । लज्जित करते हैं। 'कुलहि लजावै बाल ।' मा० १.६५.२
लजाहिं, लजाही : आ.प्रब० । लज्जित होते हैं । 'जो बिलोकि बहु काम लजाहीं।' मा०. १.२३३.६
लजाहि : आ०मए० । तू लज्जित होता है । 'तू लजाहि न मागत ककर कोरहि । कवि० ७.२६
942
_______________________________________________
लजै : आ.प्रए० (सं० लज्जते>प्रा० लज्जइ)। 'तदपि अधम बिचरत तेहिं मारग ___ कबहुं न मूढ़ लजै ।' विन० ८६.३
लटकन : सं०पू० । आभूषणविशेष । 'लटकन ललित ललाट ।' गी० १.२२.७
लटकै : आ० प्रब० । लम्बमान हैं। लटक रही हैं। 'घु घरारि लटं लटकै मुख ऊपर ।' कवि० १.५
लटत : वकृ.पु० (सं० लटत् --लट बाल्ये)। ललचा कर टूट पड़ता (बच्चों के समान लटपटाता) । 'गुजा लखि लटत ।' विन० १२६.४ (२) शिथिल होता होते । 'न लटत तन जर्जर भए ।' मा० ६.४६ छं०
लटपटेनि : भूक.पु०संब० । लटपटों, स्खलितों, थके हुओं (की)। 'लटे लटपटेनि कौन पीर गहेगो।' विन० २५९.३
लटि : पू० । (१) बाल हट करके, बचकाना प्रयास कर । 'करहु राज रघुराज चरन तजि, लै लटि लोगु रहा है।' गी० २.६४.१ (२) थककर, शिथिल होकर । 'रहौं दरबार परो लटि लूलो।' हनु० ३६
लटी : भूक०स्त्री० । जर्जर हो गयी, थक गई । ‘रटत रटत रसना लटी।' दो० २८०
लटू : वि० । (लट =बालक के समान) मुग्ध । 'जा सुख की लालसा लटू सिब ।' गी० ८.५
लटूरीं : सं०स्त्री०ब० । घुघराली-उलझी अलके । 'लटकन लसत ललाट लटूरी ।' गी० १.३१.४
लटे : भूकृ०० ब० । जर्जर, शिथिल । 'लटे लटपटेनि कौन पीर हरगो।' विन. २५६.३
लटै : सं०स्त्री० (लट) ब० । अलकें, केशपुञ्ज । ' धुरारि लट लटकै मुख ऊपर।' कवि० १.५
लट् यो : भूकृ.पु.कए । जर्जर हुआ, शिथिल पड़ गया। 'रटत रटत लट्यो।' विन० २६०.३
लड़ाइ : पूकृ० । लाड़ (दुलार) करके ; स्नेह-सम्मान करके । 'प्रमुदित महामुनिबृद बंदे पूजि प्रेम लड़ाइ कै ।' मा० १.३२६ छं० १
लता : सं०स्त्री० (सं०) । वल्ली, बौंड़ । मा० १.३७.१३
लताभवन : लताओं का घना झरमुट; लताओं का कृत्रिम मण्डप । मा० १.२३२
लपट : सं०स्त्री० । आसपास को लपेटने वाली वायुवेग से फैलती हुई अग्निज्वाला । 'झपट लपट बहु कोटि कराला ।' मा० ५.२६.२ '
लपटा, लपटाइ, ई : आ.प्रए० । लपेटता है, आबद्ध एवम् आवृत करता है। 'जनम जनम अभ्यास निरत चित अधिक अधिक लपटाई ।' विन० २.१
943
लपटाइ, लपटाई : (१) पू० । लिपटाकर, लिपटकर । 'सबरी परी चरन लपटाई।' मा० ३.३४.८ (२) चभोर कर । 'भाजि चले किलकत, मुख दधि ओदन लपटाइ ।' मा० १.२०३
लपटानि, लपटानी : भूकृ०स्त्री० । लिपट गयी। 'बहु बिधि बिलपि चरन लपटानी।' मा० २.५७.६
लपटाने : भूकृ००व० । लिपटे हुए, आवृत, लिथरे हुए। 'मोह द्रोह ममता लपटाने ।' मा० ७.१००.१
लपटावहिं : आ०प्रब० । लिपटाते हैं, चभोरते हैं। 'भांग धतूर अहार छार  लपटावहिं ।' पा०म० ५१
लपटै : लपट-+ब० ज्वालाएँ । 'लपट झपट सो तमीचर तौकी ।' कवि० ७.१४३
लपत : वकृ.पुं० (सं० लपत्) । बकवास करते । 'साधन बिनु सिद्धि सकल बिकल लोग लपत ।' विन० १३०.४
लपेटत : वकृ०० । आबद्ध+आवृत कर लेता। 'लंगूर लपेटत पटकि भट ।' कवि० ६.४७
लपेटन : लपेट+संब० । लपेटों (से), आवरणों (से), पाशबन्धनों (से) । 'काँट कुराय लपेटन लोटन ठावहिं ठाउँ बझाऊ रे ।' विन० १८६.४
लपेटनि : लपेटन । लपेटों + लप्पड़ों (से)। 'बानर भालु चपेट लपेटनि मारत ।' गी० ६.४.३
लपेटि : पूकृ० । लपेटकर=सब ओर से आबद्ध-आवृत कर। 'लेइ लपेटि लवा जिमि बाजू।' मा० २.२३०.६
लपेटे : भूकृ.पुब० । ओतप्रोत, चभोरे हुए, आवृत । 'प्रेम लपेटे अटपटे (बैन)।' मा० २.१००
लबार, लबारा : वि०पू० (सं० लप-कार>प्रा० लवार) । वाचाल, बकवादी, मिथ्या बादी। मा० ६.३४.६-७
लबारु : लबार+कए । एक ही झूठा। 'लोकरीति लायक न लंगर लबारु है।' कवि० ७.६७
लबेद : (१) सं०० (अरबी)। टटू की लादी। (२) वैदिक विधान के अतिरिक्त लोकिक व्यवहार-विधि । हनु० २८
लय : सं.पुं० (सं.)। (१) तल्लीनता, ध्यानावस्था, समाधि । 'साधक नाम जपहिं लय लाएँ।' मा० १.२२.४ (२) लगाव, आसक्ति, राग । 'रबि कर जल लय लायो। विन० १६६.१ (३) प्रलय, युगान्त । 'जग संभव पालन लय कारिणि ।' मा० १.६८.२
944
_______________________________________________
लयउ, लयऊ : (१) भूक००कए। लिया । ग्रहण किया। 'दमके उ दामिनि जिमि जब लयऊ ।' मा० १.२६१.६ (२) आरम्भ किया। 'आपन नाम कहन तब ___ लयऊ।' मा० १.१६३.७
लयलीन, लयलीना : (दे० लीन)। (१) ध्यानमग्न, समाधिलीन । मा० १.१३१ (२) अनुरक्त, आसक्त । 'बिषय ल यलीना।' मा० २.१७२.३
लये : लए। लिये । गी० १.१११
लयो : लयउ । (१) लिया, ग्रहण किया। 'हरि अवतार लयो।' गी० १.४७.२ (२) पाया। 'लयो बयो बिन जोतो।' विन० १६१.४
लरखरत : वकृ.पु.। लड़खड़ाता-ते । 'दिग्गयंद लरखरत ।' कवि० १.११
लरखरनि : संस्त्री० । लड़खड़ाने की क्रिया, गिरना-पड़ना । गी० १.२७.६
लरखरे : भूकृ००ब० । लड़खड़ाए, स्खलित हुए । 'भूधर लरखरे ।' जा०म०/०
लरत : वकृ०० (सं० लडत्>प्रा० लडत) । लड़ाई करता-ते । 'लरत निसाचर भालु कपि ।' मा० ६.८०
लरन : सं०० (सं० लडन)। लड़ना-झगड़ना। 'या की टेव लरन की; सकुच बेचि सी खाई ।' कृ. ८
लरनि : संस्त्री० । लड़ने की क्रिया, युद्ध-कौशल । 'देखो देखो लखन लरनि हनुमान ___ की।' कवि० ६.४०
लरहिं, लरहीं : (१) आप्रब० । लड़ते हैं। 'जहें तह परहिं उठि लरहिं ।' मा० ३.२० छं० १ (२) आ० उब० । हम लड़ते हैं । 'लरहिं सुखेन कालु किन होऊ ।' मा० १.२८४.२ 'एक बार काल हुँ सन लरहीं।' मा० ३.१६.१०
लराईं : लराई+ब० । लड़ाइयाँ । 'जहँ तह परी अनेक लराई।' मा० १.१५४.६
लराई : संस्त्री० । लड़ाई, युद्ध । बिबिध भांति नित होइ लराई।' मा० १.१७५.५
लरि : पूकृ० । लड़कर । रिपु दल लरि मरयो।' मा० ३.२० छं० ४
लरिकई : लरिकाई। बचपन । गी० १.८६.४
लरिकनीं : लरिकिनीं। लड़कियाँ । मा० १.३५५.२ (पाठान्तर)
लरिकन्ह : लरिका+संब० । लड़कों (ने) । ‘बात असि लरिकन्ह कही।' मा० १.६५ छं.
लरिकपन : (दे० पन)। बचपन । 'खेलत खात लरिकपन गो चलि ।' विन० २३४.२
लरिकवनि : लरिकवा (लरिका) संब० । लड़कों। 'कहँ सिव चाप, लरिकवनि बूझत ।' गी० १.६२.४
लरिका : सं०० (सं० लटक) । लड़का, बालक । मा० १.२७७.३
_______________________________________________
945
लरिकाइअ : लड़कपन ही। जो बर लागि करहु तप तो लरिकाइअ ।' पा०म० ४६
लरिकाइहि : लड़कपन ही, बचपन ही। मा० २.२७४.५
लरिकाईं : लड़कपन में, शिशुकाल में। 'बहु धधहीं तोरी लरिकाई ।' मा० १.२७१.७
लरिकाई : (१) सं०स्त्री०। लड़कपन, शैशव, बचपन । मा० २.१०५ (२) बचकाना स्वभाव (अज्ञता)। कृ० १३ (३) बालसुलभ चञ्चलता (अशिष्टता) । 'कहबि न तात लखन लरिकाई।' मा० २.१५२.८
लरिकिनीं : सं०स्त्री०ब० । लड़कियाँ। 'वधू लरिकिनी पर घर आईं।' मा० १.३५५.८
लरिकै : लड़का ही। अंत तो हौं लरिक ।' गी० १.७२.२
लरिकौ : लड़के भी, पुत्र भी। 'जा के जिये मये सोच करिहैं न लरिको ।' हनु० ४२
लरिबे : भकृ०० (सं० लडितव्य>प्रा० लडिअव्व) । लड़ने, युद्ध करने । 'जिन्ह ___के लरिबे कर अभिमाना ।' मा० १.१८२.२
लरिहै : आ०भ०प्रए । लड़ेगा । 'लरिहै मरिहै करिहै कछु साको।' कवि० १.२०
लरे : भूकृ००ब० । लडे, युद्धरत हुए । 'लोहे ललकारि लरे हैं ।' गी० ६.१३.१
लरै : आ०प्रए० (सं० लडति>प्रा० लडइ)। लड़ता है, युद्ध करता है । 'मृगराज के साज लर।' कवि० ६.३६
लरौं : आउए० । लड़ता हूं। कलह करता हूं। 'निज पाप........ सुनत लरौं ।' विन० १४१.४
लर् यो : भूक ००कए । लड़ा, युद्ध किया । 'राम काज खगराज आज लर्यो ।' गी०३ ८.३
ललक : संस्त्री०। लालसा, स्पहा, लिप्सा-प्राप्त करने की तीव्र इच्छा । दो० ६७
ललकत : वकृ००। तीव्र लिप्सा से लपकते । 'ललकत लखि ज्यों कंगाल पातरी सुनाज की ।' कवि० ६.३०
ललकारि : पूकृ० । ललकार कर, चुनौती देकर, प्रतिद्वन्द्विता में आह्वान करके । 'लोहे ललकारि लरे हैं ।' गी० ६.१३.१
ललकि : पूकृ० (सं० लालक्य-लक रसने) । ललक कर, तीव्र लालसा से चञ्चल होकर । 'लगे ललकि लोचन ।' मा० १.२४८.८
ललचानी : भूक०स्त्री० । ललचायी, लुब्ध हुई। 'रसना..त्यों न ललकि ललचानी ।' विन० १७०.३
ललचाने : भूक००० । ललच उठे, लुब्ध हुए। 'देखि रूप लोचन ललचाने ।' मा० १.२३२.४
