अँकरे : वि.पु. (आंकड़े =अंक गणना में आने वाले) खरे, उत्तम । 'करे किये खोटेउ'-कवि० ७.१२७
अँकोर : सं० स्त्री० (सं० उत्कोच>प्रा० अक्कोड़ा) घूस, रिश्वत, प्रलोभन । 'दै __ अंकोर राखे जुग रुचिर भोर' गी० ७.३.३
अँखियनु : अखिया+संब०-आंखों के। अॅखियन बीच' बर, ३०
अँखियां : अॅधिया+बहु० । आँखें । 'ए अखियां दोउ बैरिनि देत बुझाइ' बर० ३६
अलिया : 'आंख' का रूपा० । स्नेहपूर्ण आंख । 'सोभा सुधा पियें करि अंखिया दोनी।' गी० २.२२.२
अँग: अंग। मा० २.३१५
अँगइ: पूकृ अङ्गीकार करके, शरीर पर झेल कर । 'अंगइ अनट अपमान' दो० ४६६
अँगना : सं० पु० (सं० अङ्गन) आंगन, आजिर गी० १.८.३
अँगनाई : सं० स्त्री० (सं० अङ्गनवेदी>प्रा० अंगणेई) आँगन का भूभान । मा० ७.७६.४
अँगनैया : अंगनाई (सं० अङ्गनवेदिका>प्रा० अंगणेझ्या) गी० १.६.३
अँगरी : सं० स्त्री० (सं अङ्गिका कञ्चुक>प्रा० अंगिया>सं० अंगडी) कवच, अङ्गत्राण । मा० २.१९१.५
अँगवनिहारे : वि० पु बहु० । अङ्गों पर झेलने वाले। सूल कुलिस असि ___अंगवनिहारे-मा० २.२५.४
अँगार : अंगार । मा० ६.५३
अँगरू : अंगार+कए० । अंगार। 'पाके छत जनु लाग अंगारू।' मा. २.१६१.५
अँगुरिन : अंगुलियों से । 'अंगुरिन खांडि अकास'-पर २८
अँगुरियन्ह : अंगुलियों में । रा. न. १५
_______________________________________________
अँगुरियां : सं० स्त्री० बहु० (सं० अङ्गुरिका:>प्रा० अंगुरियाओ>अ. अंगुरियाई) अंगुलियां । गी० १.३२.१
अँगुली : अंगुलि । दो० ५२७
अँगुष्ठ : सं० (सं० अङ्गुष्ठ) अंगूठा । गी० ७.१७.४
अँचइ : पू कृ० (सं० आचम्य) आचमन करके, मख आदि धोकर । 'अँचइ पान सब काहूं पाए ।' मा० १.३५५.२ ।।
अँचइअ : आ० भावा० (दे० अंचव) । आचमन कीजिए, पीजिए । 'अँच इस नाथ कहहिं मृदु बानी ।' मा० २.११५.१
अँचई : भू कृ स्त्री० । पी डाली। 'लाज अंचई घोरि'--दिन० १५८.६ अचव
अँचव अँचवइ : अच (प्रक्षालन करना, पीना) पीता है। जो अंचवें । जल 'स्वाति को।' दो० ३०६
अचवहु : 'अचव'+म०व० । तुम पियो। 'सोभा सुधा अचवहु ।' गी० २.२३.२
अँचवायउ : भू कृ पु. कए। आचमन कराया, पिलाया । पाम १३५
अँजोरी : प्रकृ० । अंजलि में भर कर, समेट कर । हथिया कर। 'सुकृत __ सिला.दंभ लेत जोरि ।' दिन० १५८.४
अँजोरी : सं० स्त्री० । प्रकाश । 'खद्योत अजोरी ।' मा० ३.११.२
अँतावरि : सं० स्त्री० (सं० अन्त्रावलि>प्रा० अतावलि) आंतों की लड़ी। 'गल अॅतावरि मेल हीं।' मा० ६.८१ छं०
अँथइहि : आ० प्रए० भ० । अस्त होगा। “उदित सदा अथइहि कबहूंना मा० २.२०६.२.
अँययउ : भूकृ० पु० कए । अस्त हो गया। रबि अॅथयउ, मा० २.१५४.३
अँदेसो : सं० पू० (फा० अन्देशः) चिन्ता, सोचा । मा० १.१४.१०
अॅदेसो : 'अंदेसा'+कए। एकमात्र चिन्ता। गी० २.८७.४ ।।
अँधियारा, रा, अंधियार : सं० ० (सं० अन्धकार>प्रा० अंधयार) अंधेरा। मा० १.१५६.८, बर० ३६
अँधिआरी : (१) सं० स्त्री०=अधिार । 'अगर धूप बह जनु अंधारी।' मा० १.१६५.५ (२) वि० स्त्री० (सं० अधिकारी>प्रा० अंधियारी), अन्धेरी, काली, अन्धा बना देने वाली। 'मानहुँ कालराति अधिआरी।' मा० २.८३.५
अधिआरें : क्रि० वि० । अन्धेरे में। 'अवध प्रबेसु कीन्ह अंधिआर मा० २.१४७.५
_______________________________________________
अँधियारो : वि० पु. कए । अन्धकार से ढका हुआ । 'लागत जग अँधियारो।' गी० २.६६.१
अँबराई : (१) सं० स्त्री० (सं० आम्रराजी>प्रा० अंबराई) आमों का बगीचा, उद्यान, उपवन । मा० १.२१४.५ (२) प्रकृ० । अम्बर-आकाश के समान शन्य में फैलाव करके, बातों का वात्याजक्र गढ़ कर । 'तुलसीदास जनि बकहि मधुप सठ हठ निसिदिन अंबराई ।' कृ० ५१
अँबारी : सं० स्त्री (सं० आवारिका) आवरण, हाथी की झूल आदि । 'कलित करिवरन्ह परी अंबारी।' मा० 1.३००.१ (२) मकान का छज्जा आदि । 'चारु बजारु विचित्र अंबारी।' मा० १.२१३.२
अ : निषेधार्थक (सं०) अव्यय जो समास के पूर्व पद में आता हैअचपल, अग्यान आदि।
अंक : सं० ० (सं०) (१) चिन्ह, छाप । 'राम पद अंक' मा० २.१२३.६ (२) गोद । 'प्रीति समेत अंक बैठावा' मा० ६.४६.७ (३) बाहुपाश, भुजबन्ध । तेहि भरि अंक राम लघु भ्राता' । मा० २.१६४.४ (४) रेखा, लेख, लिपि 'बिधि के लिखे अंक निज भाला ।' मा० ६.२६.१
अंकमाल : सं० स्त्री० (सं० अंकमाला) । अकवार, बाहुबन्धन, आलिङ्गन । 'सब अंकमाल देत हैं।' कवि० ५.२६
अंका: अंक।
अंकित : भूकृ० वि० (सं.) (१) लिखित । 'राम नाम जस अंकित' मा० १.१०.५ (२) छापयुक्त, मुद्रित । 'प्रभुपद अकित अवनि बिसेषी ।' मा० २.३०८.४
अंकुर : सं० पु. (सं०) अंखुआ,, बीज जमने पर निकलने वाली नोक । 'अच्छत कुर लोचन लाजा।' मा० १.३४६.५
अंकुरे : भूकृ० बहु० पु० (सं० अंकुरित>प्रा० अंकुरिय) उगे, जमे, प्रकट हुए। 'कपट भू भट अकुरे ।' मा० ६.६४ छं०
अंकुरेउ : भूक पु० फए० । अखुआया, उगा । 'उर अंकुरेउ गरब तरु भारी।' मा० १.१२६.४
अंकुस : सं०पू० (सं० अकुश) हाथी चलाने आदि का उपकरण-विशेष । मा० १.२५६ (२) सामुद्रिक रेखा विशेष । 'रेखा कुलिस ध्वज अंकुस सोहे।' मा० १.१६६.३
अंग : सं० पुं० (सं.) (१) पक्ष, अश। 'सूझ न एकउ अग उपाऊ।' मा० १.८.६ (२) शरीर । 'भव अंग भूति मसान की।' १.१ छं० (३) देह का अवयव । 'अंग-अंग पर वारिअहिं ।' मा० १.२२० (४) सहायक । रिडरे अंग जोगु जग को है।' मा० २.२८५.५ (५) योग के आठ अङ्ग-यम, नियम, आसन, प्राणायाम, प्रत्याहार, धारणा, ध्यान और समाधि (६) राजनीति के सात अङ्ग-स्वामी, अमात्य, सुहृद, कोष, राष्ट्र, दुर्ग और सेना । सकल अंग संपन्न सुराऊ। मा० २.२३५.८
अंगद : सं० पु (सं०) (१) वाली का पुत्र वानर विशेष । मा० ४.११ (२) बाहु भूषण विशेष । 'पहुंची अंगद..।' गी० १.४३.२
अगन : सं० पु० (सं०) आंगन, मैदान, रणक्षेत्र । मा० ६.८१ छं०
अंगना : सं० स्त्री० (सं०) सुन्दर अङ्गों वाली स्त्री कवि ७.१५१
अंगनि, न्हि : 'अग+संब० । अंगों (में, पर, ने, से आदि) । 'भषन अंग अंगन्हि प्रति सजे।' मा० ७.१२ छं० २ 'विभूषन उधम अंगनि पाई।" कवि० २.१
अंगा : अंग । मा० ५.१६.४
अंगार, रा : सं० पु० (सं० अङ्गार) आग का गोला । मा० ५.१२
अंगीकारा : सं० पु. (सं० अङ्गीकार) । स्वीकार (अपना अङ्ग बना लेना)। _ 'तासु साप करि अंगीकारा।' मा० १.८६.४
अंगु, गू : 'अग+कए। शरीर मात्र । 'सूखहिं अधर जाइ सबु अंगू।' मा० २.४०.१
अंगुल : सं० ० (सं०) अगुली की चौड़ाई की नाप । मा० ७.७६
अंगुलि : सं० । स्त्री० (सं०) । कर शाखा । मा० १.११७.३
अंगुलित्राान : सं०पु० (सं० अङ्गलित्राण) हस्तकवच (दस्ताने जैसा अंगलियों का वर्ग)। गी० ७.१७.८
अंघ्रि : सं० पु० (सं०) चरण । मा० ७.१४.६
अंचल : सं० ० (सं०) परिधान का छोर जो गले से नीचे कटि से ऊपर रहता है-ओढ़नी का दामन । मा० १.३११ छं०
अचलु : कए । 'चरन नाइ सिर अचल रोपा ।' मा० ६.६४
अंजन : सं० पु० (सं०) कज्जल (दष्टि रोग निवारण की औषधि) दीप्त करने वाला साधन । 'गुरु पद रज मृदु मंजुल अंजन ।' मा० १.२.१ ('निरञ्जन आदि पदों में 'बाहरी प्रकाशक से निरपेक्ष तथा निर्मल' का अर्थ रहता है।)
अंजना : सं० स्त्री० (सं०) । हनुमान की माता । विन० २६१
अंजलि : सं० स्त्री० (सं.)। करपुट, हाथों से की हुई पात्र जैसे आकृति । मा० १.३
अंजि: पुकः । आज कर, भजन लगाकर । मा० १.१
_______________________________________________
अंजुलि : जालि । मा० १.१६१.७
अंड : सं० पु० (सं०) (१) पक्षी आदि का गोलाकार प्रसव (२) ब्राह्मण (जो अण्डाकार होता है) । 'अड अनेक अमल जसु छावा ।' मा० २.१५६.१
अंडकटाह : कढ़ाई का आकार का ब्राह्मण का अर्ध भाग । मा० ७.८० ख
अंडकोस : सं० पु. (सं० अण्डकोश) ब्राह्मण का भीतरी भाग।' अंडकोस समेत गिरि कानन ।' मा० ५.२१.६
अंडजराया : अण्डजों-पक्षियों के राजा-गरुड । मा० ७.८०.३
अंडन्हि : अड+सं० ब०। अण्डों (में)। 'अॅडण्हि कमठ हृदय जेहि भांति ।' मा० २.७.८
अंत : सं० पु. (सं.) (१) अवसान, समाप्ति । 'उधराहिं अन्त न होइ निबाहू ।' __ मा० १.७.६ (२) परिणाम । 'सुनत बात मदु अन्त कठोरी।' मा० २.२२.३
अंतःकरण : बोध के आन्तरिक साधन-अन्तरिन्द्रिय । इनकी संख्या चार है (१) संकल्प-विकल्प का साधन-मन (२) अभिमसरूप अहंकार (३) निश्चया त्मक बोधकारिणी बुद्धि और (४) इन तीनों का अधिष्ठान चित्त । 'बुधि मन चित अहंकार ।' विन० २०३.५
अंतक : सं० पु० (सं०) अन्त करने वाला =यमराज, मृत्यु । विन० ४६.२
अंतकाल : अन्त का समय-मत्यु समय । मा० ४.६
अंतर : वि.+सं० पु० (सं.) (१) भेद । 'तुम्हहि रघुपतिहि अंतर केता।' मा० ६.६.६ (२) भीतर। 'सब के उर अंतर बसहु ।' मा० २.२५७ (३) भीतरी, आन्तरिक । 'अंतरसाखी' मा० ६.१०८.१४ (४) बीच में । 'उभय अंतर एक नारि सोही।' गी० २.१६.२
अंतरगत : वि० (सं० अन्तर्गत)। भीतर स्थित । 'जलचर बृन्द जाल अंतरगत ।' विन० ६२.६
अंतरगति : सं० स्त्री० (सं० अन्तर्गति)
अन्त:करण की दशा, मनोभाव । गी० ५.१६.३
अंतरजामिनि : वि० स्त्री. (सं० अन्तर्यामिनी) जीवों के भीतर व्याप्त रहकर नियन्त्रित करने वाली प्रेरक शक्ति । गी० १.७२.२
अंतरजामी : वि० ० (सं० अन्तर्यामिन्) । ब्रह्म का तुरीय रूप जो सभी जीवों में व्याप्त एवं सूक्ष्म है। प्राणिनामन्तर्ममयति इत्यन्तर्यामी-सभी प्राणियों की वहीं प्रेरक शक्ति है। 'अन्तराविश्यभूतानि यो विभत्मिकेतुभिः । अन्तर्यामीश्वरः साक्षात् ।' अन्तर्यामी साक्षात् परमेश्वर है जो प्राणियों के भीतर आवेश लेकर अपने संकेतों से उनको प्रेरित करता है। रामानुज-दर्शन में इसी की उपासना को सर्वोपरि बताया गया है । मा० १.५१.५
अंतरधान : सं०० (सं० अन्तर्धान) अदृश्य होना । मा० १.७७.७
_______________________________________________
अंतरसाखी : सं० स्त्री० (सं० अन्तःसाक्षी) आन्तरिक प्रमाण । 'प्रगट कीन्हि चह अंतरसाखी।' मा० ६.१०८.१४
अंतरहित : वि० (सं० अन्तहित) अदृश्य, अन्तर्धान को प्राप्त । 'अस कहि अंतरहित प्रभु भयऊ ।' मा० १.१३३.२ ।
अंतक : 'अंतर'+कए । एकमात्र भेद । 'ईस अनीसहि अंतरू तैसें ।' मा० १.७०.२
अंतर्धान : अंतरधान । मा० ७.१३
अंतरु : अन्त में भी, अन्ततः, अन्ततोगत्वा । 'हठ कीन्हें अंतहुं उर दाहू ।' मा० १.२४६.५
अंतावरी : सं० स्त्री० बहु० (सं० अन्नावली:) आंतों की लड़ियां, आँते ।। 'अंतावरी गहि उड़त गीध ।' मा० ३.२०.६०
अंतु : 'बत'+कए । विनाश । 'कुल अंतु किए अंत हानि ।' कवि० ६.२२
अंध : सं०+वि० (सं०) (१) दृष्टिहीन । 'तापस अंध साप सुधि आई।' मा० २.१५५.४ (२) विवेक-हीन । 'मदन अंध ब्याकुल सब लोका। मा. १.८५.५ (३) अँधेरा । 'मोह अंध रवि बचन बहाव ।' वैरा० २२
अंघउ : अंधा भी, अंधे भी। 'अंधउ बाधिर न अस कहहिं ।' मा०६.२१
अंधकार : सं० पु० (सं.)+क ए अँधेरा । 'अंधकारु बरु रबिहि नसावै ।' मा० ७.१२२.१८
अंधनि : 'अंध'+संब० । अन्धों (ने)। 'अंधनि लहे हैं बिलोचन तारे ।' गी० १.६०.५
अंधहि : अन्धे को । 'अंधहि लोचन लाहु' मा० १.३५०.७
अंब, बा : सं० स्त्री० (सं० अम्बा) (१) माता। मा० १.३१.१४ (२) दुर्गा । ... 'बानि बिनायकु अंब रबि ।' रा०प्र० १.१.१
अंबक : सं० पु० (सं.) (१) नेत्र। 'नव अंबुज अंबक छबि नीकी ।' मा १.१४७.३ (२) पिता । 'अनकल अंबक अंब ज्यों निज डिंब हित सनमानि के।" गी० ३.१७.३
अंबर : सं० पु० (सं०) (१) वाह्य । 'अंबर पीत सुर मन मोहई ।' मा० ६.१२ छं० २ (२) आकाश । 'अबर अमर हरषिता' कृ० २०
अंबरीष (स) : एक पौराणिक राजा जो भगवद्भक्त थे। भगवान् न क्रुद्ध दुर्वासा से उनकी रक्षा करने हेतु अपना चक्र सुदर्शन दुर्वासा के पीछे लगा दिया था । ('जथा चक्र अयँ रिषि दुरबासा') 'सुधि करि अंबरीष दुरबासा।' मा०. २.२६५.४
_______________________________________________
अंबरीस : अंबरीस (प्रा.) । विन० ९८.५
अंबा : अंब । मा० २.६०.७
अंबिका : सं० स्त्री० (सं०) दुर्गामाता, पार्वती । मा० १.६७.२
अंबु : सं० पु० (सं०) जल । मा० २.५७.२
अंबुचर : जलजन्तु । हनु० ३४ ।।
अंबुज : सं० पु. (सं०) कमल । मा० १.१०६.७
अंबुद : सं० पु० (सं.) । मेघ । गी० १.७.३
अंबुधर : जलधर । मेघ । 'नव अंबधर वर गात ।' मा० ७.१२ छं २
अंबुधि : सं० पु० (सं०) समुद्र । मा०१.८५.२
अंबुनिधि : अंबुधि । मा० २.२६३.३
अंबुपति : जलाधीश-वरुण । मा० ६.१५.६
अंभोज : सं० पुं० (सं.)। कमल । मा० १.३१८ छं०
अंभोद :  सं० पु (सं०) । मेघ । विन० ५६.८
अंभोधि :  सं० पु० (सं.)। समुद्र । विन० २५.१
अंभोरुह : सं० पुं० (सं०) । कमल । गी० १.५४.२
अंस : (१) सं० पु(सं०) कन्धा। (2) भाग । 'ईस अंस भव'-मा० १.२८.८ (३) ईश्वर के गुणरूप चित् (जीव) और अचित् (प्रकृति)। 'ईस्वर अस जीव अबिनासी ।' मा० ७.११७.२ (४) विष्णु आदि जो परब्रह्म के कला अवतार हैं- मा० १.१४४.६ ।।
अंसनि : 'अस'+संब०। कन्धों (पर) । 'असनि धनु, सर कर कमलनि ।' गी० १.५५.३
अंसन्ह : असनि । अंशों । 'असन्ह सहित देह धरि ताता।' मा० १.१५२.२
अंसिक : वि० (सं० आंशिक)। (१) अंश से उत्पन्न । 'सुर सिक'  मा० ६.११४.८ (२) अंशमात्र, अल्प । निज अंसिक सुख लागि-कु० ३१ .
अइसिहुं : ऐसी भी। 'अइसिहुँ मति उर बिहर न तोरा ।' मा० ६.२२.२ .
अइसे : वि० पु बहु । ऐसे । 'अइसे मनुज अनेक ।' मा०६.३१
अइसेउ : ऐसे भी। 'अइसेउ एक तिन्हहि जे खाहीं।' मा० ६.४.६
अइहहिं : आ० भ० प्र० ए० । आएँगे । 'अइहहिं रघुबीरा ।' मा० ५.१६.४
अउर : अवर । अन्य । 'नहिं जानउँ कछु अउर कबारू ।' मा० २.१००.७
अकंटक : वि० (सं०) कण्टक-शत्रु या बाधा से रहित । निष्कण्टक । प्रतिरोध । रहित । जोगी अकंटक भए।' मा० १.८७.छं०
अंकपन : सं० पु. (सं०) एक राक्षस (युद्ध में कम्प रहित) । मा० १.१८०
_______________________________________________
अकथ : वि० (सं० अकथ्य) अकथनीय, अनिर्वचनीय (जो कहा न जा सके)। मा० १.२.१३
अकथनीय : अकथ । मा० १.६०.१
अकनि : पूकृ० (सं० आकर्ण्य>प्रा. आकाण्णि अ>अ० आकाण्णि) सुन कर। 'अवनिय अकानि रामु पगु धारे।' मा० २.४४.१
अकरुन : वि० (सं० अकरण) करुणारहित, निर्दय । मा० १.२७५.६
अकल : वि० (सं०) कलारहित, अखण्ड, निर्विकार । 'अज अकल अनीह अभेद।' मा० १.५०
अकलंकता : सं० स्त्री० (सं.) निष्कलंकता, निर्दोषता । 'अकलंकता कि कामी लहई ।' मा० १.२६७.३
अकलंका : वि. (सं० अकलंक) कलंकरहित, निर्दोष । 'सबहि भांति संकर अकलंका।' मा० १७.२.४ ।।
अकस : सं० पु । ईर्ष्या, होड़, अमर्ष । 'बंदि बोले बिरद अकस उपजाइ के।' गी० १.८४.७
अकसु : क ए । एतेमान अकसु कीबे को आपु आहि को । कवि० ७.१००
अकसर : वि० (सं० एकसर) एकाकी, अकेला । 'अकसर आयहु तात । मा० ३.२४
अकाज, जा : सं० ० (सं. अकार्य>प्रा० अकज्ज) कार्य बिगड़ना, प्रयोजन की हानि । 'पर अकाज भर सहसबाहु से।' मा० १.४.३
अकाजु : क ए। अद्वितीय प्रयोजन हानि । 'पर अकाजु लगि तनु परिहरहीं।' मा० १.४.७
अकाजेउ : भूकृपुं कए। अकाज मृत्यु को प्राप्त हुआ। ‘मानहुं राजु अकाजेउ ___आजू ।' मा० २.२४७.६
अकाथ : वि० (सं० अकृतार्थ-प्रा० अकअत्थ) निस्प्रयोजन, निरर्थक । 'तनु..... कत खोवत अकाथ।' वि. ८४.१
अकाम : (१) वि० (सं०) कामना रहित । मा० १.७६.२ (२) सं० पु० (सं.)। वासना-रहित मनःस्थिति । 'अवहे अनल अकाम बनाई।' मा० ७.१७१.१३
अकामा : अकाम। मा० ३.४५.७
अकामिन् : वि० (सं०) कामनाहीन । मा० ३.४.७०
अकारन : क्रि० वि०+वि० (सं० अकारण) । बिना कारण के ही। 'अकारन को ही।' मा० १.२६७.२
अकाल : सं० पु० (सं०) ऋतु के विपरीत समय । वह ऋतु जिसमें वस्तु विशेष पैदा न होती हो। 'जिमि अकाल के कुसुम भवानी।' मा० ३.२४.८
अकास : सं० पुं० (सं० आकाश) मा० १.१७४.४
_______________________________________________
अकासबानी : सं० स्त्री० (सं० आकाशवाणी) अदृश्य दैवी वाणी। मा० १.१७३.५
अकासा : अकास।
अकिंचन : वि० (सं०) दरिद्र (जिसके पास कुछ न हो)। मा० १.१६१.३
अकुंठा : वि० (सं०) कुण्ठारहित, छलना रहित, निर्व्याज, निश्छल । 'रघुपति भगति अकुंठा।' मा० ६.२६.८
अकुल : वि० (सं०) कुलहीन, अकुलीन । मा० १.७६.६
अकुला : (सं०) आकुलायते>प्रा० आकुलाइ
अकुलाइ, ई : विकल होना, तिलमिलाना आ० प्रए । विकल होता- होती है। 'देखि-देखि अकुलाइ।' मा० २.७६
अकुलाइ, ई : पू० कृ। आकुल होकर । 'गहे चरन अकुलाइ ।' मा० २.७१ 'केवट चरन गहे अकुलाई ।' मा० २.१०२.४
अकुलाति : व क् स्त्री० । विकल होती । 'मति अकुलाति ।' विन० २२११३
अकुलान, ना : भूकृ पु । व्याकुल हुआ। मा० २.६६.४
अकुलानि, नी : स्त्री। व्याकुल हुई । 'बिपुल वियोग प्रजा अकुलानी ।' मा० २.५१.६
अकुलाने : ब० । व्याकुल हुए । 'दरस लागि लोचन अकुलाने ।' मा०.१.१२६.७
अकुलान्यो : अकुलान कए । व्याकुल हुआ । गी० ३.८.२
अकुलाहिं, हीं : आ० प्र० । व्याकुल होते हैं । 'पुनि-पुनि मुनि उकसहिं अकुलाहीं।' मा० १.१३५.२
अकुलीन : अकुल । जो उत्तम कुल का न हो+कुलहीन । पा० मं० ५५
अकेल, ला : वि० पु० (सं० एकल <प्रा० एक्कल) एकाकी । 'रिपु तेजसी अकेल अपि ।' मा० १.१७०
अकेलि, ली : स्त्री० । एकाराकिनी। 'बिपिन अकेलि फिरहु केहि हेतु ।' मा० १.५३.८
अकेलें : क्रि० वि० (सं० एकलेन<प्रा० एक्कलेण<अ० एक्कलें) एकाकी स्थिति में । 'को तुम्ह कस बन फिरह अकेलें ।' मा० १.१५६३
अकोबिद : वि० । शास्त्रज्ञान-रहित, अकुशल । मा० १.११५.१
अखंड : वि० (सं.) अविच्छिन्न, निर्विघ्न, एकतान । 'लागि समाधि अखंड अपारा ।' मा० १.५८.८
अखंडल : सं० पुं० (सं० आखण्डल) । इन्द्र । पा० म० ११४
अखंडा : अखंड । मा० ७.६३.१
अखंडित : वि० (सं०)=अखंड । मा० ७.४६.७
अखय : वि० (सं० अक्षय>प्रा० अक्खय) अविनाशी ।
_______________________________________________
अखयबटु : प्रयाग तीर्थ का वटवृक्ष विशेष जिसको 'अक्षयवट' कहते हैं। मा० २.१०६.७
अखारा : सं० पु० (सं० अक्षवाट प्रा० अक्खाड) मल्लयुद्ध का स्थान विशेष, मनोरंजन का सामूहिक स्थान या पंडाल । 'तहं दसकंधर केर अखारा।' मा० ६.१३.४
अखारेन्ह : अखाड़ों में, कुश्ती के स्थानों में । मा० ५.३.छं०
अखिल : वि. (सं०) सम्पूर्ण, अशेष, सकल (खिल=शेष) । मा० १११६१
अखिलविग्रह : जिसका शरीर (विग्रह) सब कुछ हो: विश्वरूप; विराट; परमेश्वर (जिसके चित् और अचित् शरीर रूप हैं) । विन० १०.७
अखिलेश्वर : सं० पु० (सं० अखिलेश्वर)। सर्वेश्वर, चराचर विश्व का स्वामी । मा० १.४८.२ .
अखेटकी : सं० स्त्री० (सं० आखेटिकी) आखेट कर्म मगया। 'अटत गहनगन अहन आखेटकी ।' कवि० ७.६६
अग : वि० (सं.)। स्थावर, वृक्ष-पर्वत आदि अचर पदार्थ, जड़ प्रकृति । 'अग जगमय सब रहित बिरागी।' मा० १.१८५.७
अगति : गतिहीनता, निर्गति, गतिरोध । गी० २.८२.३
अगनित : वि० (सं० अगणित)। असंख्य, अमित । मा० १.६३.छं०
अगम : वि० (सं० अगम्य>प्रा० आगम्य) । पहुंच से परे । 'उभय अगम जुग सुगम नामते।' मा० १.२३.५
अगमनो : वि. पु. कए । अपमामी, प्राथमिक, सामने आया हुआ । गी० ५.१५.३
अगमु : 'अगम'+कए। 'अगमु न कछु' मा० १.३४२.५
अगर, अगर : सं० ० (सं० अगरु, अगुरु) । सुगन्धित काष्ठ विशेष जिसका धूप के समान उपयोग होता है। मा० १.१६५.५; १.१०.६
अगलगे : वि०पू० (सं० अग्नि लग्न या अग्रलग्न)>प्रा० अग्नि लग्न या अग लग्न) दाहयक्त तथा आगे-आगे विषयों में संलग्न ।' 'अवन-नयन-मग अगलगे, सब थल पतितायो।' विन० २.७६.५
अगवान, ना : सं० पु०-आगे जाकर बरात आदि का स्वागत करने वाले ।' मा० १.६५.२, ६६.१
अगवान्ह : सम्ब ५० अगवानों (ने) । 'अगवानन्ह जब दीखि बराता।' मा० १.३०५.७
अगवानी : सं० स्त्री० । आगे जाकर स्वागत करने की क्रिया। नियरानि नगर बरात हरषी लेन अगवानी गए।' जा० मं० १३५
अगरत्ति : सं० पु. (सं.) । एक ऋषि जो पौराणिक परम्परा में प्रथम दक्षिण यात्रा के लिये प्रसिद्ध हैं। समद्र पीने के लिये भी वे विख्यात हैं। मा० ३.१२.६
_______________________________________________
अगह : वि० (सं० अग्रह) अग्राह्य, अज्ञेय, पकड़ से बाहर । 'नूपगति अगह, गिरा जाति न गही है। मी० १.८७.२
अगह : 'अगह'+कए। एकमात्र अग्राह्य अज्ञेय । 'सब विधि अगहु अगाध दुराऊ ।' मा० २.४७.७
अगहड़, अगहुंड : वि०+क्रि० वि० आगे की ओर, आगे गति लेने वाला। 'भय बस अगहड़ परइन पाऊ।' मा० २.२५.१ 'मन अगहुंड़, तन पुलक सिथिल भयो।' गी० २.६६.३
अगाऊ: वि०+क्रि० वि० । आगे, अग्रगामी। "उलटि बिबादन आइ अगाऊ।' कृ० १२
अगाध : वि० (सं.) अथाह; जिसमें अवगाहन न किया जा सके । मा० १.२३.१
अगाधा : अगाध । मा० १.३७.२
अगाधु, धू : एक । 'सुमति भूमि थल हृदय अगाधू ।' मा० १.३६.३
अगार : सं० पू० (सं० आगार) घर, भण्डार । गी० १.७१.२
अगारु : कए । एकमात्र भण्डार । 'अपकार को अगारु जग।' कवि० ७.६८
अगारे : अगार+बहु० । 'सील सुधा के अगारे ।' गी० १.६४.३
अगिनि: सं० पु. (सं० अग्नि<प्रा० अगिणी) (१) आग । मा० १.६४.८ (२) आग्नेय दिशा के दिगपाल-अग्निदेव । मा० १.१८२.१०
अगिले : वि. पु. (सं अग्रिम-प्रा० अग्गिल्ल) आगामी, प्रथम, आगे होने वाले। विन० २४.४
अगुमाई : क्रि० वि० । अग्रभाग में, अगुआ (अग्रगामी) के रूप में । 'कियउ निषादनाथु अगुआई ।' मा० २.२०३.१
अगुन : (१) सं० पुं० । गुणाभाव, अवगुण । 'खल अघ अगुन, साधु गुन गाहा।' मा० १.६.१ (२) वि० । उत्तम गुण, कोशल आदि से रहित । 'अगुन अमान जानि तेहि दीन्ह पितां बनवास ।' मा० ६.३१क (३) गुणरहित = निर्गुण । वैष्णव दर्शन में माया गुणों से रहित (कल्याण गुणों से युक्त) ब्रह्म। 'अगुन अनुपम गुन निधान सोए मा० १.१६.२ ब्रह्म के सर्वथा निर्गुण स्वरूप को वैष्णव मत में अमान्य किया जाता है-दें मा० ७.१११
अगेह : वि० (सं०) गृहहीन । मा० १.७६.६
अगेहा : अगेह । मा० १.१६१.४ ।
अगोचर : वि० (सं०) जो इन्द्रियां (गो) की गति (चर) से परे हो; अतीन्द्रिय, ___अप्रमेय । 'मन बुद्धिबर बानी अगोचर प्रकट कवि कैसे करें।' मा० १.३२२.छ..
अग्य : वि० (सं० अज्ञ) अग्यानी, मूढ़। मा० १.५१.२
अग्यता : सं० स्त्री० (सं अज्ञता) मूढता । मा० ७.३४.६
