_______________________________________________
35
अपसरा : अपछरा । गी० १.३.२
अपह : वि० पु० (सं०) । नाशक (समासान्त में) । 'ध्वान्तापहं तापह्म'। मा० ३ श्लोक १
अपहर, अपहरई : (१) (सं० अपहरति--दूर करना, नष्ट करना, हर लेना) आ० प्रए । हरण करता है। दूर करता है। 'सरदातप निसि ससि अपहरई।' मा० ४.१७.६ (२) छीन लेती है+अपने वश में करती है । 'जो ग्यानिन्ह कर चित अपहरई ।' मा० ७.५६.५
अपहरत : (१) वक० पु । अपहरण करता है-- दूर या निरस्त करता है। 'अपहरत विषादा । मा० २.२७६.१ (२) क्रियाति० पु०। 'दुख दाह दारिद..... अपहरत को।' मा० २.३२६ छं०
अपहरति : (१) व स्त्री० । हरण करती । (२) आ० प्रए (सं०) दूर करता-ती है। 'दर्शनादेव अपहरति पाप ।' विन० ५५.८
अपहरन, →अपाहरन : वि० । हरने वाला । विन० ५३.६
अपहरहि, अपहरहीं: आ० प्रब । दूर करते हैं, छीन लेते हैं । 'भानु जान सोभा अपहरहीं।' मा० १.२६६.४
अपहारी : वि० (सं० अपहारिन्) दूर करने वाला, हरने वाला । विन० ४४.३
अपाउ : सं० पुं० (सं० अपाय)+कए। हानि, उत्पात, उपद्रव । 'जोगवत अनट अपाउ ।' विन० १००.३
अपान : सं० पु० (सं० आत्मन् >प्रा० अप्पाण) अपनापन, स्वयम्, निज की सत्ता । 'अपान सुधि भोरी भई ।' मा० १.३२१.छं०
अपाय : (१) सं० पु० (सं०) । क्षति, विकार, नाश, व्याधि । (२) विघ्न, बाधा (उपाय का विलोम) । 'कलि-काल अपर उपाय ते अपाय भए।' विन० १८४.१
अपार : वि० (सं०) जिस का पार (छोर) न हो, असीम । मा० १.६.१
अपारा : अपार । मा० १.६.१०
अपारि : अपार (सं० अपारिन् ) जो 'पारी' =पारयुक्त न हो । असीम । 'सब गुन उदधि अपारि ।' कृ० २७
अपारू : अपार-+कए। ‘राम बियोग पयोधि अपारू ।' मा० २.१५४.५ ।।
अपारो : अपारू । विन० ११७.३
अपावन : वि० (सं०) । अपवित्र, मलिन, बीभत्स । मा० १.६३ छं०
अपावनि, अपावनी: अपावन+स्त्री० । 'सहज अपावनि नारि ।' मा० ३.५
अपि : अव्यय (सं.)। भी । 'रिपु तेजसी अकेल अपि ।' मा० १.१७०
अपी : अपि । भी । 'धनवंत कुलीन मलीन अपी।' मा० ७.१०१.७
36
_______________________________________________
अपुनीत : अपावन, अपवित्र । मा० १.६६.७
अपेल : वि० (सं0-पेल गतौ) अचल, अनुल्लङ्घनीय। 'प्रभु अग्या अपेल श्रुति - गाई।' मा० ५.५६.८
अप्रतिहत : वि० (सं.)। अव्याहत, निर्बाध, बेरोक । 'अप्रतिहत गति होइहि तोरी।' मा० ७.१०६.१६
अप्रमेय : वि० (सं.)। अज्ञेय, अनिर्वचनीय (जो प्रमाणों--प्रत्यक्ष इन्द्रिय, अनुमान आदि-से प्रमेय न हो) । प्रमाता द्वारा जो स्वसंवेद्य (साक्षिमास्य) तो हो पर वह उसे अन्य संवेद्य न बना सके । मा० ३.४ छं० .
अफल : वि० (सं। निष्फल, निरर्थक । 'अफल उपाय-कदंब ।' रा०प्र० ७.५.३
अब : अव्यय (सं० अतः>प्रा० अओ>अ० अउ>अव)।
अबर्त : सं० पुं० (सं० आवर्त)। भौं र, घुमावदार धारा, प्रवाह चक्र। मा०. २.२७६.३
अबल : वि० (सं०) । बलहीन, अशक्त । 'अबला अबल सहज जड़ जाती।' मा० ७.११५.१६
अबलनि : (१) अबल+सं००। (२) अबला+संब० । अबलों ने+ अबलाओं ने। 'हम अबलनि सब सही है।' कृ० ४२
अबलन्ह : अबलनि । अबलाओं (के) (+अबलों के) । 'अबलन्ह उर भय भयउ . बिसेषा ।' मा० १.६६.४
अबला : सं० स्त्री० (सं०) स्त्री (पुरुष की अपेक्षा में अल्प बल वाली)। मा०. ७.११५.१६
अबस : वि० (सं० अवश्य) । जो वश में न किया जा सके। 'अबसहि बस-करी।" मा० ३.२६ छं०
अबहि, अबही: अभी, इसी समय । मा० २.३४.७
अबहुं, अबहूं: अब भी, इस समय भी । 'तुम्ह अबहुं न जाना ।' मा० २.१६.२
अबाध, अबाथा: वि० पुं० । बाधारहित, अविच्छिन्न, अप्रतिहत । मा० १.३६ २
अबाधी : वि० स्त्री (सं० अबाधा)। दोषों से व्याहत न होने वाली, निर्बाध । मा० ७ ११६.६
अबासू : सं० पु० (सं० आवास)+कए । भवन । 'बिन रघुबीर बिलोकि अबासू ।' मा० २.१७६.६
अबिकारी : वि० (सं० अविकारिन् ) विकार रहित, माया के त्रिगुणात्मक परिवर्तनों से परे (वैष्णव मत में जगत् ब्रह्म का परिणाम है-विवर्त नहीं-परन्तु उस में वैसा विकारात्मक परिवर्तन नहीं आता जैसा कि दूध से दही में देखा जाता है । इस सिद्धांत को 'अविकत-परिणामवाद' कहते हैं-जैसे, जल हिम रूप में भी जल ही रहता है) 'अस प्रभु हृदयं अछत अविकारी।' मा० १.२३.७
_______________________________________________
37
अबिगत : वि० (सं० अ-विगत) जो कहीं भी विगत (रहित) न हो=सर्वव्यापी । 'अबिगत अलख अनादि अनपा ।' मा० २.६३.७
अबिचल : वि० (सं० अविचल) । स्थिर, अटल । मा० १.७६.४
अबिचारे : क्रि० वि० (सं० अविचारित) । बिना विचार किये हुए; सत्-असत की विवेचना किये विना (दे अनबिचार-रमणीय) । 'स्रग मह सर्प बिपुल भयदायक प्रगट होइ अबिचारे ।' विन० १२२.३
अबिछीन : वि० (१) (सं० अविक्षीण) जो क्षीण न हो, प्रचुर, अविरल, सघन, पुष्ट (२) (सं० अविच्छिन्न) अटूट, निरन्तर, अखण्ड, धारा प्रवाहवत् व्याप्त । "राम पद प्रीति सदा अविछीन ।' मा० ७.११६
अविद्यमान : वक (सं० अविद्यमान) असत्, सत्ताहीन । 'अर्थ अविद्यमान जानिय संसृति नहिं जाइ गोसाई।' विन० १२०.२
अबिद्या : सं० पु० (सं० अविद्या) व्यामोहिका माया, (सात्त्विक विद्या से भिन्न) राजस तथा तामस प्रकति जिसकी क्रमशः विक्षेप और आवरण शक्तियाँ हैं । आवरण से सत्य का बोध तिरोहित होता है और विक्षेप से असत् में सत् का आरोप होता है-जैसे रज्जु में सर्प का बोध हो तो रज्जुबोध तिरोहित हो जाता और सर्प ( असत्) का बोध हो चलता है। मा० ३.१५.३-४
अबिद्या पंथ : राग, द्वेष, अस्मिता, अभिनिवेश सहित अविद्या का योग-शास्त्रीय पञ्चका । मा० ७ । उपसंहार अविद्या पंच जनित विकार भी रघुपति हैं ।
अविनय : सं० (सं० अविनय) । अशिष्टता, दुराग्रह, धृष्टता। 'छमबि देबि बड़ि अबिनय मोरी।' मा० २.६४.६
अबिनासिनि : वि० स्त्री० (सं० अविनाशिनी) कभी नष्ट न होने वाली (आदि शक्ति) । मा० १.६८.३।
अबिनासिहि : अविनाशी तत्त्व को। मा० ७.३०.१
अबिनासो : वि. पु. (सं० अविनाशिन्) । अनश्वर, अनन्त । मा० १.१३.६
अबिबेक, का': सं० पुं० (सं० अविवेक) विवेकहीनता, सत् तथा असत् में अन्तर करने की शक्ति का अभाव । मा० १.१५.२
अबिबेकी : वि० । विवेकहीन । मा० २.१४.२
अबिबेकु : अबिबेक+कए । एक (विचित्र) अविबेक, अद्वितीय नासमझी। 'देखहु मुनि अबिबेकु हमारा।' मा० १.७८.७
अबिरल : वि० (सं० अविरल) सधन, अधिक, संहत, प्रचुर । रति होउ अविरल ।' मा० २.७५ छं०
अबिरोधा : वि० (सं० अविरोध)। विरोध-रहित, अनुकूल, निविरोध । 'समय समाज धरम अबिरोधा।' मा० २.२६६.३
38
_______________________________________________
अबिहित : वि० (सं० अविहित) । शास्त्रीय अथवा लौकिक मर्यादाओं के विपरीत, अनुचित, अनर्गल, विधानविरुद्ध । मा० १.११६.५ [धर्मशास्त्रीय विधीविधान वाले कर्म विहित हैं, शास्त्रीय निषेध वाले कर्म अविहित हैं आधुनिक अवधी में 'अबिति' चलता है ।]
अबीर : सं० पू० (सं० आवीर) अभ्रक मिलाकर बनाया हआ रंगीन चर्ण विशेष । [अजीर के पत्ते को 'आवीर चूर्ण' कहा गया है अत: अनुमान होता है कि अबीर की रचना में इस पत्ते का योग कभी अवश्य रहा होगा। मा० १.१६५.५
अबीरनि : अबीर+संब० । अबीरों (से) । गी० ७.२१.२२
अबुझ : (१) अबुध । नासमझ, बोधहीन, मूढ़ (२) वि० (सं० अबोध्य >प्राo. अबुज्झ) अज्ञेय । 'तेरे ही बुझाये बुझे अबुझ बुझाउ सो।' विन० १८२.५
अबुध : वि० (सं०) । अज, मूढ, बोधहीन । मा० १.२७४.२
अबूझ, अबूझा: अबुझ । बुद्धिहीन, अबुध, मूढ+अबोध्य, अज्ञेय । 'अजहुं न बूझ अबूझ ।' मा० १.२७५ 'तिमिधाए मनुजाद अबूझा ।' मा० ६.४०.१०
अब्ज : सं० पुं० (सं०) । कमल । मा० ७ श्लोक १
अब्यक्त : अव्यक्त । (१) मूल प्रकृति । 'अब्यक्तमूलमनादि तरु।' मा०. ७.१३ छं० ५ (२) ब्रह्म। 'कोउ ब्रह्म निर्गुन ध्याव । अब्यक्त जेहि श्रुति गाव ।' मा० ६.१३ छं०७
अब्याहत : वि० (सं० अव्याहत)। व्याघात-रहित, निर्बाध, अप्रतिहत, बेरोक।  'अव्याहत गत संभु प्रसादा ।' मा० ७.११०.१२
अभंग, अभंगा: वि० (सं० अभङ ग) । अविच्छिन्न, अखण्ड, निरन्तर । 'प्रीति अभंगा।" मा० ३.१३.११
अभंगू : अभंग+कए । अटूट, हठ । 'मिटइ न मलिन सुभाउ अभंगू।' मा० १७.४
अभय : वि० (सं.)। भय रहित, निर्भय । मा० ४.४.३
अभाम : अभाग्य । भाग्यहीनता, दुर्भाग्य । ‘मोर अभाग उदधि अवगाह ।' मा.. .. २२६१.५
अभागा : वि० पु । भाग्यहीन । 'गएहुं न मज्जन पाव अभागा ।' मा० १.३६.२
अभागिनि : अभागी (स्त्री) । मा० २.५७.६
अभागी: वि० (१) पु० । भाग्यहीन । 'अग्य अकोबिद अंध अभागी।' माल १.११५.१ (२) स्त्री० । भाग्यहीना । मा० २.५१.२
अभागु : अभाग+कए। एकमात्र दुर्भाग्य । 'मोर अभागु मातु कुटिलाई।' मा०. ... २.२६७४
अभागे : अभागे ने । 'तउ न तजा तन प्रान अभागे।' मा० २.१६६.६ hch
_______________________________________________
39
अभागे : 'अभागा का रूपान्तर (१) बहु० । 'करहिं न प्रान पयान अभागे।' मा० २.७६.६ (२) सम्बो० ए० । 'ताते परबस परयो अभागे। विन० १३६.३
अभागो : अभागा+कए । कवि० ७.१५
अभाग्य : सं० पु० (सं.)। भाग्यहीनता, दुर्भाग्य । मा० ६.६६.६
अभारू : सं० पुं० (सं० आभारः) कए। भारी बोझ, उत्तरदायित्त्व तथा उपकार का भार । 'नाथ दीन्ह सबु मोहि अभारू ।' मा० २.२६६.३
अभास : आ० प्रए (सं० आभासते>प्रा० आभासइ) भासित होती है, प्रतीत होता है। 'सोइ स्यामता अभास ।' मा० ६.१२
अभिनंतर : अभ्यंतर । 'अभिअंतर मल कबहुं न जाई ।' मा० ७.४६.६।
अभिजित : सं० ० (सं० अभिजित) महर्त विशेष जो मध्याहन और मध्य रात्रि को दो घड़ी का माना गया है [अभितो जयति इति अभिजित' व्युत्पत्ति के अनुसार विजेता को भी 'अभिजित्' कहा जाता है अतः अभिजित् मुहूर्त में उत्पन्न बालक विजेता होता है, ऐसी मान्यता है । राम इसी मुहूर्त में हुए थे। मा० १.१६१.१
अभिनंदनु : सं० पु० कए (सं० अभिनन्दनम्) । विनययुक्त अनुमोदन, स्वागतपूर्ण समर्थन । 'गुर के बचन सचिव अभिनंदनु ।' मा० २.१७६.७
अभिमत : (१) सं+वि० पु. (सं०) । अभीष्ट, मनचाहा, इष्ट वस्तु । 'राम नाम कलि अभिमत दाता ।' मा० १.२७.६ (२) मनोरथ । 'अभिमत बिरखें परेउ जनु पानी ।' मा. २.५.६ ।। अभिमान
(ना) : सं० पु० (सं.)। अहंकार । मा० १.३६.३
अभिमानी : वि० । अहंकारी । मा० १.१२१.६
अभिमानु: अभिमान+कए। अद्वितीय अभिमान । 'अति अभिमान हृदयं तब आवा ।' मा० १.६०.७
अभिरक्षय : आ०-अभ्यर्थना-मए (सं०) तू रक्षा कर । 'मामभिरक्षय रघुकुल नायक । 'मा० ६.११५.१
अभिराम : वि० (सं०) अभितः=सब ओर रमण =आनन्द देने वाला। मनोरम, सर्वथा रमणीय, सुन्दर । मा० १.७५
अभिरामा : अभिराम । मा० ७.५३.४
अभिरामिनी : वि० स्त्री० । पूर्ण आनन्द-दायिनी। अति मनोरम 'अभिरामिनी जामिनि भई ।' गी० १.५.३ .
अभिलाष : सं० पुं० (सं.).। कामना, इच्छा, मनोरथ । मा० १.१४४.३
अभिलाषा : अभिलाष । मा० १.८५.१
अभिलाषिहि : आ० भ० प्रए । अभिलाष करेगा, चाहेगा। ‘अस सुकृती नरनाहु जो मन अभिलाषिहि । सो पुरइहि जगदीसु ।' जा० मं० ७६

_______________________________________________
40.
अभिलाषी : वि० । अभिलाष युक्त । इच्छुक । मा० २.२४४.२
अभिलाषु : अभिलाष+कए । एक ही इच्छा । 'सब के उर अभिलाषु'- २.१
अभिलाषे : क्रि० वि० । अभिलाष किये हुए स्थिति में । 'नृप सब रहहिं कृपा अभिला।' मा० २.२.३
अभिलाषे : भू० कृ० पु. (बहु०) अभिलाष युक्त हुए। 'सुनि पन सकल भूप अभिलाषे।' मा० १.२५०.५
अभिषेक : सं० पू० (सं.) (१) नहाना या नहलाना, पूर्णतः स्नान कराना। 'सिव अभिषेक करहिं बिधि नाना ।'२.१५७.७ (२) राज्याभिषेक-सिंहासन पर आसीन होने का विशेष संस्कार जिसमें तीर्थ-जल से स्नान कराया जाता है। मा० २.५ ; ३.६.४
अभिषेकतः : क्रि० वि० (सं०) । अभिषेक से । मा० २१ श्लोक २
अभिषेक, अभिषेक: अभिषेक-+कए। मा० २.८; २.१०.७
अभीष्ट : वि०+सं० (सं०) सर्वथा इष्ट, पूर्णतया मनचाहा । 'अति अभीष्ट बर पाइ।' मा० ७.३५
अभूत : वि० (सं.)। जो न हुआ हो। अपूर्व, अद्भुत । 'उपमा एक अभूत भई तब।' गी० १.२६.६
अभूतरिपु : (१) वि (सं०) जिस के शत्रु न हुए हों। अजातशत्र । सर्वथा शत्रुहीन । . (२) भूतों प्राणियों का जो शत्रु न हो । निर्वैर । सर्वथा वैर-रहित । 'सम अभूतरिपु बिभद विरागी।' मा० ७.३८.२
अभेद : वि० (१) (सं० अभेद्य)। जिसका किसी प्रकार भेदन न किया जा सके। 'कवच अभेद बिप्र गुर पूजा।' मा० ६.८०.१० (२) (सं० अभेद)। भेद रहित, अद्वैत निर्विकार, जिससे पृथक् कोई सत्ता न हो । 'अज अकल अनेह अभेद ।' मा० १.५०
अभेदबादी : वि० पुं० (सं० अभेद-वादिन) जीव और जगत् से ब्रह्म को तथा ब्रह्म से जीवजगत को भिन्न न मानने के सिद्धान्त के प्रतिपादक । अद्वैतवादी । विवर्त सिद्धान्त के आधार पर सष्टि की व्याख्या करने वाले। 'तेइ अभेदबादी ग्यानी नर।' मा० ७.१००.२ शाङ्करवेदान्त पूर्ण अभेदवादी है; माध्ववेदान्त पूर्ण द्वैतवादी तथा शेष वैष्णव वेदान्त भेदाभेद या द्वैताद्वैत मान्य करते हैं-जैसे रामानुज अंशरूप जीवजगत् की पृथक् सत्ता स्वीकृत करके भी अंशी ब्रह्म से अभेद मानते हैं। गोस्वामी जी ने निर्गुण मतवादी के लिए इस शब्द का प्रयोग किया है।
अभेरा : सं० पुं० । मुठभेड़, भिड़न्त, टकराव, धक्कमधक्का । विन० १८६.३
अभोगी : वि० ० (सं० अभोगिन्) । भोग-वासना-रहित, मुक्त । 'अज अनवद्य अकाम अभोगी।' मा० १.६०.३
_______________________________________________
41
अभ्यंतर : वि० (सं० आभ्यन्तर) भीतरी, आन्तरिक, (मानसिक) । 'बाहिर कोटि उपाय करिअ अभ्यंतर ग्रंथि न छूट ।' विन० ११५.१
अभ्यास : सं० ० (सं.)। एक ही कार्य को बार-बार निरन्तर करते रहने की प्रक्रिया; उस प्रक्रिया से बनी हुई मानसिक वासना । 'जनम-जनम अभ्यास निरत चित अधिक-अधिक लपटाई।' विन० ८२.१
अमंगल : मंगल का अभाव या मंगल-प्रतिकूल स्थिति । मा० १.२६.१
अमर : (१) वि० (सं०) जो मरता न हो, मृत्युजयी । 'अजर अमर सो जीति न जाई ।' मा० १.८२.७ (२) सं० (सं०) देवजाति । 'सब अमर हरष सुमन बरषि ।' मा० १.१०२ छं०
अमरउ : अमर भी। न मर सकता हो, उसे भी । 'सकउँ तोर अरि अमरउ मारी।' मा० २.२६.३
अमरताँ: अमरत्व के कारण, अमर करने की प्रकृति से । 'सुधा सराहिअ अमरता।' मा० १.५
अमरपति : देवराज-इन्द्र । मा० २.१७४
अमरपद : अमरों-देवों का पद; मत्यहीन स्थिति-अमरत्व । 'अभिब अमरपद माहुरु मीच ।' मा० २.२६८.६
अमरपुर : स्वर्ग, देवलोक । मा० २.१४१
अमरष : सं० पु. (सं० अमर्ष) रोष, असहिष्णुता । मा० ७.३८.२
अमरषत : वकृ पुं० । रोष करता-ते। 'बारहिं बार अमरषत करषत करके परी ___सरीर ।' गी० ५.२२.८
अमरषा : भू० कृ० पु० । अमर्ष-युक्त हुआ, क्रुद्ध हुआ । 'को कर अटक कपि कटक अमरषा।' कवि० ६.७
अमरावति : सं० स्त्री. (सं० अमरावती) इन्द्र की नगरी, स्वर्गपुरी। मा० १.१५२८
अमरावतिपालू : (दे० पालु) इन्द्र । मा० २.१६६.७
अमल : वि० (सं०) निर्मल, निष्कलुष । मा० १.४२.७
अमा, अमाइ, ई : (सं० माति, आमाति,>प्रा० माइ, आमाइ-समाना, सीमा में आ जाना) आ० प्रए० । अमाता है । 'प्रेम उमंग न अमाइ।' रा०प्र० ४.४.१ 'हृदय न अति आनंदु अमाई ।' मा० १.३०७.४
अमात : वकृ० पु० (सं० मात्>प्रा० माअंत) समाता-ते । 'हृदयें न प्रेमु अमात ।' मा० १.२८४
अमान : वि० (सं.) (१) मान-प्रमाण+परिमाण से रहित, अमेय, अप्रमेय, अज्ञेय । 'मानद अमान' विन० ४२.३ (२) प्रमाण+आत्म सम्मान से रहित । 'अगुन अमान मातु पितु हीना ।' मा० १.६७.८ (३) अभिमनरहित । 'तीसरि भगति अमान ।' मा० ३.३५ (४) आदर से रहित, सम्मान के अयोग्य । 'अगुन अमान जानि तेहि दीन्ह पिता बनबास ।' मा० ६.३१ क
अमाना : अमान । अप्रमेय, अनिवचनीय। मा० १.१६२ छं०
अमानी : वि० (सं.) । जो मानी अभिमानी न हो। निरहंकार । मा० ७.३८.४
अमानुष : वि० (सं०)। मानुषशक्ति से परे, लोकोत्तर । 'सकल अमानुष करम तुम्हारे ।' मा० १३५७६
अमाया : वि० (सं० अमाय) । निर्माय-माया रहित । निश्छल । 'मुदिता मम पद प्रीति अमाया।' मा० ३.४६.४
अमाये : भू० कृ. पु । समाया, समाये । 'मुदित मगन आनंद न अमाये ।' गी० १.३२.६
अमायो : भू० क० पुं० कए। समाया। 'उर प्रमोद न अमायो।' गी० १.१७.४
अमिअँ : अमृत से, अमृत में [सं० अमृतेन, अमृते>प्रा० अमिएण>अ० अमिएँ] ।  'बोले गिरा अमिों जनु बोरी।' मा० १.३३०.५
अमिअ, अमिय: सं० पु० (स० अमृत>प्रा० अमय =अमिअ) । अमरता देने वाला देवों का पेय विशेष । मा० १.१.२
अमित : वि० (सं०)। अपरिमित, असंख्य, अपरिमेय, मिति सीमा से परे ।  मा० १.१२.१२
अमितबोध : वि० (सं०) असीम ज्ञान से सम्पन्न । मा० ३.४५.८
अमिति : अमित । मिति परिमाण से रहित । अत्यन्त । 'सुनि मैं नाथ अमिति सुख पावा ।' मा० ७.५३.७
अमिय : अमिअ । गी० १.१४.१
अमी : अमिअ । 'कालकट फल दीन्ह अमी को।' मा० १.१६.८
अमृत : अमिअ। मा० २.४२.३
अमृतु : अमृत+कए। अमर बनाने वाला पेय । 'अमृतु लहेउ जनु संतत रोगी।' मा० १.३५०.६
अमृषा : अमिथ्या, सत्य । मा० १ श्लोक ६
अमोघ : वि० (सं.)। जो मोघ-निष्फल न हो। अव्यर्थ, सदा सार्थक, अवश्य कार्यकारी । जिमि अमोघ रघपति कर बाना।' मा० ५.१.८
अमोघसक्ति : वि० (सं० अमोघशक्ति) अमोघ शक्ति से सम्पन्न । मा० ७.७२.४
अमोल : वि० (सं० अमूल्य>प्रा० अमोल्ल) अमित मूल्य वाला (जिसका मूल्य न __लगाया जा सके)। मा० २.१.४
अमोले : अमोल (बहु०) । 'देखि प्रीति सुनि बचन अमोले ।' मा० १.१५०.१
अय : सं० पु० (सं० अयस्) । लोहा । 'अय इव जरत धरत पग धरनी।' मा० १.२६८.५
_______________________________________________
अयं : सर्व०. पु. कए (सं० अयम्) यह । 'पापौघमय तव तन अयं ।' मा० ६.१०४. छं.
अयन : सं० पु० (सं.)। (१) आगार, भवन । 'करुना अयन' मा० १.० दो० ४ (२) स्थान, माश्रय । 'नयननि अयन दये।' गी० १.६३.५ (३) सूर्यगति के अनसार खगोल के दो भाग--उत्तरायण तथा दक्षिणायन । 'दिनमति गवन कियो उतर अयन ।' गी० १.५१.३
अयना : अयन । आगार । 'सकल गुन अयना ।' मा० १.२०६.८
अयमय : वि० (सं० अयोमय) । लोह, लोहनिर्मित । 'अयमय खाँड़ न ऊखमय ।' मा० १.२७५
अयान : वि० पु० (सं० अज्ञ>प्रा० अयाण) मढ़। 'कहै सो अघम अयान असाधू ।' मा० २२०७.७
अयानप : सं० पुं० । अज्ञता, मूढता । विन० २६२.४
अयानपन : अयानप (सं० अज्ञत्व>प्रा० अयाणत्तण>अ० अयाणप्पण) । मढ़ता ।
अयानी : वि० स्त्री० । मूढाः । मा० १.१२०.४
अयाने : (१) 'अयाना' का रूपान्तर (बहु०) । (२) सम्बो० एक० । हे मढ़ ।  'भजहि व अजहुँ अयाने ।' विन० २३६.४
अयान्यो: अयाना+कए। विन० ६२.२
अयुत : संख्या (सं०) दस सहन । मा० ७.१०७.३
अरँंडु़ : सं० पु. कए (सं० एरण्डम् >अ० एरंड) रेडं का वृक्ष। 'सेवहिं अरॅड. __ कलपतरु त्यागी।' मा० २.४२.३
अरंभ, अरंमा: सं० पु० (सं० आरम्भ) प्रारम्भ (श्रीगणेश, सूत्रपात)। मा० ७.६३.५; १.३५.६
अरंभेउ : भू०० पू० कए । आरम्भ हुआ । 'अन रथु अवध अरंभेउ जब तें।' मा० २.१५७.५
अरगजाँ : अरग्रजा से । 'गली ँ सकल अरगजाँ सिंचाई।' मा० १.३४४.५
अरगजा : सं० पु० (फा० अरगजः) एक सुगन्धित द्रव पदार्थ जो चन्दन, गुलाब, कपूर, कस्तुरी और चमेली-तेल के मिश्रण से बनता है। गी० १.१.८
अरगाइ, अरगाई: पूकृ० । (१) अलग करके, निवारण कर, हटा कर । 'गह सिसु बच्छ अनल अहि धाई। तह रखइ जननी अरगाई ॥' मा० ३.४३.६ (२) अलग रह कर चुप या उदासीन होकर । 'अस कहि राम रहे अरगाई ।' मा० २.२५६८
अरगानी : भू०० स्त्री० । वार्ता से अलग हुई, चुप । 'अब रहु अरगानी ।' मा० २.१४.७
_______________________________________________
44
अरघ : सं० पु. (सं० अर्घ्य अभ्यागत स्वागत-सम्मान में भेंट किया जाने वाला पात्र जिसमें जल, फूल, फल आदि की सामग्री रहती है । षोडशोचार पूजन में यह प्रथम है । 'अरघ पाँवड़े देत ।' मा० १.३४६
अरघान : अरघ+संब० । अर्यो (से) । 'हरषत अरनि भान ।' दो० ४५५
अरघु : अरध+कए । 'करि आरती अरघु तिन्ह दीन्हा ।' मा० १.३१६.४ (सम्पूर्ण पूजा-सामग्री से तात्पर्य है)।
अरण्य : सं० पु० (सं.)। वन । मा० १ श्लोक ४
अरति : सं० स्त्री. (सं.) बेचैनी, उल्लासहीनता की मनोदशा । मा० २.२६५
अरथ : सं० पु० (सं० अर्थ) । (१) काव्यार्थ । 'आखर अरथ अलंकृति नाना।' मा० १.६.६ (२) शब्द का सामान्य अर्थ । गिरा अरथ' मा० १.१८ (३) चार पुरुषार्थों में से एक। 'धरम अरथ कामादिक चारी।' मा० २.३७.६ (४) आशय, गूढ तात्पर्य । 'कहहु नाम कर अरथ बखानी।' मा० १.१६२.८
अरथु : अरथ+कए । 'अरथु अमित अति आखर थोरे।' मा० २.२६४.२
अरष : (१) वि० सं० पु० (सं० अर्ध) एक वस्तु का समान भार । 'तनु अरध भवानी।' मा० १.२४७.५ (२) आधा कछ भाग । 'अरध निमेष' मा० २७०.८
अरधंग : सं० पू० (सं० अर्धाङ) शरीर का आधा भाग। 'सदा संभ अरधंग निवासिनि ।' मा० १.६८.३
अरनी : सं० स्त्री० (सं० अरणि) । पवित्र लकड़ी जिसे घिस कर यज्ञ हेतु अग्नि उत्पन्न की जाती है । 'पुनि विवेक पावक कहुँ अरनी ।' मा० १.३१.६
अरप : सं० ० (सं० अर्प) । अर्पण, दान । 'जो संपति दससीस अरप करि रावन सिव पहिं लीन्ही ।' विन० १६२.३
अरबिंद : अरविन्द ।
अरबिंदु : अरबिंद+कए । 'अरबिंदु सो आननु ।' कवि० १.२
अरबिन्द : सं० पु० (सं०) । कमल । मा० ७.१०८.१३
अराती : सं० पु० (सं० अराति) । शत्रु । मा० १.१६०.७ ।।
अरि : (१) सं० पु० (सं०) । शत्रु । मा० १.२७१.३ (२) सं० स्त्री० (सं० आली =श्रेणी पंक्ति, समूह । महाबिषु ब्याधि दवा-अरि घेरे ।' कवि० ७.५०
अरिन्ह : अरि+संब० । शत्रुओं । 'अरिन्ह को कोटि कृसानु है ।' गी० ५.३५.३
अरिमर्दन : (१) वि० शत्रुओं का विनाश करने वाला । (२) सं० पु० । राजा भानु प्रताप का अनुज । मा० १.१५३.६
अरिष्ट : सं० पू० (सं.)। शत्र, अनिष्ट ग्रह, पापग्रह-शनि आदि, कष्ट या कष्ट कारी ज्योतिषयोग । रा०प्र० ३.३.४
अरिहि : शत्रु को । 'जासु सुभाउ अरिहि अनुकूला।' मा० २.३२.८
_______________________________________________
45
अरिहुक : शत्रु का भी । 'अरिहुक अनभल कीन्ह न रामा।' मा० २.१८३.६
अरी : अरि । मा० ७.१४.१८
अरु : अव्यय (सं० अपरम्>प्रा० अवंर>अ० अवरु) और । 'पिता अरु माता।' मा० १.७३.८
अरुंधती : बसिष्ठ की पत्नी का नाम । मा० २.१८७.५
अरुझा, अरुझाइ, ई : (सं०आरुध्यते>प्रा० आरुज्झइ-उलझना, संपृक्त होना, सुलझाव न मिलने वाला गुथना) आ० प्रए। उलझता है, उलझती है । 'छूट न अधिक अरुझाई।' मा० ७.११७.६
अरुझानी : भू० कृ० स्त्री० । उलझी, लिपटी, गुथी हुई। 'बिटप बिसाल लता अरुझानी।' मा० ३.३८.१
'अरुझान्यो : भू०० पु० कए। गुथ गया, उलझ-लिपट गया। 'विषम जाल  अरुझान्यो ।' विम० ८८.२
अरुझि : (१) पूकृ० । उलझकर । (२) सं० स्त्री० । उलझन । 'करत :न प्रान पयान सुनहु सखि, अरुझि परी यहि लेखे ।' गी० २.५३.३
अरुन : (१) वि० (सं० अरुण) । लाल, रक्तवर्ण । मा० १.१०६.७ (२) सं० का सारथी जो उषा की लाली के रूप में उदित माना गया। (३) सूर्य का एक नाम । 'उभउ अरुन अवलोकहु ताता ।' मा० १.२३८.७
अरुनचूड़ : सं० पुं० (सं० अरुणचूड़ताम्रचूड़) । कुक्कुट, मुर्गा । मा० १.३५८.५
अरुनतर : वि० (सं० अरुणतर) । अतिशय रक्तवर्ण । गी० ७.१२.६
अरुनमय : वि० । प्रभात की अरुणाभा से ओतप्रोत । 'मान तिमिर अरुनमय रासी।' मा० २.२३७.५
अरुनसिखा : अरुनचूड (सं० अरुणशिख)। मा० १.२२६
अरुनारी : सं० स्त्री० (सं० अरुणाली)। अरुण की पक्ति ।
उष:काल की लाल आभा की रेखा । 'अड़त अबीर मनहुँ अरुनारी।' मा० १.१६५.५
अरुनारे : वि० पु (बहु०) । अरुणाभ, लाली लिए हुए, रक्तवर्ण 'अधर अरुनारे ।' मा० १.१९६.८
अरुनोदयं : अरुणोदय-काल में, उषाकाल में । 'अरुनोदय सकुचे कुमुद ।' मा० १.२३८
अरुनोपल : (अरुन+उपल) । लाल पत्थर । मा० ६.४०.६
अरूप : वि० (सं.)। रूपरहित, निराकार । मा० १.१३ ३
अरूपा : अरूप । मा० १.४१.२
अरे : (१) अव्य० सम्बोधनार्थक (सं.)। (२) भू० कृ० पु । उड़ गए, डटे गये, दृढता के साथ स्थिर हए । 'बिरुझे बिरुदैत जे खेत अटे।' कवि० ६.३४
अरोष : वि० (सं.)। रोषरहित । मा० ७.४६.६

_______________________________________________
46
अर्क : सं० पु० (सं०) (१) सूर्य (२) मदारकक्ष । 'अर्क जबास पात बिनु भयऊ ।' मा० ४.१५.३
अर्चि : (१) पूक० । अर्चन करके, पूजकर । विन० १०.६ (२) सं० स्त्री० (सं० अचिष्) अग्निशिखा, दीपशिखा-लो, आँच; तेज की किरणें । विन० ५३.६
अर्थ : (अरथ) । (१) पुरुषार्थ चतुष्टय में अन्यतम । कवि० ७.१५८ (२) पदार्थ, विषयवस्तु । 'अर्थ. अविद्यमान जानिऊ संसति नहिं जादू गोसोई ।' विन० १२०.२
अर्थसंघ : विविध अर्थों का समवाय; काव्य में वाच्य, लक्ष्य, व्यङग्य अर्थों का संश्लिष्ट बिम्ब । मा० १ श्लोक १
अर्ध : वि०+सं० (सं०) । समान भाग आधा । 'अर्ध भाग कौसल्यहि दीन्हा।' मा० १.१६०.२
अर्धंग : अरधंग। कवि० ७.१४६
अर्धनिसि : आधी रात, मध्यरात्रि में। 'इहाँ अर्धनिसि रावन जागा।' मा० ६.१००.७
अर्धांग : अर्धग । विन० १०.२
अर्पा : अर्पित । सौंप दिया। 'विस्व प्रसिहि जनु एहि बिधि अर्पा।' मा० ६.६७.५
अर्पित : भूकृ० (सं.)। समर्पित, प्रदत्त । मा० १.१५६.२
अर्बुदै : संख्या (सं० अर्बुद) । अरबों में । 'सैन के कपिन को गर्न अबुदै ।' __कवि० ६.२०
अर्भक : सं० पु. (सं०) । छोटा बच्चा, क्षीण, कृश शिशु । 'गर्भन्ह के अर्भक दलन ।' मा० १.२७२
अर्वाक् : वि० (सं.) अर्वाचीन (प्राचीन का विलोम), अपेक्षाकृत बाद का, अवर । . विन० ५४.७
अलंकृत : भू० ० (सं.)। विभूषित, सुसज्जित, अङ्गारित । मा० १.२६६.६
अलंकृति : सं० स्त्री० (सं०) । अलंकार = आभरण+काव्यालंकार । 'आखर अरथ अलंकृति नाना ।' मा० १.६.६
अलंपट : जो लम्पट न हो । परस्त्री-परधन आदि से विमुख । मा० ७.३८.१
अलक : सं० पु० (सं०) । घुघराले केश । 'चिक्कन कुटिल अलक अवली छबि० ।' कृ० २१
अलकावली : (अलक+आवली)। अलकों की श्रेणी। केशकजाप । 'गमुआरी अलकावली ।' गी० १.२२.७
अलकैँ : अलक+बहु० । गी० १.२३.२
_______________________________________________
47
अलख : वि० (सं० अलक्ष्य>प्रा० अलक्ख)। जो लक्षित न हो, देखा न जा सके; जिसका लक्षण (स्वरूप) न किया जा सके; अदृश्य, अप्रमेय । 'अबिगत अलख अनादि अनूपा ।' मा० २.६३.७
अलखगति : वि० (सं० अलक्ष्यगति) अदृश्य गति वाला, व्यापक तत्त्व जिसका लक्षण या दर्शन न किया जा सके । अदृश्य होकर चलने वाला। 'की अज अगुन अलखगति कोई ।' मा० १.१०८.८
अलखित : वि० (सं० अलक्षित) अदृश्य, न देखा हुआ, न देखी हुई । 'कबि अलखित गति बेषु बिरागी।' मा० २.११०.८
अलखु : अलख+कए । अदृश्य तत्त्व । 'ब्यापकु ब्रह्म अलखु अबिनासी।' मा० १.३४१.६
अलच्छि : सं० स्त्री० (सं० अलक्ष्मी>प्रा० अलच्छी)। निर्धनता, अकिंचनता, दरिद्रता । मा० १.६.७
अलप : वि० (सं० अल्प)। थोड़ा, लेशमात्र, यत्किचित । 'ताते मैं अति अलप बखाने ।' मा० १.१२.३
अलसात : वकृ० पु । आलस्यपूर्ण शिथिलता की चेष्टाएँ करता-करते । गी० १.१६.४
अलसातो : क्रियाति० पु. एक० । यदि आलस्य करता........'जपत जीह रघुनाथ को नाम नहिं अलसातो। बाजीगर के सूम ज्यो खल खेह न खातो॥' विन० १५१.२
अलसी : वि० पु । आलसी, अकर्मण्य । कवि० ६.७१
अलरन : सं० पु० (सं० आलान)। हाथी बाँधने का खम्भा या बँटा । मा० २.५१
अलायक : (सं० अ-+अरबी-लायक) । नालायक, अयोग्य । विन० १४५.६
अलि, अली : (१) सं० स्त्री० (सं० आली) । सखी, सहेली। 'सिय सहित हिये हरषित अली ।' मा० १.२३६ छं० (२) (सं० आलि)। श्रेणी, पंक्ति, समूह । (३) सं० पु. (सं० अलि)। भ्रमर । 'अलिगन गावत नाचत मोरा।' मा० २.२३६.७
अलिगिनी : अलिनि (संभवतः 'अलिगण' से बनाया हुआ स्त्री० शब्द)। 'मंद मंद गुजत हैं अलि अलि गिनी ।' गी० २.४३.३
अलिनि : सं० स्त्री० । भ्रमरी। मा०१.२५६.१
अलीँ  : 'अली'+ब० । अलियां, सखियाँ । 'प्रेम न जाइ कहि, जानहिं अली ।' _ मा० १.२३७ छं. ३
अलीक : वि.सं० (सं०) । मिथ्या, असत्य । मा० ६.२५.८
अलीका : अलीक । मा० २.२१६.६
48
_______________________________________________

अलीहा : वि० (सं० रेखा>प्रा. लीहा) । रेखा-हीन, निमल, निराधार (रेखा रहित चित्र के समान व्यर्थ) । मिथ्या, कपोल कल्पित । 'एक कहहिं यह बात अलीहा।' मा० २.४८.७
अलुज्झि : पूकृ० । उल झकर, उलझाकर । 'खप्परिन्ह खग्ग अलुज्झि जुज्झहिं ।' मा० ६.८८ छं०
अलेख : (१) वि० (सं.) लेख-रहित या लेखारहित । शून्य, वह जिसका उल्लेख न हो, अद्भुत । (२) (सं० अलेख्य)। अकथ्य, अनिर्वचीय, उल्लेख के. अयोग्य । (३) सं० पु० (सं० आलेख)। चित्र । ‘भए अलेख सोचबस लेखा।' २.२६४.८
अलेखी : अलेख । अकथ्य, विचित्र । 'बड़े अलेखी लखि परें ।' विन० १४७.५
अलेप : वि. (सं.)। लेपरहित, निलिप्त, अनासक्त, निष्काम, वासनादि मलों से .  रहित । 'अगुन अलेप अमान एकरस ।' मा० २.२१६.६
अलोने : वि० पु बहु० (सं० अलवण>प्रा० अलोण)। लवणरहित । 'जस सालन साग अलोने।' विन० १७५.४
अलोला : वि० (सं० अलोल)। अचञ्चल, स्थिर, लोभ तथा वासना से रहित होकर एकाग्र । 'नाथ कृपा मन भयउ अलोला ।' मा० ४.७.१५
अलौकिक : (१) (दे० लौकिक) । लौकिक हिताहित से परे, लोकोत्तर । 'अकथ अलोकिक तीरथराऊ ।' मा० १.२.१३ (२) विलक्षण, अद्भुत-जो लोक प्रसिद्ध व्यवहार की व्याख्या में न बँधता हो । 'असि सब भांति अलौकिक करनी।' गी० १.११८.८ (३) लोक में जो अन्यत्र न दिखाई दे। 'जासु बिलोकी अलौकिक सोभा ।' मा० १.२३१.३
अल्प : वि० (सं०) । तुच्छ, क्षुद्र, छोटा (थोड़ा-सा)। 'रावन नगर अल्प कपि दहई ।' मा० ६.२३.८
अल्पमृत्यु : सं० स्त्री० (सं०) । अल्पायु वाली मृत्यु, अकालमृत्यु [दीर्घायु, मध्यायु और अल्पायु ये तीन आयुर्दाय होते हैं । ४० वर्ष से कम वय वाली आय अल्पायु है और उसमें मृत्यु को 'अल्पमृत्यु' कहा जाता है] । मा० ७.२१.५
अवँराई : अंबराई । आम्रवण, बगीचा । 'संतसभा चहु ँ दिसि अर्वराई ।' मा० १.३७.१२
अवकलत : वकृ० पु । सूझता, विचार में आता, तर्क में बैठता । 'मोहि अवकलत उपाउ न एक ।' मा० २.२५३.२
अवकास : सं० पु० (सं० अकाश)। रिक्त स्थान, अन्तराल । 'कोउ अवकास कि नभ बिनु पावइ।' मा० ७६०.३ [दो मुर्त द्रव्यों के बीच का अन्तर अवकाश है, जिसका कारण अथवा आश्रय आकाश है।]
अवकासा : अवकास । 'नभ सत कोटि अमित अवकासा।' मा० ७.६१.८ .
_______________________________________________
49
अवगाहत : वक० पु । थहाते हुए । विन० १२२.४
अवगाहन्ति : आ० प्रब० (सं०) । थाह लेते हैं, मज्जन करते हैं । मा० ७.१३० श्लोक २
अवगाहहिं : अवगाहन्ति । स्नानार्थ प्रवेश करते है। जे सर सरित रामु अवगाहहिं ।' मा० २.११३.६
अवगाहा : वि० (सं० अ+वगाह) । अथाह। 'उभय अपार उदधि अवगाहा ।' मा० १.६.१ (२) अशक्य, दुर्गम । 'तोरेहुँ धनुष ब्याहु अवगाहा ।' मा० १.२४५.६
अवगाहि, अवगाही: पूक ० अवगाहन करके, निभज्जन करके । 'भइ कबि बुद्धि बिमल अवगाही।' मा० १.३६.६
अवगाहु, अवगाहू: अवगाहा । 'प्रेम बारि अवगाहु सुहावन ।' मा० १.२६२.२
अवगाहैं : अवगाहहिं ! गी० ७.१३.२
अवगुन : सं० ० (सं० अवगुण) । दोष (गुण का विलोम)। मा० १.४.५
अवगुनन्हि : अवगुन+संब० । अवगुणों (को) 'गुन प्रगटइ अवगुनन्हि दुरावा ।' मा० ४.७.४
अवग्या : सं० स्त्री० (सं० अवज्ञा) । तिरस्कार, अनादर, अवहेलना, अवमानना। मा० ५.२६.५
अवघट : सं० पुं० (सं० अपघट्ट, अवघट्ट) । जलाशय का वह तट जिसमें चढ़ने उतरने की व्यवस्था न हो और गहराई अधिक हो । मा० ३.७.४
अवचट : क्रि० वि० (सं० अव+चट आवरणे) । आवरण रखे हुए, अनिच्छा से, बिना किसी लगाव के, उड़ती नजर से, सरसरे तौर पर । 'अवचट चितए सकल भुआला।' मा० ६.२४८.६ ।
अवटै : आ० प्रए० (प्रा० अट्टइ-सं० क्वथति) । पकाता है, पकाए, आग और पानी के गोग से परिपक्व करे । 'अवटै अनल अकाम बनाई।' मा० ७.११७.१३
अवडेरि : पूक० । बाहर करके, तिरस्कृत करके, निकाल कर । 'पुनि अवडेरि मराएन्हि ताही ।' मा० १.७६.८ [प्राकृत में 'द्वार' का रूपान्तर 'देर' होता है। 'सं० अपद्वार-गौण या छोटा द्वार>प्रा० अवदेर' से अपडेरना हिन्दी क्रिया की निष्पत्ति है अतः पिछले द्वार से निकालने जैसा मूल अर्थ है । निकालने या तिस्कृत करने का लाक्षणिक अर्थ चलता है।।
अवडेरिये : आ०-कवा-प्रए । द्वार से निकालिए, बाहर कीजिए । 'पोषि तोषि थापि __आपनो न अवडेरिये।' हनु० ३४ . .
अवडेरे : क्रि० वि० । अनादर के साथ, घर से बाहर करके । “बिधिहु सृज्यो अवडेरे ।' विन० २२७.२
50
_______________________________________________
अवढर : क्रि० वि० (सं० अबाक+द्रव>प्रा० अव+ढल-परि०)। नीचे को ढलकना या बहना, बेरोक द्रवित होना, अतिशय उदारतावश बिना विचार किये दान करना । 'आसुतोष तुम्ह अवढर दानी ।' मा० २.४४८
अवतंस : सं० पु० (सं०) आभरण । मा० २.६ ।
अवतंसा : अवतंस । 'भए प्रसन्न चद्र अवतंसा ।' मा० १.८८.६
अवतर, अवतरइ, ई : (सं० अवतरित>प्रा० अवतरह-अवतार लेना, जन्म ग्रहण करना) आ० प्रए । अवतार लेता है। निज इच्छाँ प्रभ अवतरह ।' मा० ४.२६
अवतरहि, अवतरही: आ० प्रब० । अवतार लेते हैं। मा० १.१४०.२
अवतरिहउँ : आ० भ० उए । मैं अवतार लूगा । 'परमसक्ति समेत अवतरिहउँ ।'  मा० १.१८७.६
अवतरिहि : आ० भ० प्रए । अवतार लेगी (लेगा)। 'सोउ अवतरिहि मोरि यह माया।' मा० १.१५२.४
अवतरी : भ०० स्त्री० । अवतीर्ण हुई । 'जगदंबा जहँ अवतरी।' मा० १.६४
अवतरेउ : भू० कृ० पु. कए। अवतीर्ण हुआ। 'जो अवतरेउ भूमि भय टारन ।' मा० १.१६.७
अवतरेहु : आ० भूक० पु+म० ब० । तुम अवतीर्ण हुए हो । 'धर्म हेतु अवतरेहु गोसाई।' मा० ४.६.५ ।।
अवतार : सं० पुं० (सं.)। परमेश्वर का जगत् में आकार ग्रहण करना अवतार है। ब्रह्मा, विष्णु और शिव आदि अवतार हैं जिनके माध्यम से ब्रह्म (राम) जगत् में अवतीर्ण होता है । उपासना की दृष्टि से आचार्य रामानुज ने अवतार के चार भेद किये हैं- (१) अर्चा=प्रतिभा, (२) विग्रह-नृसिंह, वामन, वराह आदि; (३) व्यूह =चतुव्यूह वासुदेव या नारायण, संकर्षण प्रद्युम्न और अनिरुद्ध - रामभक्ति दर्शन में राम, भरत, लक्ष्मण और शत्रुघ्न का चतुर्वृह मान्य है; (४) प्रत्यक् अथवा अन्तर्यामी जो सभी जीवों में व्याप्त रहकर प्रेरणा देता है। रामानुज के अनुसार-चारों का उत्तरोत्तर महत्त्व है, फलतः प्रत्यक् सर्वोपरि है, परन्तु प्रथम तीन से होकर ही प्रत्यक् की उपासना संभव मानी गई है। अत्याचार का दमन करने हेतु अवतारों की अनन्तता मान्य है जिनके चार प्रमुख भेद किए जाते हैं--(१) आवेशावतार-छोटे मोटे अनाचार के विरुद्ध किसी व्यक्ति में भगवान् का आवेश हो सकता है। (२) प्रवेशावतार=परशुराम आदि । (३) अंशावतार =वामन आदि । (४) पूर्णावतार राम, कृष्ण ।
अवतारी : वि० (सं.)। अवतार लेने वाला। विन० ४३.१
अवदात : वि० (सं.)। उज्ज्वल, श्वेत । मा० ६ श्लोक १
अवध : अजोध्या (सं० अयोध्या>प्रा० अउज्फा) ।
_______________________________________________
अवधधनी : अवधपति । गी० ७.२०.१
अवधनाथु : अवधपति । दशरथ । मा० १.३३२
अवधपति : अयोध्या नरेश । मा० १.३२५
अवधपर : अयोध्या नगरी । मा० १.३३६
अवधपुरीं : अयोध्या नगरी में । 'अवधपुरीं यह चरित प्रकासा ।' मा० १.३४.५
अवधपुरी : अवधपुर । मा० १.१६.१
अवधि : (१) सं. स्त्री० [सं०) । सीमा; वह बिन्दु जहां से अथवा जहाँ तक गणना, गति आदि की जाय । 'महिमा अवधि राम पितु माता ।' मा० १.१६.८ (२) प्रवासी के आने की निश्चित तिथि । 'अवधि अंबु प्रिय परिजन मीना।' मा० २.५७.२
अवधूत : (१) वि० (सं.) । उपेक्षित तिरस्कृत । (२) सं० पु । वर्णाश्र मधर्म से संन्यास लेकर अपने में ही सन्तुष्ट रहने वाला परमहंस; जीव-ब्रह्म के अभेद अंशांशिभाव) का ज्ञाता । 'धूत कही अवधूत कही।' कवि० ७.१०६
अवधेस : अयोध्या नरेश; राम या दशरथ । मा० १.४६.७
अवधेसा : अवधेस । मा० ६.४५.७
अवन : वि० पु० (सं.)। रक्षणशील (अवरक्षणे)। पालक । 'सरन आये अवन ।' हनु० ८
अवनि : सं० स्त्री० (सं.)। पृथ्वी । मा० १.१५४.८
अवनि कुमारी : पृथ्वी की पुत्री, सीताजी। मा० २.६४.४
अवनिप : सं० पु. (सं.)। पृथ्वी का रक्षक = राजा । मा० २.४४.१
अवनी : अवनि पर, पृथ्वी पर । 'त्रसित परेउ अवनीं अकुलाई ।' मा० १.१७४.८
अवनी : अवनि । मा० १.१८२.५
अवनीस, अवनीसा: अवनिप (सं० अवनीश)। मा० १.६.७
अवनीसु, अवनीसू: अवनीस+कए । 'चलेउ लवाइ नगर अवनेसू ।' मा० १.२१७.६
अवमान : सं० पु. (सं.)। अवज्ञा, तिरस्कार, अवहेलना । 'गुर अवमान दोष नहिं दूजा ।' मा० २.२०६.५
अवमानी : वि. पु. (सं.)। अवहेलना करने वाला। 'सोचिअ सूद्र बिन अवमानी ।' मा० २.१७२.६
अवर : वि० (सं० अपर>प्रा० अवर) । अन्य और । 'अवर एक बिनती प्रभु मोरी।' मा० १.१५१.४
अवराधक : वि० (सं०) । आराधना करने वाला, उपासक । मा० ४.७.१७
अवराधन : सं० ० (सं.)। आराधना, उपासना । 'सगुन ब्रह्म अवराधन मोहि कहहु भगवान ।' मा० ७.११० घ
52
अवराधहिं : आ० प्रब० । आराधना करें। 'कहिय उमहि मन लाइ जाइ अवराधहिं ।' पा० मं० २३
अवराधहु : आ० मब० । आराधना करते या करती हो । 'केहि अवराधहु का तुम्ह ___चहहू ।' मा० १.७८.३ .
अवराधिए : आ० कवा० प्रए। आराधन कीजिए। 'बीर महा अवराधिए ।' विन० १०८.१
अवराधे : आराधन से । 'इच्छित फल बिन सिव अवराधे।' मा० १.७०.८
अवराधे : भू०० पुं० (बहु०) । आराधित किये, पूजे, अनुकूल किये । ‘इन्ह सम कोउ नहि सिव अवराधे ।' मा० १.२१०.२ ।।
अवरेखी : भू० कृ० स्त्री. (सं० अवरेखिता)। रेखाङिकत की हुई; चित्रित की हुई; रेखाओं में उकेरी हुई; उरेही हुई। रहि जनु कुअरि चित्र अवरेखी।' मा० १.२६४.४
अवरेखु : आ० आज्ञा-मए । तू रेखांकित कर, चित्रित कर । 'चित्त भीति, सुप्रीति रंग, सुरूपता अवरेखु ।' गी० ७.६.१
अवरेब, अवरेब: सं० स्त्री० (सं० अवरेबा, अवरेदा-अव+ रेब रेव गती-टेढ़ी चाल, अगवति, प्रतीति) (१) वक्रोक्ति, लाक्षणिकता, काव्य की अतिशयोक्ति जो अलंकारों का प्राण है, कवि कल्पना की वक्रता, वाग्वदग्ध्य । धनि अवरेब कवित गून जाती ।।' मा० १.३७.८ (२) उक्त प्रकार से टेढ़ाई का अर्थ लेकर यह शब्द उलझन, ग्रन्थि, असमञ्जस जैसा अर्थ भी देता है। 'राम कृपा अवरेब सुधारी।' मा० २.३१७.३ (३) संक्ट, बाधा, अपवाद । 'मिटिहि अनट अवरेब ।' मा० २.२६६
अवलंब : सं० ० (सं.)। आश्रय, आधार, सहारा । 'सो सुतंत्र अवलंबन आना। मा० ३.१६.३
अवलंबन : अवलंब (सं०) । मा० १.२६.७
अवलंबनु : अवलंबन+कए। एकमात्र सहारा। 'तुम्ह अवलंबन दोन्ह ।' मा २.१८४
अवलंबा : अवलंब । मा० २.६०.७
अवलंबि : पूक० । अवलम्बन करके, सहारा लेकर । गी० ५.९.३ ।
अवलंबु : अवलंब-+कए। एकमात्र सहारा। 'आपने तो एक अवलंब ।' कवि०. ७.८१
अवलि, अवली: सं० स्त्री० (सं० आवलि) । पंक्ति, श्रेणी, समूह । 'मनहुं ब्लाक अवलि मनु करहिं ।' मा० १.३४७.२
अवलीं : अवली+बहु० । श्रेणियाँ ‘जनु सुबेलि अवली हिम भारी।' मा २.२४४.६ .
_______________________________________________
53.
अवली : अवलि । 'बचन नखत अवली न प्रकासी।' मा०.१.२५५.१
अवलोकत : (१) वक० पु० । देखता, देखते । 'जो अवलोकत लोकपति लोक संपदा थोरि ।' मा० १.३३३ (२) देखते-ही-देखते । 'अवलोकत अपहरत विषादा।' मा० २.२७६.१
अवलोकन : भ०० अव्यय । देखने (को) । 'सो धनु कह अवलोकन भूपकिसोरहि ।' जा० मं० १०५
अवलोकनि : सं० स्त्री० । देखने की क्रिया । 'अवलोकनि बोलनि मिलनि ।' मा. १.४२
अवलोकहिं : आ० प्रब० । देखते हैं। 'निसि दिन नहिं अवलोकहिं कोका।' मा० १.८५.५
अवलोकहु : आ० मब० । देखते हो, देखो। 'उभउ अरुन अवलोकहु ताता।' मा० १.२३८.७
अवलोकि : पूकृ० (सं० अवलोक्य)। देखकर । 'लघु लाग बिधि की निपुनता अवलोकि पुर सोभा सही ।' मा० १.६४ छं०
अवलोकिए : आ० कवा० प्रए० । देखिए, देखा जाय, देखा जाता है । 'तुलसी नमत अवलोकिए ।' विन० २७६.६ .
अवलोकी : (१) अवलोकि । 'प्रगट न लाज निसा अवलोकी।' मा० १.२५६.१ (२) भक० स्त्री० । देखी। 'गुर नप भरत सभा अवलोकी ।' मा. २.३१३.३
अवलोक : आ० आज्ञा-भए० । तू देख । विन० ६३.१
अवलोके : भू०० पु बहु० । देखे । 'अवलोके रघुपति बहुतेरे ।' मा० १.५५.४
अवलोक्य : अवलोकि । विन० ४६.८
अवसर : सं० पु० (सं.)। उचित देशकाल, अनुकूल स्थिति । प्रस्तावोचित समयाविशेष । मा० १.४८.७
अवसरु : अवसर+कए । विशिष्ट अवसर । 'अवसरु जानि सप्त रिषि आए।' मा० १.८६.७
अवसाना : सं० पु० (सं० अवसान)। अन्त, विराम, छोर । 'नहिं तप आदि मध्य अवसाना ।' मा० १.२३५.७
अवसि : क्रि० वि० अव्यय (सं० अवश्यम् >अ० अवसि)। निश्चय ही, अवश्य ।  'भरतहिं अवसि देहु जुवराजू ।' मा० २.५०.२
अवसेरी : सं० स्त्री० । चिन्ता, प्रतीक्षा, मानसिक उलझन । 'भए बहुत दिन अति ___अवसेरी ।' मा० २.७.६
अवसेषा : सं० पु० (सं० अवशेष) । शेष भाग, अन्तिम भाग । 'उहाँ राम रजनी अवसेषा।' मा० २.२२६.३
54
_______________________________________________
अवसेषित : भू०० वि० सं० अवशेषित)। बचाया हुआ। सिर अवसेषित राहु ।' मा० १.१७०
अवस्था : सं० स्त्री० (सं०)। दशा, स्थिति । जीव की चार दशाएँ-जाग्रत्, स्वप्न, सुषुप्ति और तुरीय। 'जन जीव अरु चारिउ अवस्था।' मा० १.३२५ छं.. 'तीनि अवस्था "तूल तुरीय... | मा० ७.११७ ग
अवस्य : क्रि० वि० (सं० अवश्य) =अवसि । मा० ७.१०६.६
अवाँ  : सं० ० (सं० आमपाक>प्रा० आमवाअ>अ० आवाम>आवा) । आम-कच्चे बर्तन पकाने की कुमार की भट्टी जिसका धुवाँ बाहर नहीं आता, भीतर बर्तन पकते रहते हैं। मा० १.५८.४
अवास : सं० ० (सं० आवास) । घर, निवास स्थान । पा० म० १४८
अवासू : अबासू । मा० २.१७६.६
अविगत : अबिगत । सर्वव्यापी होने से सर्वगत, सर्वगत, सर्वच्याप्त । मा० १.१८६ छं.
अविछिन्न : अबिछीन । विन० ४६.३
अविद्या पञ्च : दे अविद्या ।
अव्यक्त : अब्यक्त । ब्रह्मा, जीव तथा प्रकृति ।
अव्यय : सं०+वि० (सं.)। व्यवहीन, निर्विकार, अविकृत ब्रह्मतत्त्व (दे० ___अबिकारी)। मा० ४ श्लोक २
अशुभ : (दे० असुभ) । अहित, अमङ्गल, पाप । विन० १०.५
अशेष : वि० (सं०) । सम्पूर्ण (जिससे पृथक् कुछ शेष न हो)। निविशेष (निरपेक्ष)। मा० १ श्लोक ६
अष्टक : सं० पु. (सं.)। आठ का समवाय । जैसे-रुद्राष्टक = रुद्रस्तुति के आठ श्लोकों का समूह । मा० ७.१०८.६
अष्टासिद्धि :+++(अष्टसिद्धि इति साधु । )+++ योग की आठ सिद्धियाँ-(१) अणिमा-अणु रूप ग्रहण की शक्ति (२) महिमा-अति विशाल रूप लेने की शक्ति (३) लघिम= अत्यन्त हल्का बनने की शक्ति (४) गरिमा =बहुत भारी होने की शक्ति (५) प्राप्ति = मनचाही गति या पहुंच (६) प्राकाम्य =मनोभीष्ट वस्तु की प्राप्ति (७) ईशित्व सभी जीवों पर प्रभुता (5) वशित्व = सबको वशीभूत करने की शक्ति । मा० १.२.२३ ।।
'अष्टादस : संख्या (सं० अष्टादशन्)। अठारह । मा० ६१५.७
अष्टोत्तर : वि० (सं.)। वह संख्या जिसके आगे आठ और हों। रा० प्र०. मङ्गलाचरण ।
_______________________________________________
55
अस : वि. पु. (सं० ईदश>प्रा० एरिस>अ० अइस) ऐसा । 'अस बिबेक जब देइ बिधाता।' मा० १.७.१ (२) इस प्रकार । 'अस बिचारि उर छाड़ह कोहू ।' मा० २.५०.१
असंक : वि० ० (सं० अशङक)। शङ कारहित, निःशङ क, निर्भय । 'अति असंक ___मन सदा उछाहू ।' मा० १.१३७.३ ।।
असंका : (१) असंक। 'तह रह रावन सहज असंका।' मा० ४.२८.११ (२) सं० स्त्री० (सं० आशङ का)। सन्देह, संशय । 'अस बिचारि तुम्ह तजहु असंका।' मा० १.७२.४
असंक : असंक+कए । मा० १.२७३.२
असंग : वि० (सं.)। सङ्गरहित, अनासक्त, उदासीन, निलेप। 'मीन जल बिनु तलकि तनु तर्ज, सलिल सहज असंग ।' कृ० ५४
असंगत : वि० (सं०) । अनुपयुक्त, अयुक्त, अयोग्य । विन० ६०.८
असंत : (संत का विलोम) । अशान्तचित्त, असज्जन । मा० ७.३७.५
असतन्ह, असतन्हि: असंत+संब० । असंतों। 'संत असंतन्ह के गुन भाषे ।'. मा. ७.४१.८ 'संत असंतन्हि के असि करनी।' मा० ७.३७.७ ..
असंभावना : सं० स्त्री० (सं.) । अनिश्चय, उलझन, नैराश्य । 'दारुन असंभावना बीती।' मा० १.११६.८
असंमत : वि० (सं.)। अविहित, अमान्य । 'कहहिं ते बेद असंमत बानी ।' मा०
असगुन : (सगुन का विलोम) । दुनिमित्त, अशुभसूचक प्राकृतिक संकेत । मा० २.१५८.४
असज्जन : (सज्जन का विलोम) । असाधु, असंत । मा० १.५.३
असत् : अवियमान+++(अविद्यमान ?)+++। वास्तव सत्ता से शून्य, पारमार्थिक दृष्टि से असत्य । अन्य की सत्ता से सत्तावन-जैसे, पुरुष की छाया। भ्रान्त प्रतीत- जैसे, रस्सी में साँप । संसार या जरामरण आदि सांसारिक सम्बन्ध जो जीव के सन्दर्भ में नश्वर हैं । विन० १२०.४ शड करमत में जगत्प्रपञ्च अनिवचनीय है-वह 'सत्' नहीं क्योंकि परिवर्तमान है और ज्ञानी के लिए सत्ताहीन है; 'असत' भी नहीं क्योंकि प्रतीत होती है। वैष्णवमत में प्रपञ्च नित्य सत् है- । यद्यपि परिवर्तमान है क्योंकि परिवर्तन भी नित्य है । संसार अनित्य है-क्योंकि वह जीव द्वारा स्थापित सम्बन्धों-पितापुत्र, जरामरण आदि-से बनता है।
असत्य : वि०-असत्, मिथ्या । 'जदपि असत्य देत दुख अहई ।' मा० १.११८.१
56
_______________________________________________
असन : सं. ० (१) (सं०) । फेंकने का साधन । शरासन, विशिखासन, बाणासन आदि । (२) (सं० अशन)। भोजन । 'बचन सुधासम असन अहि।' मा० १.१६१ ख (३) भोजन करने की क्रिया । 'इहाँ उचित नहिं असल अनाजू ।' मा० २.२७८.७
असनि : सं० स्त्री० (सं० अशनि) । वज्र । 'ओडिअहिं हाथ असनिहु के घाए ।' मा० २.३०६.८
असनु : असन+कए। भोजन, एकमात्र खाद्य सामग्री । 'असनु कंद फल मूल ।' मा० २.६२
असबाबु : सं० ० कए (अरबी-असबाब-सबब+बहु० जिसका अर्थ उपकरण, उपादान जैसा होता है; बन्धन, रस्सी, कारण जैसे अर्थ भी उर्दू में चलते हैं। हिन्दी में 'सामग्री के अर्थ में आता है, विशेषतः घरेलू सामग्री)। सामान। 'सबु असबाबु डाढ़ो, मैं न काढो नै न काढ़ो' कवि० ५१२ .
असम : वि० (सं.)। विषम (संख्या, मात्रा आदि में) । दुर्गम, अज्ञेय । 'असम सम सीतल सदा।' मा० ३.३२ छं०४
असमंजस : सं०+वि० पुं० (सं०) । (१) असंगत, अनह, अयोग्य । 'राम सुकीरति भनिति भदेसा । असमंजस ।' मा० १.१४.१० (२) अनिश्चय, कर्तव्यनिर्णय का अभाव । 'बना आइ असमंजस आजू ।' मा० १.१६७.५ (३) संशय, व्याघातपूर्ण स्थिति, मनोभीष्टपूर्ति में सन्देह । 'करौं काह असमंजस जी के।' मा० २.२६३.५ (४) अव्यवस्थित, उखड़ा-सा, बेठीक । 'सबु असमंजस अहइ सयानी।' मा० २.२२३.३ (५) ग्रहण-त्याग में अनिश्चित । 'समुझि अवधि असमंजस दोऊ ।' मा० २.२७१.६ (६) उक्त सभी अर्थों का समाहार । 'तुम्ह बिनु असमंजस समन को समरथ एहि कालो।' मा० २.२६१
असमंजसु : असमंजस+कए। 'असमंजसु बड़-रा०प्र० ६.७ १
असमय : प्रतिकूल समय, अनवसर, विपरीत अवसर; संकट काल । 'आपन अति असमय अनुमानी ।' मा० १.१५७.३
असमसर : सं० ० (सं० असमशर=विषमशर) विषम संख्यक बाणों वाला= पञ्चबाण = कामदेव । 'सकल असमसर-कला प्रबीना।' मा० १.१२६.४ (असमसर-कला=कामकला, संभोग कोशल ।)
असमाकं : सर्व० (सं. अस्माकम् ) । हमारा । विन० ५१.८
असयानी : (सयानी का विलोम) चातरी से रहित निश्छल, वाक्कोशल की लाग लपेट से शन्य । "बिबिध सनेह सानी बानी असयानी सुनि ।' कवि० २.१०
असरन : वि० (सं० अशरण) । शरणहीन, निराश्रय, अनाथ, रक्षकहीन । मा० ७.१८३
असवार, असवारा: वि० सं० पुं० (सं० अश्ववार>प्रा० असवार, आसवार)। (१) अश्वारोही । 'जगदपदचर असवार प्रति ।' मा० १.२६८ (२) आरोही। 'बरु बौराह बसह असवारा।' मा० १.६५.८
असहाई : असहाय । सहायक-रहित । मा० २.२२६.३
असहाय : वि० (सं०) । एकाथी, अनाथ, सहायरहित, मित्रहीन । 'संबल निसंबल को, सखा असहाय को।' विन० ६६.१
असही : वि० स्त्री० । असहनशीला, परसन्तापिनी, दूसरे के शुभ में डाह करने वाली । गी० १.२.१०
असाँचा : वि० पु० (सं० असत्य>प्रा० असच्च) । मिथ्या, झूठा । मा० १.१७५.७
असाँची : वि० स्त्री (सं० असत्य.>प्रा० असच्ची) । झूठी । मा० ६.२६.२
असा : अस । ऐसा । 'कलपांत न नास गुमानु असा ।' मा० ७.१०२.२
असाध : (१) वि० (सं० असाध्य) । जो उपायों से साध्य न हो, जिसका कोई उपचार न हो। 'देखी ब्याधि असाध नपु।' मा० २.३४ (चिकित्साशास्त्र में साध्य, दुःसाध्य और असाध्य-तीन प्रकार के रोग होते हैं ।) (२) असाधु । 'असाध जानि मोहि तजे उ अग्य की नाईं।' विन० ११२.१ (असाध = असाधु+ असाध्य-ऐसा नीच जो उपायों से भी सुधारा न जा सके ।)
असाधि : वि० स्त्री० (सं० असाध्या)। उपचारहीन । 'व्याधि असाधि देखि तिन्ह त्यागी।' मा० २.५१.२ (असाध्य रोगी को वैद्य त्याग देता है।)
असाधु, असाधू: (साधु का विलोम) असज्जन, असंत । 'सुधा सुरा सम साधु असाधू ।' मा० १.५.६
असि : (१) वि. स्त्री० (सं० ईदृशी>अ० अइसी= अइसि) ऐसी । 'जिन्ह के असि मत सहज न आई।' मा० ४.७.३ (२) सं० स्त्री० (सं.)। तलवार । 'काढ़ि असि बोला।' मा० ५.६ (३) आ० मए० (सं.)। तू है । विन० १५.१-३ (दे० जोसि, सोसि) ।
असिकला : सं० स्त्री० (सं.) । तलवार चलाने का कौशल । मा० १.२६८
असिधारब्रत : सं० पु० (सं० असिधारा-व्रत)। तलवार की धार पर चलने के समान कठोर व्रत । गी० ७.२५.३
असिधारा : सं० स्त्री. (सं०) । तलवार की धार । खड्गधारा पर चलने के समान कर्मनिष्टा । 'तिय चढ़िहहिं परिब्रत असिधारा ।' मा० १.६७.६
असिव : वि० (सं० अशिव) अमङ्गल, अभव्य, भद्दा । 'असिव बेष सिवधाम कृपाला।' मा० १.६२.४
असी : सं० (सं.)। काशी के पास नदी विशेष । वि० २२.३
असीम : वि० (सं.)। संख्या अथवा परिमाण में अज्ञेय, अनन्त, निरविधि, व्यापक । अधिकतम । विन० १३६.६
