_______________________________________________
1021
समसरि: (दे० सरि) समानता, बराबर की उपमा । 'को कबि समसरि कर पर भवकूप ।' बर०६
समसील : (१) वि. (सं० शमशील+समशील)। इन्द्रिय विकारों का शमन करने वाला, संयमी+सभी को सम दष्टि से देखने वाला; समदर्शी ।' 'तुम्ह समसील धीर मुनि ग्यानी ।' मा० १.२७७.४ (२) समान स्वभाव वाले (सं. समशील)। 'ते श्रोता बकता समसीला।' मा० १.३०.६ (३) एक जैसे, तुल्य आकार-प्रकार वाले । 'सजनी ससि में समसील उभे नव नील सरोरुह से बिकासे ।' कवि० १.१
समस्त : वि० (सं.) । सम्पूर्ण । मा० ७.५७.३
समा : सम । मा० ६६० छं०
समा,→ समाइ, समाई : आ०प्रए० (सं० समाति>प्रा० समाइ) । समाता है, समाती है । अन्तर्भूत होता होती है। 'आनंद हिय न समाइ।' रा०न०१० 'प्रीति न हृदयें समाइ ।' मा० ६.५६ 'जन टीड़ी गिरि गुहां समाई।' मा० ६.६७.२
समाइ, समाई : कृ. । समाकर, अन्तर्भूत होकर । 'रही सीय दुहुं प्रीति समाई।' मा० २.३२०.३
समाउँ : आउए । समाऊँ, समाविष्ट हो सक । 'ठाउँ न समाउँ कहाँ।' कवि० ७.७५
समाउ, समाऊ : सं००कए । (१) (सं० संमायः>प्रा० समाओ>अ. समाउ)। समाने का स्थान । 'इतो न अनत समाउ ।' विन० १००.५ (२) शक्ति, (समावेश) सामर्थ्य । 'बोलि लियो हनुमान करि सनमान जानि समाउ ।' गी. ५.४.४ (३) प्रबन्ध, जुगाड़। 'पहिएँ उपमा को समाउ न आयो ।' कवि० ६.५४ (४) समाज (अ० समाउ) । संभार, सामग्री। 'अरुंधती अरु अगिनि समाऊ ।' मा० २.१८७.३
ऽसमाकं : सर्वनाम (सं० अस्माकम् ) । हमारा। 'सर्वतो भद्रदाता ऽसमाकं ।' विन०
समागम : सं०० (सं.)। (१) मिलन, संगति । 'सुन मुनि आजु समागम तोर ।' मा० १.१०५.२ (२) समुदाय, समाज । 'गावत सुर मुनि संत समागम ।' मा० ७५१.७
समाचार : सं०० (सं.)। (१) उत्तम आचरण, समुदाचार, शिष्टाचार । (२) चरित्र, व्यवहार । (३) संदेश, संवाद, सूचना, हालचाल । 'समाचार सब संकर पाए।' मा० १.६५.१
समाज : सं०० (सं०) । (१) व्यवस्थित समुदाय, एक उद्देश्य से एकत्र जनगण । 'नत्य-समाज ।' मा० ७.२२ (२) एक नेतृत्व में एकत्र जनसमुदाय, समा; संसद् । 'राजसमाज सभासद समरथ ।' कृ०६० (३) वर्ग, विचारविशेष के आधार पर कल्पित जनगण । 'सुजन समाज।' मा० १.२.४ (४) सामग्री-समूह। 'जो न तरै भव-सागर नर समाज अस पाइ।' मा० ७.४४
समाजा: समाज मा० १.१८.१
समाजी : वि०० (सं० समाजिन्) । समाज के सदस्य । कृ० ६१
समाजु, समाजू : समाज+कए० । (१) समूह, मेला, भीड़ । 'बूड़ सो सकल समाजु ।' मा० १.२६१ (२) उद्देश्य विशेष से जुटा समूह । 'गुरजन लाज समाज बड़।' मा० १.२४८ (३) वर्गविशेष । 'मुदमंगलमय संत समाजू ।' मा० १.२.७ (४) संभार । 'बरनब राम बिबाह समाज ।' मा० १.४२.३ (५) तैयारी । 'कहिअ कृपा करि करिअ समाजू ।' मा० २.४.२
समात, समाता : समा+वकृ.पुं० । समाता-ते, अटता-अटते । मा० १.१४२ 'मिलत प्रेम नहिं हृदय समाता ।' मा० ७.२.१०
समाति, समाती : वकृ०स्त्री० । अटती, समाविष्ट हो पाती। 'प्रीति न हृदय समाति ।' मा० २.३२५.१; ६१.६
समाते : क्रियाति० ब० । चाहे अटते हों। 'बाहेर भूप खरे न समाते ।' कवि. ७.४४
समातो : क्रियाति०पू०ए० । तो अटता, समा सकता। 'जो तू मन मेरे कहे राम नाम कमातो । “सीतापति सनमुख सुखी सब ठांव समातो।' विन० १५१.३
समाधान : सं०० (सं.)। शङ कानिवारण । मा० २.२२७.५
समाधानु : समाधान+कए० । प्रबोधन, शङ कानिवारण । मा० २.३६.५
समाधि, समाधी : (१) संस्त्री० (सं० समाधि)। योग, चित्तवृत्ति निरोध की दशा, स्वरूपस्थित चैतन्य दशा, निविषय चित्त दशा। मा० ७.४२.८ (२) लय, अध्यास रहित विषयमुक्त चित्त दशा । सिथिल समाज सनेह समाधी ।' मा० २.३०७.२ (३) समाधान । (भय, शङका आदि का) निवारण । 'ब्याधि भूत जनित उपाधि काहू खल की, समाधि कीजै, तुलसी को जानि जन फुर के।' हनु० ४३
समान, समाना : (क) वि.पु. (सं० समान) । (१) सदश, तुल्य । 'अधम कवन जग मोहि समाना।' मा० ७.१.८ (२) एकरूप । 'जद्यपि सलिल समान ।' मा० २.४२ (३) अनरूप, उचित, योग्य । 'बोले मनिबर समय समाना।' मा० २.२५४.१ (ख) भूक०० । समा गया, प्रविष्ट हुआ। 'तासु तेज समान प्रभ आनन ।' मा० ६.१०३.६ 'मानहुं ब्रह्मानंद समाना।' मा० १.१९३.३
समानी : भूक०स्त्री० । समा गयी, लीन हुई । 'प्रभु पद हियं धरि अनल समानी।' मा० ३.२४.३
समाने : भूक०० ब० । (१) प्रविष्ट हुए । 'छुटे तीर सरीर समाने ।' मा० ६.७०.७ (२) लीन हुए, याप्त हुए। 'नीकेइ लागत मन रहत समाने ।' कृ०३८
_______________________________________________
1023
समारोपित : भूकृ०वि० (सं.) । स्थापित किये हुए । मा० २ श्लो० ३
समाश्रित : भूक०वि० (सं०) । भली भांति आश्रित, अवलम्बित । विन० ५७.१
समास : सं०० (सं.) । समष्टि, संक्षेप । 'व्यास समास स्वमति अनुरूपा।' मा० ७.१२३.१
समहिं, समहीं : आ.प्रब० (सं० संमान्ति>प्रा० संमंति>अ० संमाहि)। समाते हैं, अमाते हैं, अटते हैं+अटती हैं। जिमि दामिनि धन माझ समाहीं।' मा० ६.६६.६ 'बचन न हृदय समाहीं । कृ० ५८
समाहिंगे : आ०भ०पू०प्रब० । समायेंगे, अटेंगे। कवि० ६.८
समिटि : पूर्व० (सं० समिट्य = सम् +इट गतौ+ ल्यप्>प्रा० समिट्टिअ>अ० समिट्टि) । सिमट कर, सब ओर से बटुर कर । 'समिटि समिटि जल भरहिं तलावा ।' मा० ४.१४.७
समिटे : भक०पू०प० । सब ओर से एकत्र हुए । 'समिटे भूप एक ते एका।' मा० १.२६२.४
समिध : सं०स्त्री० (सं० समिध्) । होम के निमित्त काष्ठ, ईंधन । कवि० ५.७
समिधि : समिध । 'समिधि सेन चतुरंग सुहाई।' मा० १.२८३.३
समीचीन : वि०पू० (सं.) । सम्यक, उत्तम । विन० २७८.२
समीचीनता : सं०स्त्री० (सं०) उत्तमता, अर्हता । विन० २६२.२
समीति : (१) पू० । समेट कर, समवेत कर, एकत्र करके । 'समय सब रिषिराज करत समाज साज समीति ।' गी० ७.३५.२ (२) सं०स्त्री० (सं० समिति) । संगति । 'रुची न साधु समीति ।' विन० २३४.३
समीती : सं०स्त्री०=समीति । संगति, मेल । 'भाइहि भाइहि परम समीती।' ___ मा० १.१५३.७
समीप : क्रि०वि० (सं०) । निकट । मा० १.६०.८
समीपा : समीप । मा० १.२१४.४
समीर : (१) सं०० (सं०) । वायु । मा० १.१०६.३ (२) प्राण अर्थ में भी इसके प्रयोग होते हैं । (३) वायु तत्व जिसका स्पर्श गुण है ।
समीरन : समीर (सं० समीरण) । वायु (प्राण)। 'करि जोग समीरन साधि ।' कवि० ७.४५
समीरा : समीर । मा० ४.११.४
समीरु : समीर+कए । कवि० ५.२२
समीहा : सं०स्त्री० (सं०) । इच्छा शक्ति, इच्छानुसार चेष्टा । 'उतपति पालन प्रलय समीहा ।' मा० ६.१५.६
समुझ : (१) समुझइ । समझती है। 'दुख न समझ तेहि सम को खोटी।' मा० ३.५.१७ (२) समझू । तू समझ ले । 'सठ यह समझ सबेरो।' विन० ८७.१
1024
_______________________________________________

समुझ, समुझइ : आ.प्रए० (सं० संबुध्यते>प्रा० संबुज्झइ) । समझता है - बोधगम्य करता है+संवेदन में लाता है (जानता है) । समुझइ खग खग ही के भाषा ।' मा० ७.६२.६
समुझउँ : आउए। समझता हूं (था); समझू । बुद्धिगत भले ही कर लूं ।  'समुझउँ सुनउँ गुनउँ नहिं भावा ।' मा० ७.११०.५
समुझत : वकृ० । समझता, समझते । 'समुझत नहिं कछु लाभ न हानी।' मा० १.२५८.२ (२) समझते हुए, समझने में-से-पर । “समझत मन दुख भयउ अपारा।' मा० ७.१.१
समुझनि : संस्त्री०। समझने की क्रिया, बोध व्यापार । 'भरत रहनि समझनि करतूती।' मा० २.३२५.७
समुझब : (१) भूकृ०० । समझना । 'दसा एक समुझब बिलगाना।' मा० १.६८.२ (२) तुम्हें समझना (होगा) । 'समुझाब कहब करब तुम जोई ।' मा० २.३२३.८ (तुम समझोगे)।
समुझहिं : आ०प्रब० (सं० संबुध्यन्ते>प्रा० संबुज्झंति>अ० संबुज्झहिं) । समानते हैं, बोधगम्य करते हैं । 'सुनि समाहिं जन मुदित मन ।' मा० १.२ ।
समुझहु : आ०मब०। तुम समझो, बुद्धिगत करो। 'समुझहु छाडि प्रकृति अभिमानी।' मा० ५.५७.३
समुझाइ : पूकृ० । समझाकर। (१) विवेचित कर, बोधगम्य बनाकर । ईस्वर जीव भेद प्रभु सकल कही समुझाइ ।' मा० ३.१४ (२) प्रबोध देकर, सान्त्वना देकर । 'बिदा कोन्हि भगवान् तब बहु प्रकार समुझाइ ।' मा० ७.१८
समुभाइबी : भकृ० स्त्री० । समझानी (चाहिए); विवेचित करनी। 'प्रीति रीति समुझाइबी।' विन० २७८.३
समुझाइहौं : आ०भ० उए । समझाऊंगा, प्रबोध (सान्त्वना या हिसाब-किताब) दूगा । 'घरनी घर का समुझाइहों जू ।' कवि० २.६
समुझाई : भूक स्त्री०ब० । प्रबोधित की। मा० ७.३.३
समुझाई : (१) समुझाइ। 'आपु कहिं अनुजन्ह समुझाई।' मा० १.२०५.६ (२) भूकृ०स्त्री० । समझाई, विवेचित की । 'यहि बिधि सकल कथा समुझाई।' मा० ४.४.५ (३) प्रबोधित की, सान्त्वना देकर शान्त की। 'समझाई गहि बांह उठाई।' मा० ३.२२.१
समुझाउ : आ.-आज्ञा-मए । तू समझा, शान्त कर । 'करि बिनती समुझाउ कुमारा।' मा० ४.२०.३
समुझाए : भूक००ब० । विवेचित कर ज्ञात कराये । 'प्रभु प्रताप कहि सब समुझाए।' मा० ६.१६.६
_______________________________________________
1025
समुझाएसि : आ०-भूकृ००+प्रए । उसने समझाया, बताया। प्रबोध दिया । 'सुनत बचन पद गहि समुझाएसि ।' मा० ५.१२.५
समुझाएहु : आ० --भ०+आज्ञा, अभ्यर्थना+मब० । तुम समझाना । 'बान प्रताप प्रभुहि समुझाएहु ।' मा० ५.२७.५
समुझायउँ : आ०भूक+उए । मैंने समझाया। 'ता ते तात न कहि समुझायउँ ।' मा० ३.१३.२
समुझायउ : भूक०कए। समझाया, प्रबोध दिया। 'कहि बहु कथा पिता  समझायउ ।' मा० ६.७२.६
समुझाये : समुझाए।
समुझायो : समुझायउ । मा० ६.१०५.६
समुझाव, समुझावइ : आ०ए० (सं० सम्बोधयति>प्रा० संबज्झावइ) । समझाता है, प्रबोध देता है। 'सुनि सप्रेम समुझाव निषादू ।' मा० २.२०१.७
समुझावउँ : आ. उए। समझाता हूं, प्रबोध (या सान्त्वना) देता हूं। कोटि भांति समुझावउँ मनु न लहइ विश्राम ।' मा० ७.८२
समुझावत : वकृ००। समझाता-ते। 'समुझावत सब सचिव सयाने ।' मा० १.३३८.७
समुझावति : वकृ०स्त्री० । समझाती, प्रबोध देती (शान्त करती)। 'बिकल बिलोकि सुतहि समुझावति ।' मा० २.१६१.१
समुझावहिं : आ०प्रब० । समझाते हैं, बोध देते हैं (विवेचित कर बताते हैं)।  'कृपासिंधु बहु बिधि समुझावहिं ।' मा० २.८३.४
समुझावहिंगे : आ०भ००प्रब० । समझाएंगे, प्रबोध देंगे । गी० ५.१०.३
समुझावा : भूक.पु । प्रबोधित किया। मा० ७.६२.७
समुझावै : समुझावइ । जा०म०७५
समझावौं : समुझावउँ । समझाऊँ, समझा सकता हूं। 'कवन भांति समुझावौं तोही।' मा० ७.६१.३
समुझि : (१) सं०स्त्री० (सं० सम्बद्धि>प्रा. संबज्झि)। समझ, विवेकशक्ति । सूझबूझ । 'अपनी समुझि साध सुचि को भा ।' मा० २.२६१.२ (२) पू० । समझकर । 'घरी कुधरी समुझि जियँ देखू ।' मा० २.२६.८ (३) आ० आज्ञा-अभ्यर्थना- मए । तू समझ, विचार कर । 'समुझि धौं जिय भामिनी । मा० २.५० छं०
समुझिअ, समुझिय : आ०कवा०प्रए । समझ लीजिए, जान लिया जाय । 'नृप समुझिम मन माहिं ।' मा० २ ३३
समुझिए, समुझिये : 'अवसि समझिए आपु ।' दो० ४८६
1026
_______________________________________________
समुभिबो : भकृ००कए० (सं० संबोद्धव्यम् >प्रा० संबुज्झिमव्वं>अ० संबुज्झिअव्वउ) । समझना (होगा) । 'के समुझिबो के ये समुझे हैं, हारेहु मानि सहीज ।' कृ० ४५
समुझियत : वकृ०पु०कवा० । समझ में आता । समझा जाता । 'सुनत समुझियत थोरे ।' कृ० ४४
समुझिहहिं : आ० भ०प्रब० । समझेंगे, ज्ञात कर लेंगे। 'सुनि गुन भेदु समुझिहहिं  साधू ।' मा० १.२१.३
समुझिहैं : समझिहैं । 'जगुति धूम बधारिबे की समुझिहैं न गंवारी।' कवि० ५३
समुझी : भूकृ०स्त्री० । समझी, विवेक से जानी । मा० १.३० क
समुझु : आ०- आज्ञा-मए० । तू समझ, ज्ञात कर । 'मूढ़ समझु तजि टेक ।' मा०
समुझें : समझने से, पर । विवेक द्वारा जानने पर । 'समझें मिथ्या सोपि ।' मा. ७.७१
समुझे : (१) भूकृ००ब० । जाने, बोधगम्य किये । 'नाथ न मैं समुझे मुनि बैना।' मा० १.७१.२ (२) समुझें । ‘समुझे सहे हमारो है हित ।' कृ० २७
समुझै : समुझइ । समझे, जान जाय । 'जों करनी समझ प्रभु मोरी ।' मा० ७.१.५
समुझैहैं : आ०भ० प्रब० । समझाएंगे, बुद्धिगम्य करेंगे। 'के समुझिबो, के ये समझहैं।' कृ०४५
समुझौं : समुझउँ । समझ सकू। 'किमि स मुझौं मैं जीव जड़।' मा० १.३० ख
समझ्यो : भूकृ.पु.कए । समझा, जाना। 'ता ते कछू समुझ्यो नहीं।' विन. १६०.५
समुदाइ, समुदाई : समुदाय । मा० ४.१७, ७.१०.४
समुदाय : सं०० (सं.)। समूह, एक जातीय गण, संघ । मा० ७.७८ ख
समुद् भव : सं०० (सं०) । आविर्भाव, उत्पत्ति । मा० ४ श्लो० २
समुद्र : सं०पु० (सं.)। सागर । मा० ६.३४.२ '
समुहा, समुहाइ, ई : आ०प्रए० (सं० संमुखायते>प्रा० समूहाइ) । संमुख आता है, सामना करता है । 'अति भय त्रसित न कोउ समुहाई।' मा० ६.६५.१०
समुहान : भूक.पु । सामने आया । 'जनु दुकाल समुहान ।' रा०प्र० ५.७.२
समुहानी : भूक स्त्री० । सामने हुई, संमुख चली । 'राम सरूप सिंधु समुहानी।' मा० १.४०.४
समुहाही : आ.प्रब० । सम्मुख आते हैं, सामना करते हैं । 'तिन्हहि न पाप पुंज समुहाहीं।' मा० २.१६४.५
_______________________________________________

1027
समूला : वि० (सं० समल) । जड़ समेत । मा० २.२६.८
समूलें : समल' से; सकारण...से । 'अपडर डरेउँ न सोच समूलें।' मा० २.२६७.३
समूलो : वि००कए० (सं० समूल:>प्रा० समूलो)। जड़सहित, सब-का-सब, सम्पूर्ण । 'पितु मातु सों मंगल मोद समूलो।' हनु० ३६ अवधी में 'समुल्ल' तथा 'समुल्लो' आज भी 'सम्पूर्ण' के अर्थ में प्रचलित हैं।
समूह : सं०० (सं०) । समुदाय । मा० ६.४१.८
समूहा : समूह । मा० ६.१.१०
समृति : सं०स्त्री० (सं० स्मृति) । धर्मशास्त्रीय ग्रन्थविशेष । विन० १२०.४
समृद्धि : संस्त्री० (सं.)। प्रचुर, ऐश्वर्य । कवि० ५.३२
समेटा : भूक.पुं० । संकलित किया, सब ओर से एकत्र किया=बटोरा । 'जन __महि लुठत सनेह समेटा ।' मा० २.२४३.६
समेटि : पू० । समेट कर, बटोर कर, सब कहीं से एकत्र करके । 'सब समेटि बिधि रची बनाई।' मा० १.३२४.२
समेत : वि० सं०) । सहित, समवेत । 'फिरि आवइ समेत अभिमाना।' मा० १.३६.३
समेता : समेत । मा० १.१४.१०
समेति : समेत+पूकृ० । समवेत करके; एकत्र कर । 'सेन समेति.''उतरे जाइ।' ___ मा० ७.६७.७
समेते : समेता+ब० । सहित (सब)। 'त्रिजग देव नर असुर समेते ।' मा. ७.८७.६
समै : समय । गी० २.३७.३
समैहैं : आ० भ० प्रब० । समायंगे, अटेंगे । 'सुचित तेहि समै सम हैं।' गी० २.३७.३
समैहै : आ०भ०प्रए० । समायगा, अटेगा। 'निरखि हृदय आनंद न समैहै ।' गी० ५.५०.४
समोइ, समोई : प्रकृ० । (१) मिश्रित या चिकनाई (स्नेह) से ओतप्रोत होकर। 'ता में तन मन रहै समोई ।' वैरा० ५२ (२) ओतप्रोत करके । गी० ५.५.७
समौ : समउ । जा०म० १४६
सम्यक : वि० (सं० सम्यक् ) । समीचीन, उत्तम, परमार्थरूप । 'सम्यक ग्यान सकृत कोउ लहई ।' मा० ७.५४.३ ।
सम्हारहिं : संभारहिं । जा०म० छं० १७
सम्हारा : संभारा । स्मरण किया। 'संकर सहज सरूपु सँभारा।' मा० १.५८.८
सय : संख्या (सं० शत>प्रा० सय) । सौ । मा० २.१४०.७
1028
_______________________________________________
सयगुन : वि० (सं० शत गुण>प्रा० सयगुण) । सौ गुना। 'दिन दिन सयगुन भूपति भाऊ ।' मा० १.३६०.४
सयन : स०पु० (सं० शयन) । (१) निद्रा लेने की क्रिया। 'सयन करह निज निज गृह जाई ।' मा० ६.१४.५ (२) सुषुप्ति दशा । 'जीव सीव सम सुख सयन ।' दो० २४६ (३) शय्या, बिछौना। भूमि सयन ।' मा० २.२५.६ (४) (समासान्त में) शयन करने वाला, सोने वाला। 'छोर-सागर सयन । मा० १ दोहा ३ (५) सैन । संज्ञा, संकेत, इङ्गित । 'कहा अन ज सनः सयन बुझाई।' मा० ३.१७.२०
सयननि : सयन+संब० । संकेतों (से) । निज पति कहेउ तिन्हहि सिय सयन नि ।' मा० २.११७.७
सयनहिं : संकेतों से । 'सयनहिं रघुपति लखन निवारे ।' मा० १.२५४.४
सयना : सयन ।
सयल : सइल । पर्वत । मा० ३.१८ छं.
सयान, सयाना : वि०० (सं० सज्ञान>प्रा० सयाण)। चतुर । “सचिव सयान बंधु बलबीरा ।' मा० १.१५४.२ 'सुन बायस ते सहज सयाना।' मा० ७.८५.२
सयानप : (१) सयानपन । सं०पू० । सज्ञानता, चातुरी, सजगता । रह्यो न सयानप तन मन ती के ।' कृ० १० (२) सं०स्त्री० । 'भूप सयानप सकल सिरानी।' मा० १.२५६.५
सयनि : सयानी । (१) चतुरा। 'कपट सयानि न कहति कछु।' मा० २.३६ (२) तरुणी, वयः प्राप्ता (ज्ञातयोवना)। 'कुरि सयानि बिलोकि मातु पितु सोहिं ।' पा०म०६
सयानिन्ह : सयानी+संब० । सयानियों ने, चतुर तरुणियों ने। 'जुआ खेलावन कौतुक कीन्ह सयानिन्ह ।' जा०म० १५०
सयानीं : सयानी+ब० । निपुण युवतियां । मा० १.२३८.३
सयानी : सयान+स्त्री० । (१) चतुरा। विवेकवती। 'मन महं रामहि सुमिर सयानी ।' मा० १.५६.५ (२) ज्ञातयोवना, युवती । (३) चातुरी, निपुणता । 'सब कृतग्य नहिं कपट सयानी ।' मा० ७.२१.८
सयाने : सयाना+ब० । मा० ७.४१.६ ।।
सयानो : सयाना+कए. । चतुर, सतर्क, चालाक । 'सत्रु सयानो सलिल ज्यों।' दो० ५२०
सयौ : (दे० सय) । सौ-के-सो, सभी सौ; पूरे सौ। 'सयो सँघारे भीम ।' दो० ४२८
सर : (१) सं०० (सं० शर>प्रा० सर) । बाण । मा० ६ १३ ख (२) (सं० सरस्>प्रा० सर)। तालाब । 'सर समीप गिरिजा गृह सोहा ।' मा० १.२२८.४ (३) (प्रा० सल) चिता । 'एहि बिधि सर रचि मुनि सरभंगा।' मा० ३.८.८ '
सर, सरइ, ई : आ०प्र० (सं० सरति-सृगती>प्रा० सरइ) । चलता है, पूरा पड़ता है, काम बनता है; परिणाम तक पहुंचता है । 'तोरें धनुष चाड़ नहिं सरई ।' मा० १.२६६.४
सरऊ : सरजू (प्रा.) । 'प्रातकाल सरऊ करि मज्जन ।' मा० ७.२६.१
सरक : सं-स्त्री० (सं.)। (१) मार्ग की निरन्तर रेखा (सड़क) । (२) यज्ञ सम्बन्धी मदिरा, सोमरस । (३) मद की लहर, नशा । 'बय अनहरत बिभूषन बिचित्र अंग, जोहे जिय आवति सनेह की सरक सी ।' गी० १.४४.२
सरकस : (१) वि.पु. (फा० सरकश) । अहंकारी, विद्रोही (सिर काटने वाला मूल अर्थ है)। (२) सं० (फा० सरकशी)। विद्रोह, घमंड । 'काहू की सहत नाहिं सरकस हेतु है ।' कवि० ७.८२
सरखतु : सं००कए० (फा० सर-खत-सर-विजय+खत-पत्र)। विजय पत्र ।  'तुलसी निहाल के के दिये सरखतु हैं।' कवि० ६.५८
सरन : सं०० (सं० स्वर्ग) । देवलोक । मा० १.६.६
सरगु: सरग+कए० । 'सरगु नरकु जहँ लगि ब्यवहारू ।' मा० २.६२.७
सरघर : शर (बाणों) के घर तूणीर । गी० २.४५.३
सरजु, सरजू : सं०स्त्री० (सं० सरय) । अयोध्या होकर बहने वाली एक नदी । मा० २.१७०.४; १.१६.१
सरद : सं० स्त्री०+० (सं० शरद् +स्त्री०)। आश्विन+कार्तिक मासों का ऋतुविशेष । मा० १.३२.१२
सरदातप : सं०० (सं० शरदातप) शरद् ऋतु का तीखा घाम (कुवारा घाम)। मा० ४.१७.६
सरन : शरण । (१) आश्रय । (२) रक्षक । 'मोरें सरन राम की पनहीं।' मा० २.२३४.२ (३) प्रपत्ति, रक्षा हेतु प्रणिधान । 'राम सरन सब गे मन माहीं।' मा० २.२६५.२ (४) रक्षा । (५) शरणागत ।
सरनद : वि० (सं० शरणद) । रक्षा देने वाला, आश्रयदाता । विन० ७७.२
सरनपाल : शरणाबात का पालक, प्रपन्न-रक्षक । विन० २२२.४
सरना : सरन । आश्रय । 'तब ताकेउ रघनायक सरना ।' मा० ३.२६.५
सरनाईं : शरणागति में। 'जों सभीत आवा सरनाई।' मा० ५.४४.८
सरनाई : संस्त्री० (सं० शरणागति>प्रा० सरणाई) । शरण में आना, प्रपत्ति ।
सरनागत : (सं० शरणागत =शरण ! आगत) । शरण में आया हुआ, प्रपन्न । मा० ७.१४.२
1030
_______________________________________________
सरनाम : वि. (फा०) । प्रसिद्ध । 'तुलसी सरनाम गुलाम है राम को।'
सरनि, सरन्हि : सर+संब० । (१) सरोवरों में | 'सरनि सरोंज बिटप बन फले ।' मा० २.१२४.७ 'बिक से सरन्हि बहु कंज ।' मा० १.८६ छं० (२) बाणों से 'सरन्हि भरा मुख।' मा० ६.७१.३
सरनु : सरन+कए । एकमात्र आश्रय, रक्षक । 'सब ही को तुलसी को साहेबा __ सरनु भो।' कवि० ६.५६
सरपि : सं०० (सं० सर्पिष) । घी। मा० १.३२८
सरब : वि० (सं० सर्व)। सब, समस्त । विन० २६२.३
सरबगत : सर्वगत । विन० ४७.२
सरबग्य : सर्बग्य । मा० ६.१०२.४
सरबदा : सर्बदा । विन० ४७.२
सरब-बिद : वि० (सं० सर्वविद्) । सर्वज्ञ । गो० ७.२८.२
सरबरी : सं०स्त्री० (सं० शर्वरी) । रात्रि । गी० १.३८.२
सरबरीनाथ : चन्द्र मा । मा० २.११६
सरबरु : सं०० (सं० सरोवर>प्रा० सरवर) कए० (अ० सरवरु) । जलाशय । मा० १.१५८
सरबस : सं०० (सं० सर्वस्व) । सम्पूर्ण धन, सब-कुछ। 'मुनि जन धन सरबस ।' मा० १.१६८.२
सरबसु : सरबस+कए० । मा० २.२६.५
सरभंग, सरभंगा : सं०० (सं० शरभङ्ग) । एक तपस्वी मुनि । मा० ३.७; ८.८
सरम : सं०स्त्री० (सं० शर्म) । लज्जा । विन० २४६.२
सरल : (१) वि० (सं.)। ऋजु (वक्र का विलोम) । (२) निश्छल । मा० ७.५५.६ (३) वि० (सं० शटित>प्रा० सडिअ = पडिल्ल)। सड़ा हुआ, जर्जर। 'सरल तिकोन खटोला रे।' विन० १८६.२
सरलचित : वि० (सं० सरलचित्त)। सरल स्वभाव-युक्त । निश्छल । मा २.१८१
सरलता : सं०स्त्री. (सं.)। सीधापन, आर्जव, निश्छलता । मा० ७.३८.६
सरलै : सरल को, सीधे व्यक्ति को। 'सरले दंडे चक्र ।' दो० ५३७
सरव : पटेबाजी का खेल (१)। 'सरव करहिं पाइक फहराहीं।' मा० १.३०२.७ (१) सं०-रव रव सहित= सशब्द हाथों से पायक उछलते हैं। (२) पायक शख्य लक्ष्यवेध करते हैं और उच्छलते हैं ।
सरवर : सं०० (सं० सरोवर>प्रा० सरवर)। गी० १.६.५
_______________________________________________
1031
सरवाक : सं०० (सं० शराव, शरावक)। सरवा, सकोरा, मृत्पात्रविशेष । कवि० ५.२५
सरस : वि० (सं.)। रस-युक्त । (१) आर्द्र, सजल । 'तब सेवकन्ह सरस थलु देखा।' मा० २.३१०.५ (२) स्नेह युक्त । 'कह रिषिबधू सरस मृदु बानी।' मा० ३.५.४ (३) आनन्द भावना युक्त । 'बंधु सनेह सरस एहि ओरा।' मा० २.२४०.४ (४) कलात्मक सौन्दर्यानुभूति से युक्त । 'सरस राग बाजहिं सहनाई।' मा० १.३०२.६ (५) कामोद्दीपक भावयुक्त । 'सुनि रव सरस ध्यान मुनि टरहीं।' मा० ३.४०.६ (६) काव्यानन्द युक्त । 'निज कबित्त केहि लाग न नीका । सरस होउ अथवा अति फीका ।' मा० १.८.११ (७) मकरन्द युक्त +स्नेह-वात्सल्ययुक्त । 'सुरुचि सुबास सरस अनुरागा।' मा० १.१.१ (८) आनन्दमय । 'जग सरस जिन्ह की सरसई। गी० १.५.३
सरसइ : सं०स्त्री० (सं० सरस्वती>प्रा० सरसई)। प्रयाग-संगम की त्रिधारा में परिगणित (अदृश्य) नदी विशेष ।
सरसई : सं०स्त्री० (सं० सरसता>प्रा० सरसया>अ० सरसई)। रस सम्पूर्णता (दे० सरस) । (१) आर्द्रता । 'लहलहे लोयन सनेह सरसई है। गी० १.६६.२ (२) आनन्दमयता । 'जग सरस जिन्ह की सरसई ।' गी० १.५.३
सरसावति : वकृस्त्री० । सरस बनाती, आनन्दोत्कर्ष देती। गी० ७.१७.५
सरसिज : सं.पुं० (सं०)। कमल । मा० ७.२३.१०
सरसी : सं०स्त्री० (सं.)। छोटा सरोवर । मा० २.२५७.४
सरसीरूह : सं०० (सं.)। सरोरुह । कमल । मा० ६.६३.८
सरहना : सराहना । प्रशंसा । मा० २.२०१छं०
सरहि : सरोवर को। 'पंपा सरहि जाहु रघुराई।' मा० ३.३६.११
सराग : वि० (सं.)। रागयुक्त, आसक्तिपूर्ण । 'वासना सराग मोह द्वेष निबिड तम टरे।' विन० ७४.२
सराध, सराधा : सं०पू० (सं० श्राद्ध)। (१) पितृ कर्म (जो पितृलोकवासी अग्निष्वात्त आदि देवविशेषों (पितरों) के लिए अपने पूर्वजों को भी सम्मिलित कर किया जाता है)। 'द्विज भोजन मख होम सराधा ।' मा० १.१८१.८ (२) देव कार्य विशेष । 'नंदीमुख सराध करि ।' मा० १.१६३
सराधु : सराध+कए ० । पितृकार्य (पितृ संस्कार आदि) । 'सराधु कियो सबरी जटाइ को।' कवि० ७.२२
सरानल : (सर+अनल-दे० सर) बाणों की अग्नि+चिता की अग्नि । 'होहि कि राम सरानल खल कुल सहित पतंग ।' मा० ५.५६ ख
सराप : श्राप। शाप । मा० १.१३५.८
1032
_______________________________________________
सराफ : सं०० (अरबी-सर्राफ-सोना चांदी परखने वाला) । सोने चांदी का व्यापारी। मा० ७.२८ छं०
सरावग : सं०० (सं० धावक>प्रा० सावग) । जैन मतवादी, अणुव्रती जन । 'स्वान सरावग के कहें लघुता लहै न गंग ।' दो० ३८३
सरासन : सं०० (सं० शरासन-शर+असन-बाण फेंकने का साधन) । धनुष । मा० ३.२६
सरासनु : सरासन+कए । 'श्रवन प्रजंत सरासन तान्यो। मा० ६.७१.१
सरासुर : (सर+असुर-सं० शरासुर) । 'बाण' नामक असुर। 'सकइ उठाइ सरासुर मेरू ।' मा० १.२६२.७
सराह,→ सराहइ : आ०प्रए० (सं० श्लाघते>प्रा. सलहइ- सलाहइ) । प्रशंसा करता है। 'नृप सब भाँति सराह बिभूती।' मा० १.३३२.१ 'बकिहि सराहा मानि मराली।' मा० २.२०.४
सराहत : वकृ००। प्रशंसा करता-करते, सराहता-ते । 'नृपहि सराहत सब नर नारी।' मा० १.२८.७
सराहति : वकृ.स्त्री० । प्रशंसा करती। गी० ५.३४.३
सराहन : भकु० अव्यय । प्रशंसा करने। 'कपि बल बिपुल सराहन लागा।' मा० ६.८४.३
सराहना : सं-स्त्री० (सं० श्लाधना>प्रा. सलहणा, सलाहणा)। प्रशस्ति, स्तुति, गुणगान । 'बार बार सेवक सराहना करत राम ।' कवि० ६.४०
सराहसि : आ०मए० (सं० श्याघसे>प्रा० सलाहसि)। सराहता-ती है। 'तुहूं सराहसि करसि सनेहू।' मा० २.३२.७
सराहहिं : आ०प्रब० । प्रशंसा करते हैं । 'सकल सराहहिं प्रभु पद प्रीती।' मा० ७.८.४
सराहा : भूक.पु । प्रशस्त माना, प्रशंसायुक्त किया। मा० २.१७१.६
सराहि : पू० । सराहना करके । 'सत्य सराहि कहेहु बर देना।' मा० २.३०६
सराहिअ : आकवा०प्रए० (सं० श्लाघ्यते>प्रा० सलाहीअइ)। प्रशंसित किया जाय-की जाय । प्रशंसित किया जाता है-की जाती है। 'सुधा सराहिअ अमरता गरल सराहिम मीच।' मा० १.५
सराहिअत : वकृ००-वावा। सराहा जाता, सराहे जाते । 'चातक हंस सराहिअत ।' मा० २.३२४ ।
सराहिए, सराहिऐ : सराहिम । सराही जाय । 'तुलसी की साहसी सराहिए कृपाल राम।' कवि० ७.८१ 'सुमति सराहिऐ।' दो० ४४३
सराहिबे : भकृ.पु । सराहने, प्रशंसा करने ।' कवि० ७.२२
सराहिय, सराहिये : सराहिम । पा०म०७
_______________________________________________
1033
सराहियत : सराहिअत । गी० १.८८.१
सराही : (१) सराहि । 'गान करहिं निज सुकृत सराही।' मा० १.३४६.५ (२) भूकृ०स्त्री० । प्रशस्त की, सराहना की (हुई) । 'भगति मोरि मत स्वामि सराही।' मा० १.२६.३
सराहु, सराहू : आ० - आज्ञा-मए० (सं० श्लाघस्व>प्रा० सलाह>अ० सलाहु) । तू सराहना कर । 'पुनि सठ कपि निज प्रभुहि सराहू ।' मा० ६.२६.८
सराहे : भूक००० । प्रशंसित किये । 'देखि कृपा करि सकल सराहे ।' मा० ७.५०.४
सराहेउ : भूकृ.पु.कए० । प्रशंसित किया । कोसिक सुनि नप बचन सराहेउ राजहि ।' जा०म० २३
सराहेहु : आo-भूक००+मब० । तुमने सराहा, सराहे। 'जो अति सुभट सराहेहु रावन ।' मा० ६.२३.६
सराहैं : सराहहिं । प्रशंसा करते हैं । 'तुलसी सराहैं ता को भागु सानुराग सुर ।' कवि०२. १०
सराहै : सराहइ । 'तुलसी सराहे रीति साहेब सुजान की।' कवि० ६.४०
सरि : (१) सं०स्त्री० (सं. सरित>प्रा. सरि)। नदी। मा० ७.३५.६ (२) (सं० सदृश्>प्रा० सरि) समानता, सादृश्य, उपमा ।
सरित, सरिता : सरि । नदी। मा० १.४१.१, ३१.४
सरितन्ह, सरितन्हि : सरिता+संब० । नदियों (में) । 'सजल मूल जिन्ह सरितन्ह नाहीं।' मा० ५.२३.६; १.३०४.५
सरिबरि : संस्त्री० (सरि=सदृश् + बरि=वरता, श्रेष्ठता) । समान श्रेष्ठता, बराबरी । 'हमहि तुम्हहि सरिबरि कसि नाथा। कहहु त कहाँ चरन कह माथा।' मा० १.२८२.५
सरिस : (१) वि० (सं० सदश>प्रा० सरिस)। तुल्य । 'राम सरिस सुत कानन जोग ।' मा० २.५०.७ (२) अनुरूप, अनुसार । 'देस काल अवसर सरिस बोले रामु प्रबीन ।' मा० २.३१४
सरिसा : सरिस । मा० ५.१५.३
सरीकता : संस्त्री० (अरबी-शिरकत-शरीक+ता)। भाग, भागिता, अंश प्राप्ति में सम्मिलित होना । “रावरी पिनाक में सरीकता कहाँ रही।' कवि०
सरीखे : सारिखे । सदृश । 'बान बलवान जातुधानप सरीखे सूर ।' कवि० १.६
सरीर, सरीरा : सं.पु. (सं० शरीर>प्रा० सरीर) । देह । मा० १.३४; ७४.८
सरीरन्हि : सरीर+संब० । शरीरों (को)। मा० ५.३ छं. ३
1034
_______________________________________________
सरीरहि, सरीरही : शरीर को। मा० २.१४२.२ 'प्रभु कहेउ राख सरीरही।' मा०. ४.१० छं०१
सरीरु, सरीरू : सरीर+कए । मा० १.१०७.१, २.४१.३
सरीरं : सरीरहि । 'कहत यों...बिसराय सरीर ।' गी० ६.१५.१
सरीसा : सरिस । तुल्य । 'भरत सरीसा।' मा० २.२३१.८
सरु : सर+कए । (१) बाण । 'जो सुनि सरु अस लाग तुम्हारे।' मा० २.३०.३ (२) सरोवर । 'सकल सुकृत सरसिज को सरु है।' विन० २५५.१
सरुज : वि० (सं०) । (१) रोगी। 'सरुज सरीर बादि बहु भोगा।' मा० २.१७८.५ (२) क्षतियुक्त, क्षयी । जेहिं ससि कीन्ह सरुज सकलंक ।' मा० २.११६.३
सरुष : सरोष (सं० सरुष्) । क्रुद्ध, कुपित । मा० २.४.२
सरुहाए : भूकृ००ब० (सं० संरोहित>प्रा० सरुहाविय) । घाव पूर दिये । 'बिरह ब्रन अनख अमिय औषध सरुहाए।' कृ० ५०
सरूप, सरूपा : (१) सं+वि०पू० (सं० स्वरूप) । आकार । ‘सो सरूप नप कन्या देखा ।' मा० १.१३४.७ (२) रूपधारी, अभिन्न (रूपक) । 'तव सरूप गारुड़ि रघुनायक ।' मा० ७.६३.७ (३) एक ही रूप वाला (सं० सरूप)। 'अगुन सगुन दुइ ब्रह्म सरूपा ।' मा० १.२३.१ (४) रूप सहित, साकार, मूर्त । 'श्रीराम सगुन सरूप।' मा० ६.११३.७
सरूपु : सरूप+कए । स्वरूप, अपना यथार्थ रूप । “संकर सहज सरूपु सम्हारा ।' ___ मा० १ ५८.८
सरेन : (सं० शरेण>प्रा० सरेण) । बाण से। मा० ७.१४.७
सरै : सरइ । पूरा पड़ सकता है, सफल हो सकता है। जो पं कृपा रघुपति कृपाल ___ की बैर और के कहा सरै। विन० १३७.१
सरो : भूकृ००कए । पूरा हुआ। 'ताको काज सरो।' विन० २२६.५
सरोग : वि० (सं०) । रोगयुक्त, रुग्ण, रोगी । विन० १६१.३
सरोज : सं०० (सं०) । कमल । मा० १.१८.४
सरोजजा : कमल से उत्पन्न । विन० १७.१
सरोजनि : सरोज+संब० । कमलों (से) । जा०म० ६४
सरोजा : सरोज । मा० १.२८८.४
सरोबर : सरोवर । मा० १.३०७.८
सरोरुह : सं०० (सं०) । कमल । मा० १.१४६
सरोवर : सं०पू० (सं०) । श्रेष्ठ जलाशय । मा० ३.३६.६
सरोष : वि० (सं०) । कोपयुक्त । मा० २.२५ छं.
_______________________________________________
1035
सरोषा : सरोष । मा० १.४.८
सर्करा : सं०स्त्री० (सं० शर्करा) । शकर । 'ज्यों सर्करा मिले सिकता मह ।' विन १६७.३
सर्प : सं०० (सं.)। सांप । मा० ७.६३.६
सर्पराज : शेषनाग । मा० ५.३५ छं० २
सर्पी : सरपि । घी । 'सलिलु सपी समान । कवि० ५.२०
सर्पेश : सर्पराज (सं०) । विन० १८.४
सर्ब : (१) वि० (सं० सर्व)। सब। (२) सं०० (सं० शर्व)। शिव । 'सर्ब सर्बगत सर्व उरालय ।' मा० ७.३४.७ (शिवरूप तथा समस्त रूप)।
सर्बग : वि० (सं० सर्वग) । सर्वगत, सर्वव्यापी । विन० १२.५
सर्बगत : वि० (सं० सर्वगत) । सर्वव्यापी, अन्तर्यामी । मा० ७.१६
सर्बग्य : सर्वज्ञ । (१) अन्तर्यामी रूप से सबका ज्ञान रखने वाला ईश्वर । 'प्रभु सर्बग्य ।' मा० ७.१२ ग (२) अधिक विषयों का पूर्ण ज्ञान रखने वाला। 'कोउ सर्बग्य धर्मरत कोई।' मा० ७.८७.३
सर्बत्र : अव्यय (सं० सर्वत्र) । सब कहीं । मा० १.१८५.६
सर्बदा : सर्वदा । मा० १.९८ छं०
सर्बनाथ : सम्पूर्ण चराचर जगत का स्वामी सर्वेश्वर । मा० ७.१०८ छं० ८
सर्बपर : सम्पूर्ण जगत्प्रपञ्च से परे= लोकातीत । मा० ३.१५
सर्बरूप : वि० (सं० सर्वरूप) । विश्वरूप, सर्वात्मा, सभी रूपों में स्वयं रूप लेने ___ वाला (जगत् ईश्वर का ही अंश है) । मा० ५.५०.३
सर्बस : सरबस । सब कुछ। मा० १.२०८.३
सर्बसु : सर्बस+कए० । सब धन, सम्पूर्ण सम्पत्ति । 'सर्बसु खाइ भोग करि नाना ।' मा० ६.४२.८
सर्बहित : सबका हितकारी मा० ७.१६
सर्वा : सर्ब । मा० १.६१.२
सर्व : सम्पूर्ण । मा० १ श्लोक २
सर्वकृत : वि० (सं० सर्वकृत) । सबका कर्ता । विन० ५६.४
सर्वगत : सर्वव्यापी । मा० २ श्लोक १
सर्वजित : वि० (सं० सर्वजित् ) । सर्व-विजयी, सर्वोपरि सत्ता वाला। विन० ५६.४.
सर्वज्ञ : वि० (सं०) । सम्पूर्ण चराचर का ज्ञाता । विन० ५६४
सर्वतोभद्र : सं०पू० (सं.) । सब ओर कल्याण; व्यापक मङ्गल । 'सर्वतोभद्र निधि ।' विन० ५३.१ ।
सर्वतोभद्रदाता : सब ओर (सम्पूर्ण) कल्याण देने वाला। विन० ५१.८
1036

सर्वदा : अव्यय (सं०) । सदा । मा० ७.१०८.१५
सर्वनाथ : सर्वेश्वर, सबका स्वामी । मा० ७.१०८.८
सर्वभूताधिवास : सम्पूर्ण जड़-चेतन में व्याप्त परमेश्वर; सबका अधिष्ठान, ___ सर्वाधार । मा० ७.१०२.४
सर्वभूत : वि० (सं० सर्वभूत) । सबका धारणकर्ता तथा पोषणकर्ता। विन० ५६.४
सर्वमेवात्र : (सं०-सर्वम् एव अत्र) । यहाँ सभी कुछ; सभी जागतिक तत्त्व । विन० ५४.३
सर्ववासी : वि० सं० सर्ववासिन)। सब में निवास करने वाला-अन्तर्यामी ! विन० ५५.७
सर्वहित : वि० (सं०) । सभी का हितकारी । विन० ५६.४
सर्वांग : सभी अङ्गों का समवाय-समस्त काय । विन० ६१.६
सर्वेश : वि.+सं० (सं०) । सबका स्वामी परमेश्वर विन० ५३१
सलखन, सलछिमन : लक्ष्मण सहित । गी० ५.४.१, ५.५०.५
सलज्ज : वि० (सं.)। लज्जाशील, मर्यादा पालन की सद्वृत्ति वाला। मा० ६.२६.५
सलम : सं०० (सं० शलभ)। टिड्डी, पतङ्ग। मा० ७.११७ घ
सलाक : संस्त्री० (सं० शलाका) । सलाई; लम्बी छड़ । 'कनक सलाक, कला ससि, दीपसिखाउ ।' बर० ३१ ।।
सलिल : सं०० (सं०)। जल । मा० ६.६१.१७
सलिलु : सलिल+कए० । मा० २.४२
सलीले : क्रि०वि० (सं० सलीलम >प्रा० सलीलं=सलीलयं) । खेल खेल में । 'पटके सब सूर सलीले ।' कवि० ६.३२
सलोनि, सलोनी : वि०स्त्री० (सं० सलावण्या>प्रा० सलोणी)। लावण्ययक्ता, चमत्कारी (तीखे) सौन्दर्य वाली । 'रूप सलोनि तँबोलिनि ।' रान०६
सलोने : वि०० ब० (सं० सलावण्य>प्रा० सलोण)। लावण्ययुक्त, सुन्दर । 'राजकुअर दोउ सहज सलोने ।' मा० २.११६.८
सलोनो : वि०पु०कए ० । लावण्ययुक्त, सुन्दर । 'गोरे को बरनु देखें सोनो न सलोनो ___ लागे।' कवि० २.१६
सवँदरसी : समदरसी (अ० सम=स) । मा० १.३०.६
सव : सं०० (सं० शव) । मृतक शरीर, लोथ । मा० १.११३.५
सवति : (१) संस्त्री० (सं० सपत्नी>प्रा० सवत्ती>अ० सवत्ति)। एक पुरुष की अनेक पत्नियां परस्पर सपत्नी (सौत) होती हैं =समानपतिका । (२) (सं० सपत्नी सपत्न स्त्री शत्र) । 'जरि तुम्हारि चह सवति उखारी।' मा० २.१७.८
_______________________________________________
1037
सवतिआरेसू : (सवतिआ+रेसू) सं.कए. (सं० सपत्निकारेषः-रेष-रोष >प्रा० सवत्तिआरेसो>अ. सवत्तिआरेस)। सौतिया डाह, सपत्नीभाव की प्रतिहिंसा । 'कबहुं न कियह सवतिआरेसू ।' मा० २.४६.७
सवांग : स्वाँग । सं०पू० । अभिनय, लीला, भांड़ों आदि की नकल; विविध वेष प्रदर्शन । हिलि मिलि करहिं सर्वाग ।' रा०न० १८
सवाँरि : पूकृ० (सं० समाच्य>प्रा. समारिअ>अ० सारि)। बनाकर, रचकर । 'काहे को कहत बचन सारि ।' कृ० ५३
सवाँरें : दे० संवारें । मा० १.१५२.१
सवाई : वि. (सं० सपाद>प्रा० सवाय) । सवाया, अधिक । 'दोना बाम करनि सलोने भे सवाई हैं।' गी० १७१.१ ।।
सवारे : क्रि०वि० (सं० श्वोवारे>प्रा० सवारे) । सबेरे, प्रातः। 'जगावति कहि प्रिय बचन सवारे।' गी० २.५२.२
सशक्ति : वि० (सं.)। शक्तिसहित (राम की आद्याशक्ति सीता के समेत)। 'भजे सशक्ति सानुजं ।' मा० ३.४.१२
सस : (१) सं०० (सं० शश>प्रा. सस)। खरगोश । मा० ३.२८.१५ (२) (सं० सस्य = शस्य>प्रा० सस्स) । खेत में लगा हुआ अन्न, फसल । 'सुख सस सुर सींचत देत निराइ के।' गी० ५.२८.६
ससंक, ससंका : वि० (सं० सशङक) । शङकाकुल, शङ्कित (आतङिकत)। 'रावन सभा ससंक सब ।' मा० ६.१३, ५.४.५
ससंकित : ससंक (सं० सशङिकत) । सशङक हुआ = शङका व्याप्त । 'सब लंक ___ ससंकित सोरु मचा ।' मा० ६.१५ ।।
ससंकेउ : वि०पू०कए० (भूक०)। शङ्कासहित हुआ, प्राणरक्षा के संशय में पड़  गया, ससेट गया । 'सिवहि बिलोकि ससंकेउ मारू ।' मा० १.८६.२
ससांक : सस (सं० शशक) । खरगोश । मा० २.६७.७
ससचिससांकससांकव : सचिव सहित । कृ०६१
ससांक : शशाङक । चन्द्रमा । गी० १.३८.२
ससि : (१) सं०० (सं० शशिन्) । चन्द्रमा । मा० १.७ ख (२) (सं० शस्य= सस्य)-दे० सस । 'ससि सम्पन्न सोह महि कैसी ।' मा०४.१५.५
ससिभूषन : सं०० (सं० शशिभूषण)। शिव । मा० १.१०८.४
ससिसेखर : सं०० (सं० शशिशेखर) । शिव । पा०म०/० ५
ससिहि : चन्द्रमा को । 'अजहुँ देत दुख रबि ससिहि ।' मा० १.१७०
ससीय : (दे० सीय)। सीतासहित । मा० २.११२.२
ससु : सस+कए । एक कोई खरगोश । 'जिमि ससु चहै नाग अरि भाग ।' मा० १.२६७.१
1038
_______________________________________________
ससुर : सं०० (सं० श्वशुर>प्रा० ससुर)। (१) पति का पिता। मा० २.५८ (२) पत्नी का पिता । मा० १.३४२.७
ससुरारि, ससुरारी : सं०स्त्री० (सं० श्वशुरालत) । ससुगल। (१) पत्नी पिता का घर। मा० ७.१०१.५ (२) पति-पिता का घर । 'पतिगह कबहुं कबहुं ससुरारी।' मा० २.१२.५
ससुरु : ससुर+कए । अद्वितीय श्वशुर । 'ससुरु एताहस अवध निवासू ।' मा० २.६८.५
ससुरें: (दे० सासुर) ससुराल में । 'मइके ससुरें सकल सुख ।' मा० २६६
ससोक : वि० (सं० सशोक) । शोकयुक्त, दीनहीन, सकरुण । मा० २.२७६.१
ससोच : वि० । सोच से युक्त =चिन्तित+शोकयुक्त । मा० २.१५९.६
सस्त्र : सं०पू० (सं० शस्त्र) । धारदार आयुध (खड्ग आदि) । मा० ३.१९ क
सस्त्री : वि.पु. (सं० शस्त्रिन्) । शस्त्रधारी। मा० ३.२६.४
सहँगे : वि.पु.ब० । सस्ते (महंगे का विलोम)। अल्प मूल्य से प्राप्य । 'मनि मानिक महंगे किए सहगे तन जल नाज ।' दो० ५७३
सह : (१) सहइ । 'परहित निति सह विपति बिसाला ।' मा० ७.१२२.१६ (२) अव्यय (सं.)। साथ । '
सह, सहइ, ई : आ०ए० (सं० सहते>प्रा० सहइ) । सहन करता है-करती है। 'सब कर पद प्रहार नित सहई ।' मा० ७.१०६.११
सहउँ, सहऊँ : आ० उए । सहता हूं । मा० १.२७२.५; ६.२२.४
सहगामिनिहि : सहगामिनी (सती होने वाली) स्त्री को। 'मंगल सकल सोहाहि न कसें । सहगामिनिहि बिभूषन सें।' मा० २.३७.७ (सं० सहगामिनी उस स्त्री को कहा जाता है जो मृत पति के साथ सती हो जाती है)।
सहज : (१) वि० (सं०) । सहजात, जन्मजात । (२) प्राकृतिक, स्वाभाविक । 'खग मग सहज बयरु बिसराई।' मा० ७.२३.२ (३) सं० । स्वभाव । 'कुटिल न सहज बिहाइ ।' दो० ३३४
सहजहिं : सहज भाव से ही, स्वभावतः । 'सहजहिं चले ।' मा० १.२५५.५
सहजहुं : सहज भाव से भी । 'सहजहुँ चितवत मनहुं रिसाते ।' मा० १.२६८.६
सहजु : सहज+कए। स्वभाव, शील । 'जारेहुं सहजु न परिहर सोई ।' मा० १.८०.६
सहजेहिं : स्वभावतः ही, सरलता से ही (अपने आप ही) । तेहि प्रसंग सहर्जेहिं बस देवा ।' मा० १.१६६.२
सहत : वपु । सहन करता-करते । “सहत दुसह बन आतप बाता।' मा० ४.१.६
सहति : वकृ०स्त्री० । सहन करती। गी० ५.१७.१
_______________________________________________
1039
सहतेउँ : क्रियाति०० उए० । चाहे मैं सह लेता। 'बरु अपजस सहतेउँ जग माहीं।' ___मा० ६.६१.१२
सहन : सं०० (अरबी)। आंगन या द्वार का खुला भू-भाग । 'जिय की परी, संभार सहन भंडार को।' कवि० ५.१२
सहनाइन्ह : सहनाई+संब० । शहनाइयों (के साथ)। 'करहिं सुमंगल गान सुघर सहनाइन्ह ।' पा०म० १३६
सहनाईं : सहनाई+ब० । शहनाइयाँ । 'सरस राग बाजहिं सहनाई।' मा० १.३०२.६
सहनाई : संस्त्री० (फा० शहनाई) सरना-नामक वाद्यविशेष । 'सरना' का सम्बन्ध (सं०) 'स्वरण' से है अतः स्वर-संघात वाले समुदित वाद्य विशेष को 'शहनाई कहा जाता है। इसकी निष्पत्ति 'सहनाद' से मानी जा सकती है-यद्यपि फारसी शब्द का 'शह' संभवतः 'शाह से संबद्ध है । मा० ६.७६.६
सहनि : सं०स्त्री० । सहन करने की क्रिया। ‘सील गहनि, सब की सहनि, कहनि हीय, मुख राम ।' वैरा० १७
सहब : भक०पु. (सं० सोढव्य>प्रा० सहिअव्व) । सहना (होगा)। 'सो मैं सुनब सहब सुखु मानी ।' मा० २.१८२.४
सहबासी : वि.पु. (सं० सहवासिन्)। साथ रहने वाला-वाले, सहचारी। 'सहबासी काचो गिलहि । दो० ४०४
सहम : सं०स्त्री० (फा०-सहम = उर) । अनिष्ट की प्राप्ति या आशङका से उत्पन्न त्रास, जड़ता, कम्प, रोमाञ्च आदि का सम्मिलित अनुभाव । 'समुक्षि सहम मोहि अपडर अपनें ।' मा० १.२६.२
सहमत : सहम+वकृ०पु० । सहम जाते हैं, घबरा उठते । तेरी बाल केलि बीर सुनि सहमत धीर ।' हनु० २८
सहमि : (१) सप्तम+पू । सहम कर, जड़वत् होकर । 'कहि न सकइ कछु सहमि सुखानी।' मा० २.२०.१ (२) भूक०स्त्री० । सहम गई। 'सहमि सुखि सुनि सीतलि बानी ।' मा० २.५४.२
सहमे : सहम+भूकृ.पु.ब० । सहम गये। 'सुनि सहमे परि पाय कहत भए दंपति ।' पा०म० १८
सहमेउ : भूकृ००कए । सहम गया, ठक रहना । 'सुनि सुठि सहमे उ राजकुमारू।' मा० २.१६१.५
सहर : सं० (फा शहर)। नगर । कवि० ७.१७०
सहरषा : (सं० सहर्ष) । मा० २.१६१.२
सहरी : सफरी (प्रा०) । कवि० २.८
सहरु : सहर+कए । नगर । विन० २५०.१
1040

सहरोसा : क्रि०वि० । (१) प्रबलता के साथ, बल देकर । 'सुनु मुनि तोहि कहउँ सहरोसा।' मा० ३.४३.४ (२) हर्षपूर्वक, अवश्य ही। 'सर्बस देउँ आज सहरोसा ।' मा० १.२०८.३
सहस : (१) सहस्र । मा० १.२५१.१ (२) क्रि०वि० (सं०) हस-हर्ष के साथ।  'सनमुख होत जो राम पद करइ न सहस सहाइ ।' दो० १३९
सहसनयन : (१) सं०पू० (सं० सहस्रनयन) । सहस्राक्ष = इन्द्र । सहस नयन बिन लोचन जाने ।' मा० २.२१८.१ (२) हजार आंखें । 'सहसनयन पर दोष निहारा ।' मा० १.४.११
सहसनाम : सं०० (सं० सहस्रनाम) । महाभारत में 'विष्णु सहस्रनाम' स्त्रोत । मा० १.१६.६
सहसफन : हजार फणों वाला=शेषनाग । गी० ७.१६.८
सहसफनी : सहसफन । गी० ७.२०.२
सहसबाहु : सं०० (सं० सहस्रबाहु)। हैहयवंश का राजा अर्जुन जिसके हजार भुजाएँ कही गयी हैं । मा० ६.२६.८
सहसभुज : सहसबाहु । मा० ६.६.८
सहससीसु : सहससीस+कए० (दे० सहस्रसीस) । शेष । मा० २.१२६ छं०
सहसहुं : हजारों, सहस्रों से भी । 'सहसहुं मुख न जाइ सो बरनी ।' मा० ५.३०.५
सहसा : क्रि०वि० (सं.)। अकस्मात्, बिना सोचे बिचारे । 'सहसा जनि पतिआहु।' मा० २.२२
सहसाखी : संस्त्री (सं० सहस्राक्षि>प्रा० सहस्सक्खी) । हजार आँखों से । 'जे पर ___ दोष लखहिं सहसाखी।' मा० १.४.४
सहसानन : सं०० (सं० सहस्रानन) । हजार मुखों वाला=शेष । मा० ६.२६.७
सहस्र : संख्या (सं.)। हजार । मा० ७.५४.१
सहस्रसीस : (दे० सीस) हजार सिरों (फनों) वाला । शेषनाग । मा० १.१७.७
सहहिं, सहहीं : आ०प्रब० । सहते हैं । 'संत सहहिं दुख पर हित लागी।' मा० ७.१२२.१५, २.१३१.१
सहहु, सहहू : आ०मब० । सहो, सहन करो। 'जनि रिस रोकि दुसह दुख सहह ।' मा० १.२७४.७
सहा : भूक०पु० । सहन किया । 'मैं दुख दुसह सहा है।' गी० २.६४.३
सहाइ, सहाई : सहाय । (१) सहचर, साथी, अवसर पर साथ देने वाला । (२) (सं० साहाय्य)। सहायता । 'जौं संकर सत करहिं सहाई।' मा० ६.७५.१४ (३) सं० स्त्री० । साथ-संग, संगति । 'सोइ रावन कहुँ बनी सहाई।' मा० ५.३८.१
_______________________________________________
1041
सहाए : (१) सहाय+ब० । मा० २.२३३.४ (२) भूक००ब० । सहन कराये। ___'जेहि बिधि मोहि दुख दुसह सहाए।' मा० ६.६६.८
सहानुज : सानुज । मा० १.३०८.७
सहाय, सहाया : (१) सं०पू०+वि० (सं० सहयाति गच्छतीति सहाय:) । सहचर, साथ देने वाला, सहायक । 'भइ सहाय सारद मैं जाना।' मा० ५.२५.३ (२) (सं० साहाय्य) । सहायता । 'बूढ़ भयउँनत करतेउँ कछुक सहाय तुम्हार ।' मा० ४.२८ (३) (समासान्त में) सहकृत, सहित । 'भास सत्य इव मोह-सहाया ।' मा० १.११७.८
सहाव, सहावइ : आ.प्रए० (सं० साहयति>प्रा. सहावइ)। सहाता है, सहन कराता है, सहने को विवश करता है। 'दुसह दुख देउ सहावइ काहि ।' मा० २.२६२
सहावहु : आ०मब० । सहन कराओ। 'सब दुख दुसह सहावहु मोही ।' मा० २.४५.२
सहावा : (१) भूक०० । सहाया, सहन कराया, सहने को विवश किया। 'आजु दया दुख दुसह सहावा ।' मा० १.२८०.३ (२) सहावइ । 'सो सबु सहिअ जो देउ सहावा।' मा० २.२४६.६
सहावै : सहावइ । सहने को विवश करे, सहन कराए। 'तुलसी सहावै बिधि सोई सहियतु है ।' कवि० २.४ ।
सहि : (१) पू० । सह कर । 'जो सहि दुख पर छिद्र दुरावा ।' मा० १.२.६ (२) सहिहि । सहेगा। 'सहि कि दरिद्र जनि दुख सोई ।' मा० १.१०८.३ (३) सही। सचमुच । 'देखौं सपन कि सीतख ससिसेखर सहि ।' पा०म० ६६
सहिअ : आ०कवा०प्रए० (सं० सह्यते>प्रा० सहीअइ) । सहिए, सहा जाय, सहना पड़ता है । 'सो सबु सहिअ जो देउ सहावा ।' मा० २.२४६.६ ।
सहिउँ: आ०----भूक०स्त्री०+उए । मैंने सही; सहन की। 'सो सुनि समझि सहिउँ सब सूला।' मा० २.२६२.३
सहित : (१) वि० (सं०) । समेत, युक्त । 'उमा सहित जेहि जपत पुरारी।' मा० १.१०.२ (२) क्रि०वि० (सं.)। हित युक्त । 'बरसत सुमन सहित सुर-सैया।' कृ० १६
सहिदानी : सं०स्त्री० (सं० स्वभिज्ञान>प्रा० साहिणाण)। (१) स्वपरिचय चिह्न । 'दीन्हि राम तुम्ह कह सहिदानी।' मा० ५.१३.१० (२) लक्षण, पहिचान । 'तुलसी यहै सांति सहिदानी ।' वैरा० ५१
सहिदानु : सहिदानी-सं००कए० । पहिचान, लक्षण । संतराज सो जानिए तुलसी ____ या सहिदानु ।' देरा० ३३
साहिबे : भक०पू० । सहने को। 'सांसति ही सहिबे ही।' कृ. ४०
1042

साहिबो : भकृ००कए० (सं० सोढव्यम् >प्रा० सहिअव्वं>अ० सहिव्वउ) । सहना (होगा)। दिन दस और दुसह दुख सहिबो।' गी० ५.१४.१ ।।
सहियतु : वकृ००कवा०कए० । सहा जाता, सहना पड़ता । 'तुलसी सहावै विधि सोई सहियत है।' कवि० २.४
सहिहहिं : आ०भ० प्रब० । सहेंगे । 'दुख सहिहहिं पावर प्रान ।' मा० २.६७
सहिहि : आ०भ०प्रए० (सं० सहिष्यति>प्रा० सहिहिइ) । सहेगा । 'सहिहि निठुर ____ कठोर उर मोरा ।' मा० ६.६१.१३
सहिहौं : आ०भ० उए । सहूंगा। सब सहे दुसह अरु सहिहौं ।' विन० २३१.२
सहिही : आ०भ०मब० । सहोगे। गी० २.५.२
सही : (क) (१) भूक०स्त्री० । सहन की। 'हम अबलनि सब सही है।' कृ० ४२ (२) सहि (पूकृ०)। 'सही न जाइ कपिन्ह के मारी।' मा० ६.८६.६ (ख) (अरबी-सहीह) (१) निर्दोष। 'पुर सोभा सही।' मा० १.६४ छं. (२) ठीक-ठीक । 'अबला निरखि बोले सही।' मा० १.८७ छं० (३) निर्दोष होने का प्रमाणभूत हस्ताक्षर आदि । 'परी रघुनाथ हाथ सही है।' विन० २७६.३ (४) समर्थन, अनुमोदनात्मक स्वीकृति । 'सही भरी लोमस भुसंडि बहु बारिखो।' कवि० १.१६ (५) अवश्य । 'गति पैहहिं सही।' मा० ५.३ छं० ३ (६) भले ही । 'प्रभु कह देन सकल सुख सही । भगति आफ्नी देन न कही।' मा० ७.८४.४ (७) वस्तुतः। 'भाग्य बड़ तिन्ह कर सही।' मा० १.६५ छं० (८) यथार्थ, वास्तविक । 'मारुत मदन अनल सखा सही।' मा० मा० १.८६ छं०
सहीजै : (१) आ०कवा०प्रए । सहिअ (प्रा० सहिज्जइ) । सहा जाय, सहन करना पड़ता है । 'हारेहु मानि सहीजै ।' कृ० ४५ (२) सही। समर्थन । 'परी मनो प्रेम सहीजै ।' गी० ३.१५.४
सहें : सहने में, सहन करने से । 'सहे समुझे भलाई है ।' गी० ५.२६.२
सहे : (१) भूक००ब० । सहन किये। 'हठ बस सब संकट सहे ।' मा० २.६१ (२) सहें । 'समुझे सहे हमारो है हित ।' कृ. २७
सहेउँ : आ०-भकृ००+उए० । मैंने सहे। 'सहेउँ कठोर बचन सठ तेरे ।' मा० ६.३०.४
सहेउ : भूकृ००कए । सहा, झेल लिया। 'सन्मुख राम स हेउ सोइ सेला।' मा० ६.६४.२
सहेतू : वि० (सं० सहेत) । हेतयक्त, सकारण, सप्रयोजन, सार्थक । 'नारद बचन सगर्भ सहेतू ।' मा० १.७२.३
सहेली : सं+वि०स्त्री० (सं० सहभवा>प्रा० सहेल्ली) । साथ रहने खेलने वाली, सहचरी । 'मुदित मातु सब सखी सहेली ।' मा० २.१.७
_______________________________________________
1043
सहेहु : आ०-भक००+मब० । तुमने सहा-सहे। 'सहेहु दुसह हिम आतप बाता ।' मा० ६.६१.४ ।
सहै : (१) सहइ । सहन करे, सहता है। 'लात के अघात सहै।' कवि० ५.३ (२) भकृ० अव्यय । सहने को। 'बाली रिपु बल सहै न पारा ।' मा ४.६.३
सहैगो : आ० भ०पू०प्रए । सहेगा । 'तुलसी परमेस्वर न सहेगी ।' कृ० ४२
सहोदर : सं०+वि०० (सं.)। एक माता से उत्पन्न । भाई । 'मिलइ न जगत सहोदर भ्राता।' मा० ६.६१.८
सहौं : सहउँ । सहती हूं। 'गोरस हानि सहीं न कहीं कछु ।' कृ० ३
सहोंगो : आ.भ.पु उए । सहूंगा । 'सुनि सानंद सहौंगो।' गी० २.७७.२
सहौ : सहहु । 'के यह हानि सहो ।' कवि० ७.५६
सह्यो : सहेउ । 'तनु राखि बियोग सह्यो है।' गी० ४.२.४
साँइ, साँई : साईं।
साँकरे : (१) सं०० (सं० संकट>प्रा० संकड=संकडय)। (२) क्रि०वि० (सं. संकटे>प्रा० संकडे) । संकट में । 'सको सबै पै राम रावरे कृपा करी।' कवि० ७.६७
साँगि, साँगी : सं०स्त्री० । आयधविशेष, शक्ति नामक प्रहरण । 'बीर घातिनी छाँडेसि सांगी.. मुरुछा भई सक्ति के लागें ।' मा० ६.५४.७-८
साँच, साँचा : वि०+क्रि०वि० (सं० सत्य>प्रा० सच्च)। सत्य, यथार्थ, वस्तुतः । ___'स्वारथ सांच जीव कहुं एहा ।' मा० ७.६६.१ 'अब यह मरनिहार भा साँचा।' मा० १.२७५.४
साँचि : सोची। तब तें आज साँचि सुधि पाई।' मा० १.२६१.७
साँचिअ, साँचिये : (१) सच्ची ही। 'कहैं हम साँचिअ ।' पा०म०१०७ (२) सच, ___मुच ही । 'साँचियं परंगी सही।' विन० २५४.३
साँचिली : साँची (प्रा. सच्चिली)। सच्ची । 'साँचिली चाह ।' दो० ८०
साँचिलो : साँचो (प्रा० सच्चिल्लो) । सच्चा । 'साँचिलो सनेह ।' दो० ३१८
साँचिहुं : सच्ची.. में भी । 'साँचिहुं सपथ अघाइ अकाजु ।' मा० २.२११.१
साँची : वि० स्त्री० (सं० सत्या>प्रा० सच्ची) । सच्ची, सच बात। 'हरषी सभा बात सुनि साँची ।' मा० १.२६०.६ 'अब सब साँची कान्ह तिहारी।' कृ०६
साँच : साँच+कए । सत्य, यथार्थ बात । 'कहउँ साँचु सब सुनि पतिआहू ।' मा० २.१७६.१
साँचे : वि०पू०ब० । सच्चे । मा० २.१६८
साँचेहुं : सच में ही, वास्तव में ही । 'साँचेहुं कीस कीन्ह पुर दाहा।' मा० ६.२३.७
साँचो : (१) साँच+कए । सच्चा। हुतो न साँचो सनेह ।' कृ० ३६ (२) सं०पू०कए। सांचा (जिस में मिट्टी आदि भर कर मूर्ति आदि बनाते हैं)। 'सोभा को साँचो सँवारि, रूप जातरूप ढारि, नारि बिरची बिरंचि, संग सोही ।' गी० २.२०.३
साँझ : सं०स्त्री० (सं० सन्ध्या>प्रा० संझा) । सायंकाल । मा० ६.३५
साँठे : भूकृ०पु० ब० (सं० श्रन्थित>प्रा. संठिय) । बंधे हुए, नथे हुए (साँठ-गांठ में फंसे हुए)। 'बलि बालि गए चलि बात के सांठे।' कवि० ६.२८
साँति, साँती : सांति । 'बिन अधार मन तोष न सांती।' मा० २.३१६.२
साँथरी : सं०स्त्री० (सं० संस्तर>प्रा० संथर) साथरी। बिस्तर, घास-फूस का बिछावन । मा० २.८६.७
साँधा : भूकृ०० (सं० संहित>प्रा० संधिअ)। (१) संधान किया, चढ़ाया। 'ब्रह्म अस्त्र तेहिं साँधा।' मा० ५.१६ (२) पकाया, पकाते समय मिला दिया। 'तेहि महं विप्र मासु खल सांधा ।' मा० १.१७३.३
साँध्यो : साँधा+कए० (सं० संहितः>प्रा० संधिओ) । संधान किया, चढ़ाया। ___ 'दूसरो सरु न साँध्यो।' कवि० ६.४
साँप : सं०० (सं० सर्प>प्रा० सप्प) । मा० २.५५.३
साँपन, साँपनि : सांप+संब० । साँपों। साँपनि सों खेलें ।' कवि० ५.११
साँपिनि : सं०स्त्री. (सं० सर्पिणी>प्रा० सप्पिणी)। मा० ७.७१.४
साँवर : वि०पू० (सं० श्यामल>प्रा० सामल>अ. सावल)। श्यामवर्ण । रान० १२
साँवरि, साँवरी : साँवर+स्त्री० (अ० सावली)। श्यामवर्ण वाली। निरखि निरखि हिय हरहिं मूरति साँवरि ।' जा०म० १६५.
साँवरीं : श्यामवर्ण वाली...ने। कियो बिदेहु मूरति साँवरी। मा० १.३२४ छं० ४.
साँवरे : ('साँवर' का रूपान्तर)। (१) श्याम वर्ण वाले । 'साँवरे गोरे सलोने सुभाय ।' कवि० २.१६ (२) श्रीकृष्ण । कृ० १६ ।
साँवरो: साँवर+कए० (सं० श्यामल:>प्रा० सामलो>अ० सावलो)। मा० १.२३६ छं.
साँसति : (१) सासति । (२) संस्त्री. (सं० श्वासात्ति>प्रा० सासत्ति) । सांस उखड़ने की व्यथा, तत्तुल्य मनोव्यथा । 'तुलसी प्रभुहि तुम्हहि हमहूं हिय सांसति सी सहिब ही।' कृ० ४०
सा : सर्वनाम स्त्री० (सं०) । वह । मा० २ श्लोक २
सांख्य : सं० (सं०) । कपिल द्वारा प्रवर्तित दर्शनशास्त्र जिसमें प्रकृति-पुरुष विवेक (संख्या) को कैवल्य का कारण मानकर २५ तत्त्वों की व्याख्या की गई है । मा० १.१४२.७
सांत : वि० (सं० शान्त) । (१) शान्तियुक्त । 'सांत बेषु करनी कठिन ।' मा० १.२६८ (२) शमयुक्त-दे० सम। (३) समाहितचित्त, एकाग्र । (४) निर्विकार, पूर्ण, व्यापक, अविचल, कूटस्थ । 'सांत सुद्ध सम सहज प्रकासा।' मा० १.२४२.४
सांतरस : (सं० शान्तरस) । काव्य का नवम रस जिसका स्थायी भाव 'शम' होता है और तत्त्वज्ञान आलम्बन रहता है। इसे सम्पूर्ण विकारात्मक मनोवेगों की शान्तिदशा कहा गया है। मा० २.२७५
सांतरसु : सांत रस-+कए । केवल शान्तरस । 'धरें सरीर सांतरसु जैसें ।' मा. १.१०७.१
सांति : सं०स्त्री० (सं० शान्ति) । (१) चित्त की पूर्ण मात्त्विकदशा, शमदशा जिसमें दुःख और मोह का पूर्ण शमन हो जाता है । ‘सांति सुमति सुचि सुदर रानी।' मा० २.२३५.७ (२) ताप शमन । (३) वैदिक शान्तिमन्त्र । 'सांति पढ़हिं महिसुर ।' मा० १.३१६.६
साइँ : साईं।
साइँदोह : वि.पु. (सं० स्वामिद्रोह-स्वामिने द्रुह्यति यः>प्रा० सामिदोह) । स्वामी के प्रति द्रोहशील, स्वामी से वैर रखने वाला । 'साइंदोह मोहि कीन्ह कुमाता । मा० २.२०१.६
साइँदोहाइँ : साइंदोहाई में; स्वामिद्रोह भावना में; स्वामि के प्रति वैर भाव में । 'मोहि समान मैं साइँदोहाइँ।' मा० २.२६८.४
साइँदोहाई : सं०स्त्री० (सं० स्वामिद्रोहता>प्रा. सामिदोहया) । स्वामी के प्रति द्रोह करने की भावना । 'स्वामी की सेवक-हितता सब, कछु निज साईदोहाई। मैं मति तुला तौलि देखी, भइ मेरिहि दिसि गरुआई।' विन० १७१.६
साइँ : वि.पु. (सं० स्वमिन्>प्रा. सामि, सामी) । स्वामी, प्रभु । 'सिंघासन पर त्रिभुवन साई।' मा० ७.१२.८
साइँद्रोह : साइँदोह । विन० ३३.६
साउज : सं०० (सं० श्वापद>प्रा० सावज्ज)। (शिकार किये जाने वाले) वन्य जन्तु । 'सकल कलुष कलि साउज नाना ।' मा० २.१३३.३
साक : संपु० (सं० शाक) । सब्जी, भाजी । 'साक बनिक मान गुन गन जैसें ।' ___ मा० १.३ १२
साकं : अव्यय (सं.)। सहित, साथ। श्रीराम सौमित्रि साकं ।' विन० ५१.८
साका : (१) सं०० (सं शक्य>प्रा. सक्क) । सामर्थ्यानुसार किया जाने वाला कर्म। (२) (सं० शाक =संवत्) । ख्याति, प्रसिद्धि । 'तस फल देउँ उन्हहि करि साका।' मा० २.३३.८
साके : साका+ब० । यशः प्रशस्तियां, कीति-गाथाएँ । 'जुग जुग जग साके केसव के ।' कृ०६१
