104 
_______________________________________________
उराहनो : सं०० (सं० उपालमन>प्रा० उआलहण)+कए। उपालभ्य, __शिकायत, गिला । 'पाइ के उराहनो, उराहनो न दीजो मोहि ।' कवि० १.१६५
उरिन : वि० (सं० उऋण =अऋण>प्रा० उरिण। ऋण मुक्त। मा० .. १.२७५.८, २७६.२ 
उरु : सं०० (सं० अरु) । (१) घुटनों के ऊपर चरणों का भाग । गी० ७.१७.५ 
(२) विस्तृत, दीर्घ, विशाल (सं.)।
उरुगाय : संपु० (सं.)। विस्तृत (व्यापक) गति वाला विष्णु । 'जयति जय 
उरुगाय ।' विन ० २२०.११ ।
उबि : उर्वी । कवि० १.११
उबिजा : पृथ्वी-पुत्री= सीता जी । मा० ३.४ छ० .
उबिधर : सं०पू० (सं० उर्वीधर)। भूधर-पर्वत । विन० १५.५
उबिपति : पृथ्वी का स्वामी राजा । विन० ५६.६
उर्वी : सं०स्त्री० (सं.)। पृथ्वी।
उर्वोश : पृथ्वी का स्वामी राजा । मा० ६ श्लोक १
उलटउँ : आ० उए । उलटे देता हूं। 'उलटउँ महि जहँ लगि तव राजू ।' मा० 
१.२७०.४
उलटा : वि.पुं० (प्रा० उल्लट्ट) । प्रतीप । मा० १.१६.५
उलटि : पू०/० । उलटकर। (१) 'उलटि पलटि लंका सब जारी।' मा० ५.२६.८ 
(२) उलटा होकर, प्रतिकूल होकर । 'करइत उलटि परइ सुर-राया।' मा० 
२.२१८.२
उलटी : भूक स्त्री० । विपरीत, प्रतिकूल । 'उलटी रीति प्रोति ।' विन० २२४.२
उलटे : उलटा+बहु० । मा० २.११६.२
उलटने : उलटा+कए । गी० ५.४०.३
उलदै : आ०ए० (प्रा० उल्लद्दइ)। उँडेलता है। 'बारिधारा उलदै जलदु जोन 
सावनौ।' कवि० ५.८
उलीचा : भू० कृ०। हाथ से (पानी) डाला। 'मीन जिअन निति बारि 
उलीचा ।' मा० २.१६१.८
उलीचे : उलीचने से, हाथ या पात्र से पानी डालने से । 'सागर सीप कि जाहिं 
उलीचे । मा० २.२८३.४
उलूक : सं०० (सं०) । उल्लू पक्षी । मा० १.२५५.२
उलूफहि : उल्लू को, घुग्धू पक्षी को। 'जया उलूकहि तम पर नेहा ।' मा० 
५.४५.८ 
_______________________________________________
105 
उवन : सं०० (सं० उदयन>प्रा० उअण)। उदय करना । 'दंड द्वै (हे हैं रघु 
आदित उवन को।' कवि० ६.७
उनकाल : सं०० (सं० उष्णकाल) । ग्रीष्म ऋतु । दो० ३१० उसास,
सा: सं०पु०स्त्री० (सं० उच्छ्वास>प्रा० ऊसास) । ऊंची साँस, आह । 
सिरु धुनि लीन्हि उसास असि ।' मा० २.३०, २.५१.५ उसासु,
सू : उसास+कए । 'ऊतरु देइ च, लेइ उसासू ।' मा० २.१३.६
उसीले : वि.पु.ब० (सं० उच्छील)। उच्च शोल वाला, कृतज्ञ, उपकारी । 
साहेब कहूं न राम से, तो से न उसीले ।' विन० ३२.१
उहाँ : क्रि०वि० । वहाँ । 'इहाँ उहाँ दुइ बालक देखा । मा०' १.२०१.७
उहारु : सं०पु०कए० (सं० अवहारः, अवहारम् >प्रा० ओहारो, ओहारं>अ. 
ओहारु) । ऊपर का आवरण (खो पालकी आदि पर पड़ा होता है)। 'नारि । उहारु उधारि दुलहिनिन्ह देखहिं ।' जा०म० १८८ 
ऊच : वि०० (सं० उच्च) । ऊर्ध्व, महान, उत्तम । मा० १.६.६ ऊँचि,
ची : वि० स्त्री० । 'मति अति नीचि ऊँचि रुचि आछी।' मा० १.८.७ .
ऊँचें : उच्च स्थान पर (या से) । 'तब केवट ऊँचें चढ़ि धाई ।' मा० २.२३७.१
ऊँचो : ऊँच+कए । 'ऊँचो कुल केहि काम को।' वैरा० ३८ ।
ऊंट : सं०० (सं० उष्ट्र>प्रा. उट्ट) । पशु विशेष । मा० १.३००.६
ऊ : अध्यय । भी । 'नटनागर मनि नंदललाऊ। कृ० १२
ऊक : सं०स्त्री० (सं० उल्का>प्रा० उक्का) । पुच्छल, तारा, टूटता-गिरता नक्षत्र । 
'ऊकपातदिकदाह दिन ।' रा०प्र० ५.६.३
ऊख : सं०स्त्री० (सं० इक्ष>प्रा० उच्छू=इक्खु)। (१) ईख । वैरा० ३६ 
(२) वि०पू० (सं० उख्य-उख दाहे>प्रा० उक्ख) । दग्ध । 'उन काल 
अरु देह खिन मग पंथी तन ऊख ।' दो० ३१०
ऊखमय : ऊख से बना हुआ (खाँड) । 'अयमय खाँड, न ऊखमय ।' मा० १.२७५ ऊगो,
ग्यो : उग्यो । 'ऊगो आतम भान ।' वैरा० ३३
ऊतर : उत्तर । गी० ५.३२.२ 
106 
_______________________________________________
ऊतरु : उतरु । एक भी उत्तर । 'ऊतरु देइ न, लेइ उसासू ।' मा० २.१३.६
ऊतरे : उतरे । पहने कर फेंके-पुराने । 'तुलसी पट ऊतरे ओढ़िहौं ।' गी० ५.३०.४ ऊधो,
धौ : सं०पु० (सं० उद्धव) । मथुरा में कृष्ण के सखा । कृ० ४६
ऊना : वि०पू० (सं० ऊन) न्यून, अल्प, छोटा । 'अस कस कहहु मानि मन ऊना।' 
मा० २.२१.४
ऊपजे : उपजइ । 'दुख ते दुख नहिं ऊपजी।' वैरा० ३० ।
ऊपर : अव्यय (सं० उपरि >प्रा० उम्परि) । मा० ५.३०.२
ऊब : संस्त्री० । उद्वेग, मानसिक क्लान्ति, उदासी । 'सब की सहत, उर अंतर 
न ऊब हो।' कवि० ७.१०८
ऊबर : वि० (१) उबार । रक्षा। (२) (सं० उर्वर>प्रा० उव्वर) । अधिक, 
'सफल । 'सो सब बिधि ऊबर कर, अपराध बिसारी। विन० ३४.४ ।। ऊबर,
ऊवरइ : (/ऊबर)। बच जाय, बच सकता है। 'कह तुलसी सो 
ऊबरं जेहि राख राम राजिवनयन ।' कवि० ७.११७
ऊमरि : सं०स्त्री० (सं० उदुम्बरि>प्रा० उंबरि)। गूलर वृक्ष । 'खमरि तरु बिसाल 
तब माया। मा० ३.१३.६
ऊर्ध : (सं० ऊर्ध्व) । ऊपर । कवि० ५.१७ अध्वरेता वि०० (सं० ऊर्ध्वरेतस्) । जिसका रेतस् (वीर्य) ऊर्ध्व हो-नीच न 
आये; वीर्यपात रहित= ब्रह्मचारी । विन० २६.३
ऊपर : सं०० (सं०) अनुर्वर भूमि जिसकी दूषित मिट्टी में वनस्पति नहीं उगते । ___ 'ऊपर बरषइ तन नहिं जामा ।' मा० ४.१५.१०
ऊसर : ऊपर । 'ऊसर बीज बएँ फल जथा।' मा० ५.५८.४
ऊसरो : ऊसर भी । 'सुखेत होत ऊसरो।' कवि० ७.१६ 
ऋक्ष : सं०० (सं०) । रीछ, भालू । विन० २५.६
ऋचा : सं०स्त्री० (सं० ऋच्) । वेद मन्त्र । गी० १.२३.५
ऋतु : सं० (सं.)। वर्ष के छठे भाग के दोमास का समय--- (१) बसन्त - 
चैत्र-वैशाख; (२) ग्रीष्म= ज्येष्ठ-आषाढ; (३) वर्षा = श्रावण-भाद्रपद; 
_______________________________________________
107 
(४) शरद् आश्विन-कार्तिक; (५) हेमन्त मार्गशीर्ष-पोष; (६) शिशिर 
=माघ-फाल्गुन । ये मास सूर्य तिथि से लिये जाते हैं।
ऋतुनाथ : बसन्त । गी० २.२४.२
ऋतुपति : बसन्त । गी० १.६५.३
ऋसि : सं०स्त्री० (सं०) । (१) वृद्धि (२) उन्नति, अभ्युदय (३) सफलता 
(४) महत्ता (५) उत्तमता, उदात्तता, उदरता (६) पूर्णता, समग्रता, श्रेष्ठता (७) अप्राकृत शक्ति (८) उपलब्धि (९) सम्पत्ति (१०) कुबेर की पत्नी 
(११) पार्वती (१२) लक्ष्मी । रा०न० २०
ऋषयनि : (दे० रिषय) । ऋषियों ने । 'जे पूजी कौसिक मख ऋषयनि ।' गी० 
७.१३.४
ऋषि : सं०० (सं०) । वेद-मन्त्रों का द्रष्टा, मन्त्ररहस्य ज्ञाता । गी० १.६०.४
ऋषिन : ऋषि+ संब० (सं० ऋषीणाम् ) । ऋषियों । 'ऋषिन के आश्रम सराहैं ।' 
गी० २.४५४ 
ए : सर्वनाम-कब (सं० एते>प्रा० एए>अ० एइ) । ये । 'ए प्रिय सबहि जहाँ 
लगि प्रानी।' मा० १.२१६.७ एइ,
एई : ये ही । केवल ये। ‘इन्ह से एइ कहैं ।' मा० १.३११ छं. एउ,
एऊ : ये भी । 'एउ देखि हैं पिनाकु ।' गी० १.६८.४
एक: (१) संख्या (सं०) । 'एक कलप एहि बिधि अवतारा ।' मा० ११२३.४ 
(२) सर्वनाम (सं०) । कुछ कतिपय । 'एक कहहिं भल भूप न कीन्हा ।' मा० २ ४८.२ (३) वि० (सं.) । श्रेष्ठ । 'परम बिचित्र एक ते एका ।' मा० १.१२२.२ (४ वि०) (सं०) । अल्प । 'कथा कछु एक है कही।' मा० ५.३ छं० ३ (५) वि० (सं०) । अनन्य, एकमात्र । राम नाम गति एक ।' दो० ३७. 
(६) वि० (सं०) । अद्वितीय, सर्वोत्तम-निज जननी के एक कुमार । एकंत,
ता : एकान्त । 'सदा रहैं एहि भांति एकता।' वैरा० ४७
एकई : एक ही । 'एकह उर बम दुसह दवारी ।' मा० २.१८४.६
एकउ : एक हो । 'जदपि कबित रस एकउ नाहीं।' मा० १.१०.७ 
108 
_______________________________________________
एकछत्र : वि० (सं० एकच्छत्र) । (राजा या राज्य) जिसके प्रति दूसरा छत्रधारी 
राजा न हो । 'एकछत्र रिपुहीन महि ।' मा० १.१६४
एकटक : वि०+क्रि०वि० (सं० एकतर्क >प्रा० एक्कतक्क)। एक ही दृष्टि से 
ताकते रहने वाला, अविराम ताकने वाला, अपलक । टकटकी बाँधकर । 'एकटक 
रहे नयन-पट रोकी ।' मा० १.१.४८ (दे० तक) एक ठोरी,
ठोरी : (दे० ठोरी, ठोरी) एक स्थान पर, एकत्र ।
एकतनु : जिसका एक ही शरीर हो-दुबारा जन्म लेकर शरीर धारण न किया 
हो। मा० १.१६२ एकतीस,
सा : संख्या (सं० एकत्रिंशत् >प्रा० एक्कतीसा) । मा० १.३४.४
एकनयन : वि० (सं.)। एकाक्ष, काना । मा० ३.२.१४ एकनारि
व्रत : एक ही पत्नी के प्रति निष्ठा । मा० ७.२२.८ 
•
एकन्ह : एक+संब० । कुछ लोगों (को)। 'एकन्ह एक बोलि सिख देहीं ।' मा० 
२.११४.६
एकपर : वि० (सं०) । एकमात्र प्रधान । विन० ५७.४
एकरस : वि०+क्रि०वि० (सं०) । (१) अपरिवर्तित, निर्विकार । 'सदा एकरस 
सहज उदासी।' मा० ६.११०.५ (२) एकभाव से, निरन्तर समान । 'तब तें 
बिरह रबि उदित एकरस।' कृ० २६
एकरूप : वि० (सं.)। (१) सदृश रूप वाले । 'एकरूप तुम्ह भ्राता दोऊ ।' मा० 
४.८.५ (२) सदा एक ही रहने वाला, अपरिवर्तित, निर्विकार । विन० ६०.५ एकहि,
हीं : एक ही । मा० २.१८३.२
एकहु : एक भी। 'प्रभु के एकहु काज न आयउँ।' मा० ६.६०.३
एका : एक । मा० १.१२२.२
एकांत : क्रि०वि० (सं०) । जहाँ एक (अपेक्षित व्यक्ति) के अतिरिक्त अन्य कोई ___ न हो । 'पतिहि एकांत पाइ कह मैना।' मा० १.७१.२ । 
एकाकिन्ह : एकाकी+संब० (सं० एकाकिनाम्) । एकाकियों, अकेलों। 'सहज 
एकाकिन्ह के भवन ।' मा० १.७६
एकाकी : वि० (सं०) । अकेला (अद्वितीय, असहाय) । मा० २.२२८.४
एकादसी : वि०+सं० स्त्री० (सं० एकादसी) (१) ग्यारहवीं (२) पक्ष की 
ग्यारहवीं तिथि । विन० २०३.१२ एकु,
एक : (१) एक+कए । 'एकु दारुगत देखिअ एकू।' मा० १.२३.४ 
(२) क्रि०वि० । प्रथमतः, पहले तो। 'एक मंद मैं मोहबस ।' मा० ४.२
एके : (१) एकइ । एक ही। दो० ३१८ (२) एक+हि। एक से, एक को । 'एक 
एक कहत।' गी० १.८८.४ 
_______________________________________________
109 
एको : एकउ । एक भी । 'सो तो कछु एकौ न चित्त ठई।' कृ० ३६
एतना : वि.पुं० (सं० एत्सकत्>प्रा० एत्तुल्ल)। इतना । मा० २.१६२.४
एतनिअ : इतनी ही । 'जनु एतनिअ बिरंचि करतूती ।' मा० २.१.५
एतनेइ : इतना ही, इतने ही । 'एतनेइ कहेह भरत सन जाई।' २.१५७.३
एतनेहि : इतने ही । मा० ५.१५.७
एतनोई : इतना ही । 'राज धरम सरबसु एतनोई ।' मा० २.३१६.१
एताहस : वि० (सं० एतादृश) । ऐसा । मा० २.६८.५
एती : वि० स्त्री० (सं० इयती>प्रा० एत्तिई) । इतनी । एती गलानि न गलतो।' ____ गी० ५.१३.५
एते : इते । इतने । दो० ५७३ एतेहुं,
हु : (१) इतने..... भी। एतेहु पर करिहहिं जे असंका।' मा० १.१२.८ 
(२) इतने में भी। 'जो एतेहुं दुख मोहि सिआवा ।' मा० २.१६५.८
एतो : वि.पु.कए० (सं० एतावत् >प्रा० एत्तिओ) । इतना । कवि० ७.७२
एवं : निश्चयार्थक अव्यय (सं०) । ही। 'स्वारथ साधन एव ।' दो० ३४६
एवमस्तु : अव्यय (सं० -- एवम् +अस्तु)। ऐसा हो (आशीर्वाद जिसमें वर-याचन 
को मान्य किया जाता है) । मा० १.१६५
एह : सर्वनाम (सं०
एष:>प्रा० एसो>अ० एह =एहा, एहु, एहो)। पु०कए । ___ यह । 'सिख वन एह ।' विन० १६०.१
एहा : एह । 'सत्य कहेहु गिरिभव तनु एहा ।' मा० १.८०.५
एहि : सर्वनाम पद (सं० एतास्मिन् >प्रा० एअहिं) । इस में, इससे । 'में एहिं बेष 
न आउब काऊ।' मा० १.१६६.३ एहिं बिआह अतिहित सबही का।' मा० 
१.२२३.१
एहि : 'एइ' का रूपान्तर । इस । 'राम प्रताप प्रगट एहि नाहीं।' मा० १.१०.७ ____ 'एहि बिधि जलपत भयउ बिहाना ।' मा० ६.७२.६
एहीं : इसीसे, इसी में । 'कछु दिन जाइ रहउँ मिस एहीं।' मा० १.६ १.६
एही : इसी । 'एही भांति चलेउ हनुमाना।' मा० ५.१.८
एह : एह । यह । 'तम्हहि उचित मत एह ।' मा० २.२०७
एहूं : एह+हूँ। यह भी, इस भी। 'एहूं मिस देखौं पद जाई।' मा० १.२०६.७
एहू : एहु । 'तिन्ह कहें सुखद हास रस एहू ।' मा० १.६.२ 
110 
_______________________________________________
ऐ 
ऐक : संपु (सं० ऐक्य) । (१) एकत्व, एकरूपता, अत्यन्त समानता। कीन्ह ___ बहुत अम ऐक न आए।' मा० २.१२०.६ (२) मेल, सामञ्जस्य, संगति । 
'सकहिं न सेइ ऐक नहिं आवा ।' मा० २.२७६.४ ।
ऐन : अयन । घर, भाण्डार । 'बिहसे करुना ऐन ।' मा० २.१००
ऐनी : ऐन-+स्त्री० । खानि । 'सीय सुमंगल ऐनी।' गी० १.८१.२
ऐपन : सं०० (प्रा० आइप्पण)। हल्दी और चावल के पीठे का मिश्रित द्रव । __ दो० ४५४
ऐश्वर्य : सं०० (सं.)। (१) सम्पत्ति, वैभव (२) ईश्वरत्व (३) श्रेष्ठता 
(४) ईश्वरीय गुणकर्म व्यापकत्व, सर्वज्ञत्व, सर्वकर्तृत्व, सत्य संकल्प आदि 
कल्याण गुण । विन० ६१.६
ऐसा : वि.पु(सं० ईदृश>प्रा० एरिस>म० अइस) । मा० ५.२६.५
ऐसि : ऐसी । मा० ६.६६.२
ऐसिअ : (१) ऐसी ही । 'ऐसिअ प्रस्न बिहंगपति कीन्हि ।' मा० ७.५५ (२) ऐसी। __ कवि० ६.२१
ऐसिउ : ऐसी भी । ऐसिउ पीर बिहसि तेहिं गोई ।' मा० २.२७.५
ऐसिहु : ऐसिउ । विन० १३६.८
ऐसी : वि०स्त्री० (सं० ईदृशी>प्रा० एरिसी>अ० अदृसी) । कवि० ७.११
ऐसें : क्रि०वि० । इस प्रकार से । 'जासु बियोग बिकल पसु ऐसें ।' मा० २.१००.१
ऐसे : ऐसा+बहु० । इस प्रकार के । मा० २.१११.७
ऐसेइ : (१) ऐसा ही। ऐसेइ होउ कहा सुख मानी।' मा० १.८६.५ (२) ऐसे 
ही। ऐसे इ संसय कोन्हि भवानी।' मा० १.४७.८ ऐसेउ,
ऊ : ऐसे भी । 'ऐसेउ प्रभु सेवक बस अहई ।' मा० १.१४४.७
ऐसेहिं : इसी प्रकार । मा० १.२३६.३ ऐसेहुं, हु, हूं,
हू : ऐसे भी, ऐसे में भी। 'ऐसेहुं पति कर किएं अपमानाए मा० . ३.५.६, 'ऐसेहुं दुख जो राख मम प्राना।' मा० ६.६६.१० 
ऐसो : ऐसा+कए । 'नहिं जानत ऐसो को है ।' कृ० ३५
ऐसोई : ऐसा ही । कवि० ७.७७ 
4 
. 
AR 
_______________________________________________
111 
ऐहउँ : आ०भ० उए । आऊंगा। ऐहउ बे गिहि होइ रजाई ।' मा० २.४६.३
ऐहहि : ऐहैं । आएँगे । 'ऐहहिं बेगि सुनत दोउ भ्राता।' मा० २.३१.७
ऐहहु : आ० भ० मब० । आओगे-गी। 'जब लगि तुम्ह ऐहहु मोहि पाहीं ।' मा० 
ऐहैं : आ०भ०प्रब० । आएंगे । 'ऐहैं सुत देखुवार कालि तेरे ।' कृ० १३
ऐहै : आ०भ०प्रए० । आएगा । गी० ५.३४.२
ऐहौं : ऐहउँ । 'ऐहौं बेगि सुनहु दुति दामिन्ति ।' गी० २.५.३
ऐहो : ऐहहु । 'जो रघुबीर न ऐहो।' गी० २.७६.४ 
ओंकार : सं०० (सं०)। ॐ ध्वनि जो ब्रह्म का वाचक कहा गया है, मूलनाद, 
नादब्रह्म, शब्दब्रह्म, अनाहतनाद (परब्रह्म ही ओंकार का मूल कारण है जिससे शब्दजगत् और अर्थजगत् की सृष्टि होती है अतः ब्रह्म ओंकार रूप तथा ओंकार 
मूल भी होता है । 'निराकारमों का मूल तुरीय ।' मा० ७.१०८.३
पोऊ : वे भी । 'सुन्दर सुत जनमत मैं ओऊ।' मा० १.१६५.१ ।। 
ओक : सं०० (सं० ओकस्) । घर । 'ओक की नीव परी हरिलोका ।' कवि० 
७.१४५
प्रोघ : सं०० (सं.)। प्रवाह, समूह । 'सिय निंदक अघ ओघ बसाए।' मा० 
ओझ : सं०० (सं० ऊपाध्याय>प्रा० ओज्झाअ)। ओझा, पण्डित, पुरोहित । 'तुलसी रामहि परिहरें निपट हानि सुन ओझ।' दो० ६८ 
ओझरी : सं०स्त्री० । पेट के भीतर आमाशय की थैली या आंत । कवि० ६.५० ओट,
रा : संस्त्री० (सं० अवकटिका)। पर्दा, आवरण, आड़। 'बेगि करहु किन 
आँखिन्ह ओटा।' मा० १.२८०.७ 'लता ओट तव साखिन्ह लखाए।' मा० १.२३२.३ (२) सहारा, अपने अवगुणों का अवरण । 'ओट राम नाम की 
ललाट लिख लई है।' हनु० ३८
ओठ : सं०० (सं० ओष्ठ>प्रा०ओष्ठ) । अधर । मा० ६.४१.६
ओड़न : सं०० (सं० अवकटन-कट आवरणे>प्रा०ओअण) । बार या प्रहार 
रोकना, बचाव करना । 'एक कुसल अति ओड़न खाँडो।' मा० २.१९१.६ 
112 
_______________________________________________
प्रोडिअत : वक०० कर्मवाच्य (सं० अवकट्य मान>प्रा० ओअडीअंत) रोका जाता, 
बचाव के लिए ओट किया जाता । पलक पानि पर ओड़ियत समुझि कुघाइ 
सुधाई ।' दो० ३२५
ओडिअहिं : आ०कवा०प्रब (सं० अपकटयन्ते>प्रा० ओअडीअंति>अ० ओअडी 
अहिं) । ओड़े जाते हैं, बचाव के लिए आड़ में लाए जाते हैं। 'ओडिअहिं हाथ 
असनिहुं के घाए।' मा० २.३०६.८ ओड़िए,
ये : आ०कवा प्रए । बचाव के लिए आड़ लिया जाए। 'तजि रघुनाथ ___ हाथु और काहि ओडिए ।' कवि० ७.२५
मोड़ेहुं : ओड़ने पर भी, बार रोकने पर भी । 'भागें भल ओड़ हुँ भलो।' दो० ४२४
ओढ़नं : सं०० (सं० अवगुण्ठन >प्रा० ओढण)। शरीर का आवरण । मा० 
७.४०.१
ओढ़ाई : भक०स्त्री० । आच्छादित की हुई । 'हेमलता जनु तरु तमाल ढिग नील 
निचोल ओढ़ाई। विन० ६२.१२
ओढ़ाए : भू००। अवगुण्ठित किए। 'जननी पट पीत ओढ़ाए।' गी० २६.६
प्रोढ़िहौं : आ०भ०पुए। ओढूंगा, शरीर ढकुंगा । 'तुलसी पट अतरे ओढ़िहौं ।' गी० 
५.३०.४
ओढ़ी : भू० कृ०स्त्री० । ओढ़ ली, शरीर पर लपेट ली । 'दामिनी ओढ़ी मानो बारे ___ बारिधर ।' गी० १.३३.२ 
ओढ़े : भू०कृ०पू० (बहु०) । आवेष्टित किए हुए, लपेटे हुए । 'ओढ़े जीत पट हैं ।' 
कृ० २०
मोतो : वि०पु०कए । उतना । 'क्यों कहि आवत ओतो।' विन० १६१.४
ओदन : सं०० (सं०) पका चावल, भात । मा० १.२०३
ओधे : भू००पू०ब० (सं० ऊर्ध्व>प्रा. उद्ध=ओद्ध) । ऊर्ध्व हुए, उठ खड़े हुए, 
उद्यत एहु । निज निज काज, पाइ सिख ओधे ।' मा० २.३२३.१
प्रोट : सं० स्त्री० (सं० अपरा>प्रा० ओरा)। (१) दिशा, पाव । 'बिहरहिं 
बन चहँ ओर । मा० २.२५५ (२) पक्ष । 'तुलसी के हिएँ है भरोसो एक ओर को ।' हनु० ६ (३) छोर, अन्त, सीमा। 'ओर निबाहेहु भायप भाई।' मा० 
२.१५२.५
ओरहने : सं.पु. (सं० उपालभन>प्रा० ओआलहण) । शिकायत करने, अपराध 
लगाने । 'ठाढ़ी ग्वालि ओरहने के मिस ।' कृ. ५
ओरा : ओर । मा० १.२३०.३
पोरी : ओर । 'भ्राजत दुहं ओरी ।' गी० ७.७.३ 
ओरे : सं०पु०ब० (सं० ओल) । ओले, वर्षोपल । 'गरहिं गति जिमि आतप ओरे।' 
मा० २.१४७.७ 
_______________________________________________
113 
ओल : सं०० (सं० ओल्ल =शरीर बन्धक)। वह दास जिसका शरीर धरोहर 
हो, क्रीतदास, गुलाम । 'बाजे-बाजे राजन के बेटा-बेटी ओल हैं।' कवि. 
५.२१
ओषधी : सं०स्त्री० (सं ओषधि)। जड़ी, चिकित्सा हेतु मूल आदि । रा०प्र० 
७.२.१
ओस : सं०स्त्री० (सं० अवश्याय>प्रा० ओसा) । तुषार पंकज कोस ओस कन 
जैसें ।' मा० २.२०४१
ओसरिन्ह : ओसरी+ संब० । ओसरियों (से) । 'ओसरिन्ह गावे सुहो।' गी० 
७.१८.५
ओसरी : सं० स्त्री० (सं० अवसर>प्रा. ओसर) । क्रम, बारी, पर्याय ।
ओहार : सं० स्त्री० (सं० अवसर>प्रा० ओसर)। पालकी आदि का वाता 
वरण । 'सिबिका सुभग ओहार उघारी।' मा० १.३४८.८
ओही : सर्वनाम (सं० असो>प्रा० अहो>म० ओह) । (१) वह, उसे । 'आन 
भांति नहिं पावों ओही ।' मा० १.१३२.६ (२) उसने । 'भलो ठग्यो ठगु 
ओही।' कृ० ४१ .
ओहू : (अ० ओह+कए ओहु)। वह। पिता बचन मनतेउँ नहिं ओहूं।' मा० 
औ 
औ : और। (१) कवि० ७.१२२ (२) अव्यय - समुच्चयार्थक । जैसे, मोरिओ।
ओगुन : अवगुन । कवि० ७.१७४ ।
औचट : अवचट । तिजरा को सो टोटक औचक उलटि न हेदो।' विन० 
२७२.२
ओटि : पूक० (१) (सौं क्वथित्वा =प्रा० अट्टिअ>अ० अट्टि)। उबलकर, क्वथित 
होकर । (२) (स आवर्त्य>प्रा० आवट्टिअ>अ० आवट्टि)। आवर्त गति लेकर, भ्रमण कर, उलट-फेर कर, आवागमन करके । 'कलट कोटि लगि औटि 
मरौं ।' विन० १४१.६
औढर : अवढर । कवि० ७.१५६ 
114 
_______________________________________________
भीत : सं००+स्त्री० (सं० आपूर्त= आपूर्ति>प्रा० आउत्त =आउत्ति)। घाव 
आदि (या गड्ढे आदि) का भरना । चैन, तृषा आदि की पूर्ति, आराम । 
'ओत पावै न मनाक सो।' कवि० ५.२५
प्रोतेहु : क्रियाति० पु० मब० । तुम आते। 'जौं तुम्ह औतेहु मुनि की नाई।' ___मा० १.२८२.३ 
औध : अवध । कवि० २.१
औनिप : अवनिप । राजा । कवि० ७.१६४
औनिपनि : औनिप + संब० । राजाओं (ने) । कवि० १.१६
और : अउर । 'मेरे जान और कछु न मन गुनिए।' कृ० ३७ और
उ: और भी, अन्य भी। औरउ जे हरि भगत सुजाना ।' मा० १.३०.८ औरन,
नि : और+संब० (१) (सं० अपरेषाम् >प्रा० अवराण)। औरौं । 'कुमयाँ कछु हानि न औरन की।' कवि० ७.४७ (२) औरौं को। 'तेरे बेसाहे बेसाहत 
औरनि ।' कवि० ७.१२ (३) औरौं का। कवि० ४.१ ।।
औरहि : और को, अन्य के प्रति । 'जरि जाउ सो जीह जो जाचत औरहि ।' 
कवि० ७.२६
औरह : औरउ । और भी। गी० ७.३८.८
प्रौर : और+कए । अन्य कोई (एक)। और करें अपराध कोउ।' मा० 
२७७
औरे : 'और' का रूपान्तर। दूसरे (से) । 'बनिहै बात उपाइ न औरे ।' गी० 
२.११.२
औरेब : अवरेब।
औरेब : औरव+ब० । गाँठे, वक्रताएं, कुटिल
करतूतें : 'हमहूं कछुक लखी ही 
तब की औरेबैं नंदलाला की।' कृ०४३
और : और ही, अन्य ही, कोई विलक्षण । 'और आगि लागि, न बझाव सिंधु 
सावनो।' कवि० ५.१८
औरौ : औरउ । गी० ६.१७.१ ।
औषध : सं०० (सं.)। (१) वनस्पति आदि । 'औषध मूल फूल फल नाना ।' 
मा० २.६.२ (२) दवा, औषधियों का मिश्रण जो चिकित्सा के काम आता 
है। 'बिनु औषध बिआधे बिधि खोई।' मा० १.१७१.४
औषधी: मोषधी। मा० ६.५५
औषधु : औषध+कए । एक भी उपचार, कोई दवा । 'एहि कुरोग कर औषधु 
नाहीं।' मा० २.२१२.२
औसर : अवसर । कवि० २.२२
प्रोसरा : औसर । दो० ४६६ 
_______________________________________________
115 
कंगाल : वि० (सं० कङ काल = अस्थिपञ्जर)। बुभुक्षा-जीडित (जो कङ काल 
शेष रह गया हो), अतिशय दरिद्र तथा भखा। 'ललकत लखि ज्यों कंगाल 
पातरी सुनाज की।' कवि० ६.३०
कॅग्रन्हि : 'कंगूरा'+संब० । कँगूरों (पर)। 'कोट कैंगरन्हि चढ़ि गए।' मा० 
कंगूरों : कँगूरे पर । 'कौत की कपीसु कूदि कनक कँगूरां चढ़ यो।' कवि० ५.४
कंगूरा : सं.पु (सं० कङ्ग लहाथ; फा० कंगुर=बाजू, बाँह) । भवन के ऊपर 
हस्ताकार उन्नत रचनाविशेष । 'रचे कँगूरा रंग रंग बर।' मा० ७.२७.४
कंगूरें : कँगूरा+ब० । कँगूरों को। 'कोट के कैंगूरें..... ढहैं ढेलन की ढेरी सी।' 
कवि० ६.१० कंप,
कपइ : (सं० कम्पते>प्रा० कंपइ-काँपना) । आ०प्रए० । कांपता है । ___कॅप कलाप बर बरहि फिरावत ।' गी० ३.१.२
कवल : कमल (सं० कमल>प्रा० कमल>अ. कवल) । 'नवल कँवलहू ते कोमल 
चरन हैं।' कवि० २.१७
क : (१) 'का' का लघुरूप । 'मित्र क दुख रज मेरु समाना।' मा० ४.७.२ 
(२) 'इक' का रूपान्तर । कोटिक, कछुक । (३) 'कर' का लघु रूप (पूर्व०)। जावक रचि क अंगुरियन्ह मदुल सुठारी हो ।' रा०न० १५ (४) (सं० किम) सर्वनाम जिससे को, केहि, कब आदि रूप बनते हैं। (५) स्वार्थिक प्रत्यय 
कटक आदि।
कंक : सं०० (सं०) । गृध्र । 'काक कंक ले भुजा उड़ाहीं ।' मा० ६.८८.२
कंकन : सं०० (सं० कङ कण) । हस्ताभरण विशेष, कंगन । मा० १.६२२
कंकर : कांकर । विन० २३१.३
कंचन : सं०० (सं.)। सुवर्ण । मा० १.१२.३
कंचुकि : सं०स्त्री० (सं० कञ्चुकी) । (१) स्त्रियों के वक्षस्थल का परिधान विशेष। 
'श्रीफल कुच कंचुकि लता जाल ।' विन० १.४१५ (२) चोगा, लम्बा अंगरखा। 
'बहु बासना बिबिध कंचुकि भूषन लोभादि भर यौ।' विन० ६१.२
कंज : सं०० (सं०) । कमल । मा० १.२०.८ . कंजन, नि, न्ह,
म्हि : कंज+संब० । कमलों (पर, में, से आदि) । 'पग नूपुर ओ 
पहुँची कर कंजनि ।' कवि० १.२
कंजकोस : कमल की पंखड़ियों के समूचे आकार का भीतरी भाग । गी० ७.७४ 
116 
_______________________________________________
हु 
कंजराग : पक्षराग । मणिविशेष । 'कंजकोस भीतर जन कंचराग सिखर निकर।' 
गी० ७७.४
कंजा : कंजा। मा० १.१४८.८
कंजारुन : वि० (सं० कंजारुण) । कमल के समान लाल । मा० ५.४५.४
कंजु : कंज+कए । 'बंदउँ मुनि पद कंजु ।' मा० १.१४ घ
कंटक : सं०० (सं०) । (११ काँटा । 'कुस कंटक मग कांकर नाना ।' मा० 
• २.६२.५ (२) व्याघात, विरोधी तत्त्व । 'कासी में कंटक जेने भए ।' कवि० 
७.१७६ (३) शत्रु (शत्रु विनाश = कण्टक शोधन)। 'तीय तनय सेवक सखा मन के कंटक चारि ।' दो० ४७६ (मूल अर्थ एक है--चुभन की समानता से 
अन्य अर्थ आते हैं जो मानसिक कोंचन से सम्बद्ध है।)
कंटकित : वि० (सं.) । काँटों से युक्त । कमल कंटकित सजनी, कोमल पाइ ।' 
बर० २६
कंठ : सं०० (सं०) । ग्रीवा । मा० १.७२.७
कंठगत : कण्ठ में स्थित (सारे शरीर को छोड़कर कण्ठ में आया हुआ)। 'प्रान 
कंठगत भयउ भुआलू ।' मा० २.१५४.१ कंठहंसी गुप्त परिहास जो गले तक ही सीमित हो, बाहर प्रगति ध्वनि न करे। 
गी० १.८४.८
कंठा : सं०पु० (सं० कण्ठ्य > प्रा० कंठअ) । ग्रीवाभरण । 'कुंजर-मनि कंठा कलित।' 
मा० १.२४३
कंतु : कंठ+कए० । 'कंठ सूख मुख आव न बानी ।' मा० २.३५.२
कंठे : (सं० पद) । कण्ठ में । मा० ७.१०८ छं०६
कंडु : सं०स्त्री० (सं० कण्डु = कण्डू)। (१) खुजली का रोग । मा० ७.१२१.३३ 
(२) खुजलाहट । 'भ्रमत मंदर कंडु सुख मुरारी ।' विन० ५२.३ कंत,
कंता : सं०+वि०० (सं. कान्त>प्रा० कंत)। प्रिय, पति । 'सिंधु सुता 
प्रिय कंता।' मा० १.१८६ छं०
कंद : सं०० (सं.)। (१) मूल, जड़ (कारण) । 'प्रगटे सुषमा कंद ।' मा०. 
१.१६४ (२) खाद्य मूलविशेष । 'कंद मूल फल भोजन ।' मा० १.२०६ (३) (सं० के जल+द)=जलद । मेघ । 'कंद तड़ित बिध जनु सुरपति धनु ।' 
गी० १.१०८.६
कंदबद : मेघ समूह । 'कंदबृद बरषत जनु ' गी० ७.७.५
कंदर : सं००+स्त्री० (सं० कन्दर कन्दरा) । गृहा । मा० ३.१८.११
कंदरन्हि : कंदर+संब० । कंदराओं। 'सदग्रंथ परबत कंदरन्हि महुं जाइ तेहिं 
अवसर दुरे। मा० १.८४ छं. 
_______________________________________________
117 
117 
. 
कंवरप : कंदर्प । विन० २३६.६
कंदरां : कन्दरा में । 'गिरि कंदरी सुना संपाती।' मा० ४.२७१
कंदरा : कंदर । मा० ६.७५.२
कंदर्प : सं०० (सं०) । कमदेव । मा० ६ श्लोक २
कंदा : कंद । मा० १.१४४.१
कंदिनी : वि०स्त्री०=निकंदिनी। उन्मूलन करने वाली । 'क्रोध-कंदिनी।' गो. 
२.४३.२
कंदु : कंद+कए । एकमात्र मूल कारण । 'आनंद कंद बिलोकि दुलहु.........।' 
मा० १.३२१ छं०
कंदुक : सं०० (सं०) । गेंद । मा० १.२५३.४
कंध : सं०पु० (सं० स्कन्ध>प्रा० खंध) । (१) बाहुमूल । 'वृषभ कंध केहरि 
ठवनि ।' मा० १.२४३ (२) शाखामूल, वृक्ष का । वह भाग जहाँ से मोटी 
शाखाएँ निकलती हैं।' 'षट कंध साखा पचबीस ।' मा० ७.१३.५
कंधर : सं०पु. (सं.)। ग्रीवा । 'केहरि कंधर बाहु बिसाला।' मा० १.२१६.५ 
'दल्यो दसकंधर कंधर तोर ।' कवि० ६.५७
कंप : सं०पु० (सं० कम्प) । (अङ्गों की) थरथराहट, बेपथु । मा० १.५५.६
कंपत : वकृ०० । कापता, काँपने । 'कंपत अकंपन, सुखाय अतिकाय काय ।' 
कवि० ६.४३
कंपति : (१) वकृ० स्त्री० । कांपती । 'मंदोदरि उर कंपति भारी ।' मा० ६.१०२.१० 
(२) सं०० (सं०) । समुद्र । सत्य तोयनिधि कंपति ।' मा० ६.५
कंपहिं : काँपहिं । काँपते हैं । 'कंपहिं भूप बिलोकत जाकें ।' मा० १.२६३.४
कंपिन : भूकृ० (सं.)। कांपा हुआ, काँपे हुए । 'ठाढ़ रहा अति कंपित गाता ।' 
मा० ६.६५.३
कंपेउ : भू००० कए। काँप उठा । 'भयउ कोष कंपेउ भैलोका ।' मा० 
१.८७.५
कंवल : सं०० (सं०) । ऊनी आवरण विशेष । मा० १.३२६.३
कंबु : सं०० (सं०) । शङ्ख । 'कंबु कंठ अति चिबुक सुहाई।' मा० १.१६९.७
कंस : मथुरा का राजा जिसे कृष्ण ने मारा था। विन० ४६.६ 
कइ : (१) की (सम्बन्धार्थक स्त्री०)। 'सोभा दसरथ भवन कइ ।' मा० १.२९७ 
(२) सर्व० (सं० कति>प्रा० कइ=कई)। कितने । 'एक गाँठि कइ फेरे।' 
विन० २२७.४
कई : भू.कृ० स्त्री० (सं० कृता>प्रा० कई)। की। 'बहुत हों ढोठ्यो कई ।' मा० 
१.३२६ छं० ३ 
hc 
- 
118 
_______________________________________________
५ 
कच : सं०पू० (सं०) । केश । मा० १.१६६.१० कचनि,
न्हि : कच-+संब० । केशों (ने) । 'कचनि अनुपम छबि पाई।' गी० 
१.१०८.८
कच्छ : संपु० (सं० कक्ष) । तिनकों (या पुआल का) ढेर । 'राम प्रताप हुतासन, 
कच्छ विपक्ष ।' हनु० १६
कच्छप : सं०पू० (सं०) कमठ, कछुआ।
कच्छपु : कच्छप+कए । कच्छपावतार भगवान् । मा० १.२४७.७
प.छ, : वि०+ क्रि०वि० । कुछ, अल्प । मा० २.५०.६ ।। कछ
क : (कछु+इक)। कुछेक, थोड़ा, अत्यल्प । 'छुक दिवस जननी धरु धीरा ।' 
मा० ५.१६.४
कछ : कछ। मा० ५.३३.६
कछोटी : सं०स्त्री० (सं० कक्षपट्टी>प्रा० कच्छपट्टी) । कटि भाग के पास का 
परिधान । 'छोटिय कछौटी तटि ।' गी० १.१४४.१
कज्जल : सं०पू० (सं.)। आँखों का मलहम विशेष, काला उजन, परे के मिश्रण 
से बनाई कजली । 'जन कज्जल के आँधी चली ।' मा० ६.७८.८
कज्जलगिरि : कज्जल या सुरमे का पहाड़। मा० ६.१६.४
कज्जली : सं०स्त्री० (सं०) । धुएं से जमी कालिख । दो० ५७१
कजनाभ : सं०पु० (पद्मनाभो) । जिसकी नाभि से कमल उत्पन्न हुआ विष्णु । 
विन० ५३.७ Vकट
कटइ : (सं० कर्त>प्रा० कट्ट) आ०प्रए । कटता है, कट सकता है । 'तुब 
हित होइ कटै भव बंधन ।' विन ० १६६.३
कटक : सं०० (सं.)। (१) सेना। मा० ३.२२.११ (२) कड़ा, हस्ताभरण 
' तथा पादाभरण । 'कनक कटकांगदादी ।' विन० ५४.४
कटकई : कटक । सेना । 'मनहुं क रुनरस कटकई उतरी अवध बढ़ाइ।' मा २.४६
कटकटहि : आप्रब० (सं० कटकटायन्ते) । दातों की ध्वनि करते हैं। 'कटकटहिं 
जंबुक भूत प्रेत ।' मा० ३.२० छं०
कटकटाइ : पूकृ० । दाँत पीसकर, दन्त ध्वनि करके (क्रुद्ध होकर) । 'कटकटाइ 
गर्जा अस धावा।' मा० ५१६.४
कटकटात : वकृ०पु० । क्रोध से दाँत पीसने की ध्वनि करने । 'कटकटात भर 
भालु ।' गी० ५२२ ४ .
कटकटान : भूकृ.पु । दाँत पीसता हुआ क्रुद्ध हुआ। 'कटकटान कपि कुंजर 
भारी ।' मा० ६.३२.३
कटकटाहिं : कटकटाहिं । 'क टक टाहिं कोटिन्ह भट गर्जहिं ।' मा० ६.४१.६ 
_______________________________________________
119 
र 
बु 
न 
- 
कटकाई : कटकई । सेना । मा० १.१७६.४
कटक : कटक-कए। एक फोज । 'राम भाल कपि कटक बटोरा ।' मा० 
१.२५.३
कटक्कट : कि०वि० । 'कटकट' ध्वनिपूर्वक । 'जंबुकनिकर कटक्कट कट्टहिं ।' मा० 
६.८८.६
कटत : (१) वकृ०पू० । कटता-ते; छिन्न होता-ते । 'भट कटत तन सत खंड ।' 
मा० ३.२०.११ (२) कटते ही। 'कटत झटिति पुनि नूतन भए ।' मा० 
६.६२.१२
कटन : भकृ० अव्यय । कटने, छिन्न होने । 'लगे कटन बिकट पिसाच ।' मा० 
३.२०.८
कटहि : आ०प्रब० । कटते हैं, छिन्न होते हैं। 'कटहिं चरन उर सिर भुजदंडा ।' 
मा० ६६८.५
कटाइ : कटैया। काटने वाला । 'रामु सो न साहेबु न कुमति कटाइ को।' 
कवि० ७.२२
कटाच्छ : सं०० (सं० कटाक्ष) । नेत्रापाङ्ग, नेत्रकोण, अपाङ्ग से देखना। 'कृपा 
कटाच्छ पसाउ । मा० १.१३१
कटाच्छु : कटाच्छ+कए । एक अपाङ्ग दृष्टि । 'जासु कृपा कटाच्छु सुर 
चाहत ।' मा० ७.२४
कटाह : सं०पू० (सं.)। बड़ी कड़ाही, कड़ाह के आकार की नतोदर गोल वस्तु 
(जैसे, आकाश) । 'अंडकटाह अपितु लयकारी।' मा० ७.६४.८
कटि : संत्री० (सं.)। शरीर-मध्य भाग, उदर और नितम्ब 
अङ्ग । मा० १.१६६.४
कटितट : कटि का पार्श्व भाग । 'कटितट परिकर कस्यो निषंगा।' मा० ६.८६.१०
कटिन्ह : कटि-+संब० । कटियों (पर)। 'मुनिपट कटिन्ह कसें तूनीरा।' मा० 
२११५.८
कटिहउँ : आ०भ० उए । काट डालूंगा। 'कटिहउँ तव सिर कठिन कृपाना।' मा० 
५१०.१
कटु : (१) वि० (सं०) । कड़वा (अस्वाद्य) । मा० ७.१३ छं०५ (२) असह्य, ___कष्टकर । 'अति कटु वचन कहति के केई ।' मा० २.३०.८
कटुक : कटु । (१) अस्वाध, कड़वा । 'कृटिल कटक फर फरैगो।' दो० ४५२ 
(२) कष्टकर । 'कटुक कठोर कुबस्तु दुराई।' मा० २.३११.५
कटुबादी : वि०पुं० (सं० कटु-वादिन्) । कष्टकर बोलने वाला। क्रूट तर्क-वितर्क 
करने वाला । 'कटबादी बालक बधा जोगू ।' मा० १.२७५.३ 
द 
120 
तुलसी शब्दकोश 
कटेहुं : कटने पर भी । 'मरत न मूढ़ कटेहुं भुजसीसा ।' मा० ६.६८.२
कटैया : वि० । काटने वाला, छिन्नकर्ता । 'दसरस्थ को नंदन बंदि कटैया ।' कवि० 
७.५१ 
कहिं : आ० प्रब० । काटते हैं । 'जंबुक निकर कटक्कट कट्टहिं ।' मा० ६.८८.६ 
कठमलिआ : वि०० (सं० काष्ठमालिक>प्रा० कट्ठमालिअ) । काठ की माला 
पहनने वाला (दम्भी) । 'करमठ कठमलिआ कहैं ।' दो० ६६
कठवता : सं०० (सं० काष्ठपात्रक>प्रा कटुवत्तअ) । कठवत, अढ़िया । 'पानि 
कठवता भरि लेइ आवा।' मा० २.१०१.६ ।
कठवति : सं०स्त्री० (सं० काष्ठपात्री>प्रा० कट्टवत्ती>अ० कटुवत्ति) । छोटा 
___ कठौता। 'मीठो अरु कठवति भरो।' दो० १५
कठिन : वि० सं०) । (१) कठोर, निष्ठुर, जड़, क्रूर । मा० १.३२.६ (२) दुर्दम, 
घोर । 'हरन कठिन कलि कलुष कलेसू ।' मा० २.३२६.६ (३) तीक्ष्ण । 
कटिहउँ तव सिर कठिन कृपाना ।' मा० ५.१०.१।
कठिनई : कठिनता (प्रा. कठिणया)। विषमता, उलझना ।. 'तहाँ परंतु एक 
कठिनई । मा० ७.११७.६
कठिनता : सं०स्त्री० (सं.) कठोरता । 'सुनत कठिनता अति अकुलानी ।' मा० . २.४१.१
कठिनाई : कठिनई । कठोरता, संकट, कष्ट । मा० १.३८.६
कठुला : सं०० (अ० कंठा-कंठुल्लअ) । कण्ठाभरण (बालकों का)। 'कठुला 
कंठ बधनहानी के ।' गी० १.३१.३
कठोर : वि०पू० (सं.)। परुष, निष्ठुर, क्रूर, कठिन । मा० १.११३.७
कठोरपनु : सं०पु०कए । कठोरता, क्रूरता । 'जनु कठोरपनु धरे सरीरू ।' मा० 
२.४१.३
कठोरा : कठोर । मा० १.६.१ कठोरि,
री : वि०स्त्री० । 'मति थोरि कठोरि न कोमलता।' मा० ७.१०२ छं. कठोरु,
रू : कठोर+कए । अद्वितीय कठोर । ‘मान हुं कुलिस कठोरू ।' मा० 
२.१५३
कठोरें : कठोर....' से । 'न त एहि काटि कुठार कठोरें।' मा० १ २७५.८
कठोरे : 'कठोर' का रूपान्तर (बहु०) । 'सुगम अगम मृदु मंजु कठोरे ।' मा० 
२२६४.२
कठौता : कठवता । कवि० २.१०
कड़हारू : सं०पु०कए० (सं० कर्णधार>प्रा. कण्णहारो>अ. कण्णहारु) । 
नाविक, मल्लाह । 'चहत पारु, नहिं कोउ कड़हारू ।' मा १.२६०.८ 
_______________________________________________
121 
कढ़त : वकृ०पु । निकलता, निकलते । 'कढ़त प्रेम बल धीर ।' गी० २.६६.३
काढ़इ : पूक० । खिंचवा कर, निकलवा कर । 'खाल कढ़ाइ बिपति सह मरई।' 
मा० ७.१२१.१७
कढ़ावउँ : आ० उए । खिचवालं । तो धरि जीभ कढ़ावउँ तोरी।' मा० २.१४.८
कढ़ावन : भक० अव्यय । खिचाने, रेखित कराने । 'तूम्ह सब कहह कढ़ावन टीका।' 
___ मा० २.१८१.३
कढैया : वि०। खींचने वाला, निकालने वाला । 'बार खाल को कढ़या सो बढ़ेया 
गुर-साल को।' कवि० ७.१३५
कढ़ोरि : पू०० । घसीटकर, खींचकर, बाहर निकालकर । 'तोरि जम कातरि 
__ मदोदरी कढ़ोरि आनी।' हनु० २७
कत : अव्यय (सं. कुतः>प्रा० कर्ता)। किस कारण । 'तौ कत दोष लगाइअ 
काहू ।' मा० १.६७.७ (२) कहाँ, किधर । कतहु,
हूं : कहीं भी, किसी ओर । 'खोजत कतहुं मिलइ नहिं धूरी।' मा० ४.१५.४
कति : वि०स्त्री० (सं० कियती>प्रा० कियत्ती)। कितनी । 'यह लघु जलधि 
तरत कति बारा ।' मा० ६.१.१ Vथ
कथइ : (१) सं० कथयति-कथ वाक्य प्रबन्धे--कहना; (२) कत्थते 
कत्थ श्लाघायम् - आत्म प्रशंसा करना। आ०प्रए। कहता है, प्रशस्तिगान __ करता है। जिमि जिमि तापसु कथइ उदासा।' मा० १.१६२.५
कथक : सं०० (सं०) । नाट्य-निर्देशक, मुख्य नर्तक जो टोली के बीच में अङ्गलि 
संकेत से या छड़ी घुमाकर सबको लय-ताल का अन शासन देता है जिसके इङ्गित पर सब नाचते हैं। कियो कथक को दंड हौं जड़ करन कुचाली।' 
विन० १४७.३
कथन : सं०० (सं.)। कहना, वर्णन । मा० १.४१
कथनीया : वि० (सं० कथनीय) । कहने योग्य, वर्णन-शक्य । 'सो सपनेहुं सुख नहिं 
कथनीया ।' मा० १.२४२.६
कथरी : सं०स्त्री० (सं० कन्था>प्रा० कंथा>अ० कंथडी)। वस्त्रखण्ड-निर्मित 
बिछावन । 'मलीन धरें कथरी करवा है।' कवि० ७.५६
कहिं : आ०प्रब० (सं० कत्थन्ते>प्रा० कत्थंति >अ. कत्थहिं) । प्रशस्ति गान 
करते हैं । 'कायर कहिं प्रतापु।' मा० १.२७४
कहि : कथा को । 'जो एहि कथहि..... कहिहाहीं ।' मा० १.१५.१०
कथा : सं०स्त्री० (सं.)। (१) आख्यान, इतिहास । 'राम कथा जगमंगल 
करनी ।' मा० १.१०.१० (२) वर्णन । 'करम कथा बिनदिनि बरनी।' मा० 
N. 
_______________________________________________
१.२.६ (३) वार्ता । 'मोरिओ सुधि या इबी कछु करुन कथा चलाइ ।" 
विन० ४१.१
कथाप्रबंध : कथा का प्रबन्ध काव्यात्मक रूप । मा० १.३३.२ कथा प्रसंगु,
गू : सं००कए० । वार्ता-सन्दर्भ, वृत्तान्त का अवसर, इतिवृत्त का 
अवसर प्राप्त अंश । 'पूरब कथा प्रसंगु सुनावा ।' मा० १.६८.१
कदंब : सं०० (सं.)। (१) वृक्ष-विशेष । 'चंपक बकुल कदंब तमाला ।' मा० 
३.४०.६ (२) समूह । 'कूदत कबंध के कदंब बंबसी करन ।' कवि० ६.४८
कदंबा : कदंब । समूह । 'एहि बिधि करेहु उपाय कदंबा ।' मा० २.८२.६
कदन : सं०० (सं.)। सूदन, वध, संहार । विन० २५.८ 
/कदरा,
कदराई : (सं० कातरायते>प्रा० कादराइ-कायर आचरण करना) । 
आ०ए० । कायरतापूर्ण आचरण करता है, करे । कायर व्यवहार करे । 'सुनि 
रजाइ कदराइ न कोऊ ।' मा० २.१९१.१
कदराई : (१) कदराइ । अति या कातर हो जाता है। करत कथा मन अति 
कदराई ।' मा० १.१२.१२ (२) सं०स्त्री० (सं० कातरता>प्रा० कादरया)। 
कायर कम रिपु पर कृपा परम कदराई ।' मा० ३.१६.१३ कदराहु,
हू : आ०मब० । (१) कातर होते हो। 'तुम्ह एहि भांति तात कदराहू ।' 
मा० २.१७६.३ (२) कातर होओ। 'तात प्रेम बस जनि कदराहू ।' मा० 
२.७०.८
कदरी : कदली। 'काटे पै कदरी करइ ।' मा० ५.५८
कदर्थना : स० स्त्री० (सं०) । उत्पीड़न, सन्तापना, घोर अपमान । 'कासी की ___कदर्थना कराल कलिकाल की ।' कवि० ७.१८२
कदचि : कदली । मा० ३.३०.१३
कदली : सं०स्त्री० (सं.) । केले का वृक्ष । मा० २.२०.२
कदाचि : कदाचित । संभवतः (मान लें कि, शायद)। जौं कदाचि मोहि मारहिं ।' 
मा० ४.७
कदाचित : अव्यय (सं० कदाचित्) । शायद ही, कभी, हो सकता है कि, विरल ____ अवसरों पर हो। 'तबहुं कदाचित सो निरु अरई।' मा० ७ ११७.८
कदूं : कद्र ने (सं० कद्रू = सर्पमाता= कश्यप-पत्नी विशेष) । 'बिन तहि ___दीन दुख।' मा० २.१६
कन : सं०पू० (सं० कण) । (१) किन का, लघु खण्ड । सिरस सुमन कन बोधिक 
हीरा । मा० १.२५८.५ (२) बंद | 'लसत स्वेद कन जाल ।' मा० २.११५ 
(३) चिनगारी । 'चंदु चवै बरु अनल कन ।' मा० २.४८
कनउड़ : वि०पू० (सं० कृतज्ञ>प्रा० कयण्णू) । आचारी, उपकृत । 'हमहि आजु 
लगि कनउड़ काहुँ न कीन्हेउ ।' पा०म०७३ 
_______________________________________________
123 
कनक : सं०० (सं०) । सुवर्ण मा० १.३५६.१ कनक
उ : सुवर्ण भी । 'कनकउ पुनि पषान ते होई ।' मा० १.८०.६
कनककासिपु : (कनक=हिरण्य)-हिरण्यकशिपु दैत्यराज, प्रह्लाद का पिता । 
मा० १.२७
कनकफल : कर्णाभरण विशेष जो पुष्पाकार बनते हैं-कनफल । गी० १.७३.४
कनकमय : वि० (सं०) । स्वर्ण घटित, प्रचुर सुवर्णयुक्त । 'तासु कनकमय सिखर 
सुहाए।' मा० ७.५६.८
कनकलोचन : (कनक =हिरण्य-+लोचन =अक्ष) हिरण्याक्ष (हिरण्यकाशिपु का 
अनुज) । मा० २.२६७.५
कनहिं : कनक पर, सुवर्ण में । कनकहिं बान चढ़इ जिमि दाहें।' मा० २.२०५.५
कनक : कनक+कए । सुवर्ण । 'कसे कनकु मनि पारिखि पाएँ।' मा० २.२८३.६
कनखियनु : कनाखिया+संब० (सं० कटाक्ष>प्रा. कडक्ख>अ० कडक्खिया)। 
कटाक्षों में नेत्रकोण दर्शन में। 'चितबनि बसति कनखियनु अँखियनु बीच ।' 
बर० ३०
कनगुरिया : सं० स्त्री० (सं० कनाङ्गलिका>प्रा० कणंगुलिया)। छोटी अँगुली 
(कनिष्ठा) । 'कनगुरिया के मुदरी कंकन होइ ।' बर० ३८
कनसुई : सं०स्त्री० (सं० कणसूची>प्रा० कणसूई) । आटे या गोबर की गौरी 
जिसे चलनी में घमाकर स्त्रियां औंधा करती हैं; यदि 'कनसुई' सीधी निकलती है तो शकुन, उत्तम माना जाता है । 'लेत फिर कनसूई सगुन सुभ ।' गी० 
१.७०.५
कनाउड़ो : कनउड-कनाउड+कए । कृतज्ञ, आभारी। 'जाचक जगत कनाड़ो।' 
दो० २८६
कनावड़े : कनाड़-कनावड़-+ब० । कृतज्ञ । 'जनक दसरथ किए प्रेम कनावडं ।' 
___ जा०म० छं० १६
कनिगर : वि०पू० । 'कानि' करने वाला, आत्मप्रतिष्ठा वाला, स्वाभिमानी। देखिए 
दास दुखी तोसे कनिगर के ।' हनु० ३३
कनियाँ : कनिया=गोद में । 'भूपं लिये कनियाँ ।' गी० १.३४.१
कनी : कनी+बहु० । कणिकाएँ, बूंदें । 'झलकी भरि भाल कनी जल की।' कवि. 
२.११
कनी : संस्त्री० (सं० कणिका>प्रा० कणिया>अ० कणी) =कण । (१) छोटी 
बूंद । 'अरुन तन सोनित कनी।' मा० ६.७१ छं० (२) छोटा कण । 'रज 
कनी ।' मा० ६.८३ छ।
कने : कण को, अन्नादि के खण्ड को। 'मोद पाइ कोदो कनै ।' गी० ५.४०.४ 
124 
_______________________________________________
कौड़े : कनावड़े ! 'कपि सेवा बस भए कनौड़े।' विन० १००.७
कनौड़ो : कनाउड़ो। (१) कृतज्ञ । 'प्रेम कनौड़ो राम सो।' विन० १६४.६ (२) क्षुद्र 
परिचारक आदि, क्रीत दास । 'प्रभुहि कनौड़ो भरिहैं।' विन० १७१.७
कन्दर्पह : (दे० ह) । कन्दर्प = कामदेव के घातक शिवजी । मा० ६.२ श्लोक २
कन्या : सं०स्त्री० (सं०) । (१) अविवाहिता बालिका । मा० १.८१.४ (२) पुत्री। 
__ मा० १.७१.८
कन्यादानु : सं०पु कए । विवाह के पूर्व माता-पिता द्वारा कन्या का बर को 
संकल्पित समर्पण । मा० १.३२४ छं० ३
कन्हाई : कान्ह । कृष्ण । कृ० २६
कन्हैया : कन्हाई (स्नेहातिरेक का प्रयोग) । कृ० २
कपट : सं०० (सं०) । छल । मा० १.१२.२
कपटमुनि : जल से मुनि बना हुआ। मा० १.१६५
कपदमग : छल से बना हआ मग, हरिवेष में मारीच । मा० ३.२७
कपटी : वि०पू० (सं० कपटिन्) । छली, वञ्चक । मा० १.७६.४
कपटु : कपट-+कए । एकमात्र छल । 'सती कपटु जाना सुरस्वामी ।' मा० 
१.५३.३
कपाट : संपु० (सं०)। किवाड़ । मा० १.२३२.७
कपाटा : कपाट । मा० १.२१४.१
कपाटो : कपाट, छोटा किवाड़। 'जिउ न जाइ उर अवधि कपाटी।' मा० 
२.१४५.४ कपारु,
रू : कपाल = कपार+कए० । (१) मत्था । 'कूबरू टूटेउ फूट कपारू ।' 
मा० २.१६३.५ (२) भाग्य । 'फोरै जोगु कपारू अभागा। मा० २.१६.२
कपाल : सं०पू० (सं.)। (१) नरमुण्ड । 'ब्याल कपाल विभूषच छारा ।' मा० 
१.९५.८ (२) खप्पर । मा० १.६३ छं०
कपाला : कपाल । मा० ६.२८.११
कपाली : वि०० (सं० कपालिन्) । नरमुण्डधारी। मा० १.७६.६
कपालु : कपाल+कए । एक नरमुण्ड या खप्पर ! 'डमरू कपालु कर ।' कवि० 
७.१४६
कपास : सं०० (सं० कर्पास>प्रा० कप्पास)। रुई । मा० ७.११७ ग
कपासू : कपास+कए । 'साधु चरित सुभ चरित कपासू ।' मा० १२.५
कपि : सं०० (सं०) । वानर । मा० १.२५.३
कपिदा : सं००+वि० (सं० कपीन्द>प्रा० कइंद)। श्रेष्ठ वानर । (१) हनुमान । 
मा० ५.३५.३ (२) अंगद । मा० ६.३२.१ 
_______________________________________________
125 
U 
कपिकच्छ : सं०स्त्री० (सं.)। के वांच नामक लता (जिसे वानर उखाड़ डालता 
है)। 'बाहु सूल कपिकच्छु बेलि - कपिकेलि ही उखारिए।' हनु० २४ कपिक
जर : हाथी जैसे डील डोल वाला वानर । 'कट कटान कपिकुंजर भारी।' 
मा०६.३२.३ कपिन,
न्हि : कपि+संब० । वानरों। 'देखिन्ह जाइ कपिन्ह के ठट्ठा।' मा० 
६.४१.४
कपिपति : वानरों का राजा-सुग्रीव । मा० ४.४.२
कपिपोत : (दे० पोट) । बन्दर का बच्चा । 'रे कपिपोत बोलु संभारी।' मा० . 
६.२१.१ कपिराइ,
ई : कपिराज । मा० ५.५।। कपिराउ,
ऊ : (दे० राऊ) । वानरों का एकमात्र स्वामी । मा० ४.१२.४
कपिराज : कपिपति । (१) सुग्रीव । मा० ६ ६५ (२) श्रेष्ठ वानर, हनुमान । 
कवि० ७.१७६
कपिल : सं०० (सं०) । सांख्यशास्त्र के प्रवर्तक मनि जो चौबीस अवतारों में 
परिगणित हैं । मा० १.१४२.६.
कपिलहि : कपिला गाय को। 'जिमि कपिलहि घालइ हरहाई।' मा० ७.३६.२
कपिला : संस्त्री० (सं०)। पीले रंग की श्रेष्ठ गाय । जिमि मलेच्छ बस कपिला 
गाई ।' मा० ३.२६.८
कपिलोला : वानरक्रीडा-उछल कूद, मुह बिचकाना, किलकिला शब्द, दांत 
निकालना, झपट्टा, खो खो ध्वनि आदि । मा० ६.४४.५
कपिश : वि० (सं०)। भूरे रंग का (वानर जैसे रंग वाला)। 'कपिश कर्कश 
जटाजूटधारी।' विन० २८.२
कपिस : कपिश । हनु० २
कपिहिं : कपि ने ही 'प्रभु कारज लगि कपिहिं बँधावा ।' मा० ५.२०.४
कपिहि : कपि को, कपि के प्रति । 'सो छन कपिहि कलप समबीता।' मा० 
५.१२.१२
कपीश्वर : वानर श्रेष्ठ-हनुमान । मा० १ श्लोक ४ कपीस,
सा : (सं०
कपीश) : (१) वानरराज =सुग्रीव । मा० ४.२०.२ (२) श्रेष्ठ 
वानर । हनुमान
कपोसु : कपीस+कए० । अद्वितीय वानरराज । (१) हनुमान । 'कपीसु कूषो बात 
घात जलधि हलोरि के।' कवि० ५.२७ (२) सुग्रीव । कवि० ७.४
कपूत : सं०० (सं० कुपुत्र, कापुत्र, कसुत्र>प्रा. कप्पुत्त) । निन्दित पुत्र । मा० 
१.२६६.१ 
126 
_______________________________________________
कपूतन : कपूत+संब० । कपूतों। 'कायर कूर कपूतन की हद ।' कवि० ७.१
कपूर : कर्पूर । दो० २५५
कपोत : सं०पु० (सं०) । भूरा पारावत, कबूतर । मा० ३.३०.१० 
कपोल : सं०० (सं.)। गाल । मा० १.१४७.१ कपोलन,
नि : कपोल+संब० । कपोलों। कूडल लोल कपोलन की।' कवि० 
कपोला : कपोल । मा० १.१६६.६
कफ : सं०पु० (सं.)। त्रिदोष में, अन्यतम । श्लेष्मा । मा० ७.१२१.३०
कव : अव्यय (सं० कदा>प्रा० कआ; सं०
कुत:>प्रा० कओ>अ० कउ>कव) । 
किस समय । मा० २.११.६
कबंध : संपु० (सं.)। (१) एक राक्षस जिसका धड़ ही था, सिर वृक्ष पर 
लटकता-लगा था । मा० ३.३३.६ (२) शरीर का धड़ भाग, शिरोरहित 
शरीर । 'कूदत कबंध के कदंब बंस सी करत ।' कवि० ६.४८
कबंधु : कबंध+कए । कबन्ध नामक राक्षस । कवि० ६.११
कहिं : निश्चित रूप से कब, भला कब । 'कबहिं देखिबे नयन भरि।' मा० । १.३०० 
कबहुँ,
हूँ : कभी, किसी समय । 'कबहुं पालने घालि झुलावै ।' मा० १.२००.८
कबहुँक : कभी एक बार (कबहुं+इक) | कभी तो। 'कबहुँक ए. आवहिं एहि 
नाते।' मा० १.२२२.८
कबार : सं० । लेन देन का लघु व्यवसाय, छोटी मोटी दुकानदारी, क्रय विक्रय 
धंधा । 'मागध सूत भाट नट जाचक जहँ तह करहिं कबार ।' मी० १.२.२१
कबारू : कबार+कए । 'नहिं जानउँ कछु अउर कबारू ।' मा० १.१००७
कबि : सं० (सं० कवि) । (१) ऋषि, तत्त्व दृष्टा (२) विद्वान्, विवेकी । 
(३) शब्दों में भाव व्यक्त करने वाला साहित्यकार । मा० १.६.८
कबित : सं०० (सं० कवित्त्व>प्रा० कवित्त) । कविकर्म, काव्य कौशल, कविता 
कला । मा० १.६.११
कबितरस : (दे० नवरस) परम्परागत काव्य रस जिनमें सहृदय विषय-वासना का 
रस-निष्पत्ति की प्रणाली से आस्वादन करता है। वासना की सूक्ष्म अनुभूति से पथक कोई बाह्य प्रयोजन नहीं माना जाता । 'जदपि कबित रस एकउ नाहीं।' 
मा० १.१०.७
कबितरसिक : वे रसिक जो स्वागत वासना का ही काव्य के माध्यम से रस रूप में 
आस्वादन करते हैं, इस रसास्वाद से पथक किसी काव्य प्रयोजन को मान्य नहीं