596 
_______________________________________________
पाट : (१) सं०पू० (सं० पट्ट) । रेशम । 'रोम पाट पट अगनित जाती।' मा २.६.३ (२) वि० । विशिष्ट, श्रेष्ठ-दे० पाट महिषी।
पाटंबर : सं०पु० (सं० पट्टाम्बर>प्रा० पटेंबर) । रेशमी परिधान । मा० ७.६५ ख
पाटन : सं०० (सं०)। फाड़ना । मा० ३ श्लोक १
पाटमय : वि० (सं० पट्टमय) । रेशमी । 'लसत पाटमय डोरि।' मा० १.२८८
पाटमहिषी : (सं० पट्टमहिषी--पट्टराज्ञा) । पटरानी, बड़ी रानी । मा० १.३२४.१
पाटल : सं०० (सं.)। गुलाब से मिलता-जुलता पुष्प वृक्ष विशेष । मा० ६.६० छं० 
पाटि, टी: सं०स्त्री० (सं० पट्टी, पट्टिका)। तख्ता, झूले की बैठकी। 'पाटीर पाटि बिचित्र भंवरा ।' गी० ७.१८.२ ।।
पाटियतु : वकृ०कवा०पु०कए । पाटा जाता (समतल किया जाता) । 'मसक की पांसूरी पयोधि पाटियतु है ।' कवि० ७.६६
पाटीर : सं०० (सं.)। चन्दन । गी० ७.१८.२
पाटे : भूक.पुब । पाट दिये, पूर दिये । 'ते दिसि बिदिसि गगन महि पाटे।' मा० ६.६३.६
पाठ : सं०० (सं०) । शब्दवाचन । 'पसु नाचत सुक पाठ प्रबीना। मा० २.२६६.८
पाठक : वि० (सं.)। पढ़ाने वाला। 'गुन गति नट पाठक आधीना।' मा० २.२६६.८
पाठीन : सं०० (सं.)। मत्स्यविशेष, पढ़िन मछली । मा० २.१९३.३
पाठीनु : पाठीन-+कए । एकाकी पाठीन । 'जनु पाठीनु दीन बिनु पानी ।' मा० २.३५.२
पाठु : पाठ+कए । रटन्त । 'दस आठ को पाठु कुकाठु ज्यों फार।' कवि०. ७.१०४
पाणि : सं०० (सं०) । हाथ। मा० ३.११.४
पाणौ : (सं०-पद) हाथ में । मा० २ श्लोक ३
पात : सं०० (सं० पत्र>प्रा० पत्त) । पत्ता, पत्ते । 'पीपर पात सरिस मनु डोला ।' मा० २.४५.३ (२) घास-फूस । 'ईंधनु पात किरात मिताई ।' मा० २.२५१.२ (३) पत्तल । 'पात भरी सहरी।' कवि० २.८
पातक : सं०० (सं०) । पतन लाने वाला पतित करने वाला=पाप; अशुभ कर्म । मा० २.२८.५ पातक तीन भागों में विभक्त हैं--(क) महापातक = ब्रह्महत्या. सुरापान, स्तेय (चोरी), गुरुपत्ती समागम तथा इन पापों के कर्ता के साथ सम्पर्क । (ख) पातक - उक्त पांचों के तुल्य पापकर्म । (ग) उपपातक = जो उक्त दोनों से न्यून हों । मा० २.१६७ का पूरा प्रसङ्ग । सुलसी शब्द-कोश 
597 
पातकमई : वि०स्त्री० (सं० पातकमयी)। पापपूर्ण । मा० १.३२४ छं० २
'पातकरूप : शरीर धारी पातक (जिनका आकार-प्रकार पापनिर्मित हो) । विन० २१४.६
'पातकिनि: वि.स्त्री. (सं० पातकनी) । पापिनी, पातक करने वाली। मा० २.२२
पातकी : वि०पू० (सं.)। पापकर्मा, पातकशील । मा० २.१६२
पातकोसु : (पातकी+ईसु-सं०
ईश:>प्रा० ईसो>अ० ईस)। अद्वितीय श्रेष्ठ पातकी । 'पुनीत कियो पातकीसु ।' कवि ७.१८
पातक : पातक+कए. । अद्वितीय एक पाप । 'दिएँ उतरु फिरि पातकु लहऊँ।' मा० २.६५.८
पातरि : पातरी । 'चाटत रह्यो स्वान पातरि ज्यों ।' विन० २२६.३
पातरी : सं०स्त्री० (सं० पत्रल>प्रा० पत्तल> अ० पत्तली-पत्तलि -पत्तडी पत्तडि) । पत्तल, पत्रों का बना पात्र । 'ललकत लखि ज्यों कँगाल पातरी सुनाज की।' कवि० ६.३०
पाता : (१) पात । पत्ता। मा० २.११६.७ (२) वि०० (सं०)। रक्षक । 'रुद्र अवतार संसार पाता।' विन० २५.३
पाताल : सं०० (सं.)। अधोलोक (तल, अतल, वितल, सुतल, तलातल, रसातल और पाताल)। मा० १.२६५.५
पाती : संस्त्री० (सं० पत्री>प्रा० पत्ती)। (१) दल, पत्ता। 'बेल पाती महि परइ सुखाई ।' मा० १.७४.६ (२) चिट्टी । 'तात कहाँ ते पाती आई।' मा. १.२६०.८
पातु : आ०-प्रार्थना-प्रए० (सं.)। रक्षा करे । मा० २ श्लोक १
पात्र : सं०पु० (सं०) । (१) बर्तन । मा० ७.११७.१२ (२) किसी विषय या वस्तु का योग्य अधिकारी । 'कृपा पात्र ।' मा० ७.७०.२
पात्रु : पात्र--कए० । एकमात्र अधिकारी । 'पेम पात्रु तुम्ह सम कोउ नाहीं।' मा० २.२०८.३ 
पाथ, था : सं०पू० (सं० पाथस्) । जल । मा० १.४२.७; १.१० छं०
पाथनायु : सं०० (सं० पाथोनाथ) कए । समुद्र । 'पाथनाथु बांधि आयो नाथ ।' कवि० ६.२३
पाथप्रदनाथ : पाथप्रदों मेघों के स्वामी=इन्द्र । कवि० ५.१६
पाथु : पाथ+कए । अद्वितीय जल । 'आश्रम सागर सात रस पूरन पावन पाथ ।' मा० २.२७५
पाथोज : सं०० (सं.)। कमल । मा० १.१०१ छं० 
598 
_______________________________________________
पायोजनाभ : पद्मनाभ, विष्णु (जिनकी नाभि से आविर्भूत कमल से ब्रह्मा ने जन्म लिया)। विन० ५०.२
पायोजपानी : (सं० पाथोजपाणि) कमल तुल्य हाथों वाला+पद्मपाणि = विष्णु (जिनके हाथों में शङ्ख, चक्र, गदा और पद्म रहते हैं)। विन० ५६.६
पाथोद : सं०० (सं०) । मेघ । मा० ३.३२ छं० १
पाथोधि : सं०० (सं०) । समुद्र । मा० ६.६.२
पाद : सं०० (सं०) । चरण । मा० १ श्लोक ६
पादप : सं०० (सं०) । वृक्ष । मा० ६.१
पादमूल : चरणतल । विन० १०.८
पादुकन्हि : पादुक+संब० । पादुकाओं (में) । 'जिन्ह पायन्ह के पादुकन्हि भरतु रहे 
__ मन लाइ।' मा० ५.४२
पादुका : सं०स्त्री० (सं०) । खड़ाऊँ मा० २.३२३
पादोदक : (पाद=चरण+उदक=जल) चरणोदक, पाद-प्रक्षालन का जल । मा० ७.४८.२
पान : (१) सं०० (सं० पान) । पीना, पीने की क्रिया। 'गुनद करहिं सब पान ।' मा० १.१० ख (२) जल । 'ऊख अन्न अरु पान ।' वैरा० ३६ (३) मद्यपान । 'करइ पान सोवइ षट मासा ।' मा० १.१८०.४ (४) पेय पदार्थ । 'पान पकवान बिधि नाना को।' कवि० ५.२३ (५) (सं० पर्ण>प्रा. पण्ण) पत्ता । 'कनक कील मनि पान संवारे ।' मा० १.३२८.८ (६) ताम्बूल । 'देइ पान पूजे जनक ।' मा० १.३२६ पान
हिन्ह : पानही+संब० । जूतियों। 'बिनु पानहिन्ह पयादेहिं पाएँ।' मा०. २.२६२.५
पानहीं : पानही ब० । जूतियां । 'तेहि के पग की पानहीं मेरे तन को चाम ।" दो० ५६
पानही : पनही (सं० उपानह ) । 'कहत पानही गहिहौं ।' विन० २३१.४
पानह्यो : पानही भी, जूती भी। पानह्यो न पायनि ।' गी २.२५.२
पाना : पान । (१) पीने की क्रिया। 'दरस परस मज्जन अरु पाना।' मा० १.३५.१ (२) पत्ते, ताम्बूल । 'औषध मूल फूल फल पाना ।' मा० २.६.२
पानि : (१) पाणि । हाथ । 'बहु बिधि क्रोडहिं पानि पतंगा।' मा० १.१२६.५ (२) पानी । जल । 'पानि कठवता भरि लेइ आवा ।' मा० २.१०१.६
पानिग्रहन : सं०० (सं० पाणिग्रहण) । विवाह में वर द्वारा वधू का करपीडन । मा०१.१०१.३
पानिग्रहनु : पानि ग्रहन+कए । मा० १.३२४ छं० ३
पानी : पानी में, जल में । बिकल मीनगन जनु लघु पानी ।' मा० १.३३४.२ तुलसी शन्द-कोश 
599 
पानी : (१) सं०० (सं० पानीय>प्रा० पाणिभ)। जल । 'देखि निकट बटु सीतल पानी ।' मा० २.१२४.३ (२) पाणि । हाथ । 'धोए चरन जनक निज पानी ।' मा० १.३२८.६
पाप : सं०पू० (सं.)। (१) पातक । 'पाप पयोनिधि जन मन मीना।' मा० १.२७.४ (२) गुप्त दोष । 'पिसुन पराय पाप कहि देहीं ।' मा० २.१६८.१
पापछालिका : (सं० पाप-क्षालिका) पापरूपी पङक को धो बहाने बाली । विन. १७.१
पापप्रिय : वि० (सं०) । पाप में रुचि रखने वाला । मा० ५.४५.८
पापमई : पापमय । 'देतो पं देखाइ बल, फल पापमई ।' गी० १.८५.२
पापमय : वि० (सं.)। पापपूर्ण । मा० ५.४३
पापमूल : पापों की जड़-जहाँ से पापों को पोषण मिले अति पापी । विन ० २१७.२
पापवंत : वि० (सं० पापवत्) । पापी। मा० ५.४४.३
पापहर : वि.पुं० (सं०) । पापों को नष्ट करने वाला । मा० ७.१३० श्लोक २
पापहरनि : वि०स्त्री० । पाप नाशिनी । गी० २.४७.२
पापहारी: वि.० (सं० पापहारिन्) । पाप नाशक । विन० ४३.३
पापहि : पाप की। तिन्ह के पापहि कवनि मिति ।' मा० १.१८३
पापा : पाप । मा० ३.३३.७
पापिउ : पापी भी । 'पापिउ जाकर नाम जाकर नाम सुमिरहीं।' मा० ४.२६.३
पापिन : पापी+संब० । पापियों । 'चलिहैं छुटि पुज पापिन के ।' विन० १५.२ 
पापिनि, नी : वि.स्त्री० (सं० पापिनी) । पापकारिणी । मा० २.७३
पापिनिहि: पापिनी को। 'एहि पापिनि बक्षि का परेऊ ।' मा० २.४७.२
पापिष्ट : वि० (सं० पापिष्ठ>प्रा०-मागधी-पापिस्ट)। अतिशय पापी । मा० ६.११३ छं०
पापिष्ठ : वि० (सं०) दे० पापिष्ट । विन० ५८.४
पापिहि : पापी को । 'एहि पापिहि मैं बहुत खेलावा ।' मा० ६.७६.१४
पापी : वि.पु. (सं० पापिन्) । पातकी, पापकर्मा । मा० १.१३५
पापु : पाप+कए । अद्वितीय पाप । 'किएँ प्रेम बड़ पापु।' मा० १.५६
पापौघ : (पाप+ ओघ) पाप-प्रवाह । पाप समूह ।
पापौघमय : वि० (सं०) पाप समूह से व्याप्त । मा० ६.१०४ छं०
पामर : दे० पावर (सं.) । विन० ६६.६
पायें : (१) पाय । चरण । 'न पायें पिराने ।' विन० २३५.३ (२) पैरों से । 'राम पयादेहिं पायें सिधाए ।' मा० २.२०३.६ (३) पैरों पर। 'बिनय करबि परि पाय।' मा० २.९८ 
600 
तुलसी शब्दकोश 
पाय : (१) सं०० (सं० पाद>प्रा० पाय)! चरण । 'पाय पलोटत भाइ।' मा० २.८६ (२) पाइ । पाकर । 'आयसु पाय कपि ।' रा०प्र० ५.३.७
पायउँ : आ०-भूक००+उए । मैंने पाया । 'सो फल पायउँ कीन्हेउँ रोष ।' मा० ३.२६.३ 
पायउ, ऊ : भूकृ००कए० । पाया, प्राप्त किया। 'पायउ अचल अनुपम ठाऊँ।' ___ मा० १.२६.५
पायक : (१) पाइक (२) (फा० पायक प्यादः) पैदल सैनिक (३) (सं०) रक्षक । 'जिन्ह के हनुमान से पायक ।' मा० ६.६३.३ (४) पाय+क । पाने का। 'कछु सुभाउ जनु नर तनु पायक ।' गी० २.३.४ 
पायन, नि : पाय+ संब० । पैरों (में) । 'पानह्यो न पायनि ।' गी० २.२५.२ 
पायन्ह, न्हि : पायन । 'झलका झलकत पायन्ह कैसें ।' मा० २.२०४.१
पायस : सं०० (सं.)। खीर । 'पायस पाइ बिभाग करि रानिन्ह दीन्ह बुलाइ ।' रा०प्र० ४.१.२
पायसि : आ० -- भूकृ००+प्रए० । उसने पाया-ये । 'निदरेसि हरु पायसि फर तेउ।' पा०म० २६
पायहु : आ-भकृ००+मब० । तुमने पाया-पाये । 'बर पायहु कीन्हेहु सब काजा ।' मा० ६.२०.४
पाया : पावा । प्राप्त किया । 'बड़ अपराध कीन्ह फल पाया।' मा० १.१३६.३
पाये : पाए । विन० ८०.४
पायों : पायउँ । मैंने पाया-पाये । 'मैं फिरत न पायों पार ।' विन० १८८.३ 'जो __ दुख मैं पायों सुजनी ।' कृ० २५
पायो : पायउ । मा० ६.४८.८
पार : वि०+क्रि०वि० (सं.)। (१) पारंगत, परे, अतिक्रान्त । 'माया मोह पार परमीसा ।' मा० ७.५८.७ (२) अन्त, समाप्ति । 'बाढ़इ कथा पार नहिं लहऊँ।' मा० १.१२.५ (३) अन्त =मक्ति+किनारा। 'संसार सिंध अपार पार ।' मा० ६.१०६ छं० (४) किनारे । उस पार । 'बारिधि पार गयउ मति धीरा।' मा० ५.३.५ (५) इस किनारे । 'सिंधु पार सेना सब आई।' मा० ५.३७.७ (६) दे० /पार। /पार
पारइ : (सं० पारयति>प्रा० पारइ) आ.प्रए । सकता है। ‘गने को पार निसाचर
जाती :' मा० १.१८१.३
पारई : सं०स्त्री० (सं० पालि=पालिका>प्रा० पालिआ>अ० पालई-परि०)। प्याली, परई, मिट्टी का सकोरा । 'मनि भाजन, मधु पारई।' दो० ३५१
पारखी : वि.पु. । पारिख वाला, जानकार, विवेकी, कुशल । 'सोइ पंडित सोइ पारखी। वैरा० ५८ _______________________________________________
601 
पारथ : सं०पू० (सं० पार्थ-पृथापुत्र) ! कुन्तीपुत्र अजुन आदि । कृ० ६१
पारथिव : सपु+वि० (सं० पार्थिव) । मिट्टी (पृथ्वी) की बनी शिवमूर्ति । 'पूजि पारथिव नायउ माथा ।' मा० २.१०३.१
पारद : सं०पु० (सं०) । पारा (रसेन्द्र)। दो० २६० । 'तुलसी छुवत पराइ ज्यों पारद पावक आंच ।' दो० ३३६
पारन : सं.पु+स्त्री० (सं० पारणा)। उपवास के बाद भोजन । विन० २०३.१३
पारवति : पारबती। मा० १.११२
पारबतिहि : पार्वती को। 'पारबतिहि निरमय उ जेहिं ।' मा० १.७१
पारबती : पार्वती ने । “पारबती तपु कीन्ह अपारा ।' मा० १.८६.४
पारबती : सं स्त्री० (सं० पार्वती)। पर्वतपुत्री-उमा। मा० १.७७
पारस : सं०० (सं० परश-दे० परसमनि)। एक काल्पनिक पत्थर जिसके स्पर्श से लोहा सोना हो जाता है, ऐसी पौराणिक जनश्रुति है। 'पारस परस कुधातु सुहाई ।' मा० १.३.६
पारसु :
पारस+कए० : अद्वितीय परशमणि । 'परमरंक जिमि पारसु पावा।' मा० २.१११.१
पारहि : (१) आप्रब० (सं० पारयन्ति>प्रा. पारंति>अ. पारहिं) । सकते हैं। 'कछु कहन न पारहिं ।' मा० ७.१७.४ (२) (सं० पातयन्ति-तु>प्रा० पाउंति तु>अ० पाडहिं) । डालें (गिनती में डालें)। 'ते बिरंचि जनि पारहिं लेखें ।' मा० १.३५७.८
पारहि : पार को । बिनु श्रम पारहि जाहिं ।' मा० १.१३
पारा : (१) पार । 'कब जैहउँ दुख सागर पारा।' मा० १.५६.१ (२) पारइ । सकता है । 'तुम्हहि अछत को बरनै पारा।' मा० १.२७४.५ (३) भूकृ०० (सं० पारित>प्रा० पारिअ) । सका, सकता था। 'बाली रिपु बल सहै न पारा।' मा० ४.६.३ (४) (सं० पातित>प्रा. पाडिअ)। डाला, गिराया। 'तुम्ह जेहि लागि बज्र पुर पारा । मा० २.४६.८
पारायण : परायन । तत्पर । विन० ६०.१
पारावत : सं०० (सं०) । कबूतर । मा० ७.२८.५
पारावार : सं०० (सं०) । समुद्र । गी० १.६४.३
पारिखि : वि० (सं० परीक्षिन् >प्रा० पारिक्खी । पारखी, परीक्षक । 'कसें कनकु मनि पारिखि पाएँ।' मा० २.२८३.६
पारिखी : पारिखि । कवि० १.१५
पारिखो : वि.पु.कए० (सं०
परीक्षक:>प्रा० पारिक्खओ>अ० पारिक्ख उ)। पारखी, परखने वाला । नारद सों परदा न नारद सो पारिखो।' कवि० १.१६ 
602 
तुलसी शब्द-कोश
पारी : भूक०स्त्री० (सं० पातिता>प्रा. पाडिआ)। गिरा दी। 'प्रभु सोउ भुजा काटि महि पारी ।' मा० ६.७०.१० 
पारु, रू: पार+कए । कोई ओर-छोर, किनारा । 'बेद न पावहिं पारु ।' मा० १.१०३
पारे : (१) पारइ । सकता है, सके । 'बिपुल जोग जल बोरि न पारे।' कृ० ५७ 'नासा तिलक को बरन पारे ।' मा० १.१९६.८ (२) भूक पुब० (सं० पातित >प्रा० पाडिय)। गिरा दिये। 'भुजन्हि समेत सीस महि पारे ।' मा० ६.६२.१०
पारो : आ०मब० (सं० पारयथ-त>प्रा० पारह>अ० पारहु)। सको, सकते होओ। 'मधुकर कहहु कहन जो पारो।' कृ० ३४
पार्यो : भूकृ.पु०कए० (सं० पातितः>प्रा०
पाडिओ) : गिराया। 'बुधि बल 
__ निसिचर परह न पार्यो।' मा० ६.९५.८
पाल : वि०पु० (सं.)। (१) पालक, रक्षक, पोषक । 'सेवक सालि पाल जलधर से ।' मा० १.३२.१० (२) राजा, स्वामी । कोसलपाल आदि । (३) पालइ । 'प्रजा पाल अति बेद बिधि ।' मा० १.१५३ पाल
पालइ : (सं० पालयति>प्रा. पालइ) आ.प्रए । पालता है, रक्षा करता है । 'पालइ पोषइ सकल अंग ।' मा० २.३१५
पालउ : पालव+कए० । कोई एक पल्लव । 'पेड़, काटि ते पालउ सींचा।' मा० २.१६१.८
पालक : वि०० (सं०) । रक्षक । 'जो कर्ता पालक संहर्ता।' मा० ६.७.४
पालकिन्ह : पालकी+संब० । पालकियों (में) । 'कुरि चढ़ाई पाल किन्ह ।' मा १.३३८
पालकों : पालक+ब० । पालकियाँ । ‘मात पालकी सकल चलाई ।' मा० २.२०३.१
पालको : सं०स्त्री. (सं० पालि=पालिका-वृत्त, घेरा)। कहारों से ढोई जाने वाली पर्दादार सवारो। मा० २.३१६
पालत : वकृ.पुं० । पालन करता-ते । मा० ५.२१.५
पालति : वकृ०स्त्री० । पालन करती। 'जो सजति जगु पालात हरति ।' मा० २.१२६ छं०
पालन : (१) सं ० (सं.) । रक्षण । 'जग संभव पालन लय कारिनि ।' मा० १.९८.४ (२) वि.पु. । पालनकर्ता । 'भालु कटक पालन ।' कवि० ७.११४ पाल
निहार : वि०पू० । पालनशील, रक्षक । गी० ५.२५.२
पालने : (दे० पलना) । पाल ने पर, झूले पर। 'कबहुं पालनें घालि झुलावै ।' मा० १.२००.८ _______________________________________________
603 
पालने : पालनें । 'पोढ़िये लालन पालने हौं झुलावौं ।' गी० १.१८.१
पालनो : सं००कए० । पालना, बच्चों का झूला । 'कनक रतनमय पालनो।' गी० १.२२.१
पालबी : पालिबी । गी० ७.२६.३ (पाठान्तर)।
पालय : पल्लव । 'पालव बैठि पेड़, एहिं काटा ।' मा० २.४७.५ 
पालहि, हीं : आप्रब० (सं० पालयन्ति>प्रा. पालंति>अ० पालहिं) । पालन करते हैं । 'जे पालहिं पितु बैन ।' मा० २.१७४ 
पालहि, हो : आ०मए० (सं० पालय>प्रा० पालहि)। तू पालन कर, रक्षा कर । "उपाय करि कुल पालही ।' मा० २.५० छं०
पालहु : आ०मब० (सं० पालयत>प्रा. पालह>अ० पाल हु) । रक्षा करो। 'पालहु प्रजा सोकु परिहरहू ।' मा० २.१७५.१
पालहुगे : आ० भ००मब० । पालन करोगे । पाल्यो है, पालत, पालहगे।' विन० २२३.२
पाला : भूक०'० । पालन किया। प्रनतपाल पन आपन पाला।' मा० २.२६७.५
पालागनि : सं-स्त्री० । पैलगवा, चरण-स्पर्श की क्रिया । नववधू द्वारा पतिगृह की वयस्काओं के पैर छूने की रीति । गी० १.११०.२
पालि : (१) पू० (सं० पालयित्वा>प्रा० पालिअ>अ० पालि) । पालन करके । 'प्रजा पालि परिजन दुख हरहू ।' मा० २.१७६.६ (२) आ.-आज्ञा-मएक (सं० पालय>प्रा० पालहि>अ० पालि)। तू पालन कर। 'रामरूप सिसु.'' तूं प्रेम पय पालि री ।' कवि० १.१२
पालिअत : वकृ०कवा.पु. पाला जाता । 'कोटिक उपाय करि लालि पालिअत देह ।' __ कवि० ७.११०
पालिऐ : आकवा०प्रए । (सं० पाल्यते>प्रा० पालीअइ)। पाला जाय, पालना चाहिए । 'राम कृपालं पालिऐ।' दो० १७८
पालिका : वि०स्त्री० (सं.)। पालन करने वाली। विन० १६.३
पालिके : पालिका+सम्बोधन (सं०) । हे रक्षिके । 'तेरेही प्रसाद जग, अग जग पालिके।' कवि० ७.१७३
पालित : भूक०वि० (सं०) । रक्षित । 'रावन पालित लंका ।' मा० ५.३३.५
पालिबी : भकृ०स्त्री०१० । पालनों, पालनी हैं; पालनी चाहिएँ। 'ए दारिका परि 
___चारिका करि पालिबौं ।' मा० १.३२६ छं० ३
पालिबी : भक०स्त्री० । पालनी, पालनीय । गी० ७ २६.३
पालिबे : भक०० (सं० पालयितव्य>प्रा. पालिअव्व=पालिअध्वय)। पालने, रक्षा करने । 'दीन पालिबे जोग ।' दो० १७८ 
604 
_______________________________________________
पालिबो : भक००कए० (सं० पालयितव्यम् >प्रा० पालिअव्वं>अ० पालिव्वउ) । पालन करना । 'लाभ समय को पालिबो ।' दो० ४४४
पालिये : पालिए। विन० ३५.४
पालिहिं : आ० भ०प्रब० (सं० पालयिष्यन्ति>प्रा० पालिहिति>अ० पालिहिहिं)। पालन करेंगे । 'पितु आयसु पालिहिं दुहु भाई।' मा ० २.३१५.४
पालिहि : आ०भ० प्रए० (सं० पालयिष्यति>प्रा० पालिहिइ)। पालन करेगा । 'गुरु प्रभाउ पालिहि सबहि ।' मा० २.३०५
पालिहैं : पालिहिं । बालक ज्यों पालिहैं कृपालु ।' हनु० १३
पालिहै : पालिहि । 'को कृपाल बिनु पालिहै ।' मा० २.२६६
पाली : भूक स्त्री० । पालन की, रखी । “मैं सबकी रुचि पाली ।' विन० १४७.३
पालु : (१) आo=पालि (अ.)। तू पालन कर । 'पालु बिबुध कुल करि छल छाया ।' मा० २.२६५.२ (२) पाल+कए० । एकमात्र रक्षक ! 'प्रनत पाल ।' विन० १५४.१
पालें : पालन करने से । 'स्वामि सिख पालें...पग परहिं न खालें ।' मा० २.३१५.५
पाले : (१) भूकृ०० (सं० पालित>प्रा. पालिय) । रक्षित । 'मोसे ते कृपालु पाले पोसे ।' विन० २५०.१ (२) क्रि०वि० (सं० पल्ये, पल्ले) । फन्दे में, पकड़ में । 'परेहु कठिन रावन के पाले ।' मा० ६.६०.८ (सं० पल्ल =पल्य बड़े डहरे को कहते हैं जिसमें अनाज रखते हैं। उसके भीतर फंसे हुए प्राणी का श्वासरोध स्वाभाविक है। इसी आधार पर पाले पड़ना' या 'पल्ले पड़ना' मुहावरा चल पड़ा लगता है।)
पलेहु : आ० -भ+आज्ञा-मब ० । तुम पालन करना । 'पालेहु पुहुमि प्रजा रजधानी।' मा० २.३१५.८
पालो : पाल्यो । पाला हुआ। पालो तेरे ट्रक को।' हनु० ३४
पाल्यो : भूक००कए० (सं०
पालित:>प्रा० पालिओ) । पाला हुआ । पाल्यो हौं बाल ज्यों।' हनु० ३६
पावर : वि०० (सं० पामर>अ० पावर) । नीच, गवार, मूर्ख । मा० २.१६४
पावरन्हि : पावर+संब० । पामरों। 'पावरन्हि की को कहै ।' मा० १.८५ छं०
पावरी : पावरी+ब० । खड़ाउएँ । 'प्रभु करि कपा पावरी दीन्हीं।' मा० २.३१६.४
पावरी : सं०स्त्री० (सं० पादुका>प्रा० पाउल्ला>अ० पाअडी)। खड़ाऊँ।' मा० २.३२५
पावरु : पावर+कए । कोई मूर्ख । 'जो पावरु अपनी जड़ताई।' मा० २.१८४.६
पाव : (१) पाउ। पैर । पंथ देत नहिं पाव ।' वैरा० १२ (२) पावइ । पाता है। पा सकता है । 'घृत कि पाव कोउ बारि बिलाएं।' मा० ७.४६.५ _______________________________________________
605 
'पाव
पावइ : (सं० प्राप्नोति>प्रा० पावइ) आ०प्रए । पाता है । 'सो परत्र दुख पावइ ।' मा० ७.४७
पावई : पावहिं । रान० २०
पावई : पावइ । 'नर भगति अनुपम पावई ।' मा० ३.६ छं०
पावउँ : आ०उए० (सं० प्राप्नोमि>प्रा० पावमि>अ० पावउँ) । पाऊँ, पाता हूं। 'जासु कृपाँ निरमल मति पावउँ ।' मा० १.१८.८
पावक : सं०पू० (सं०) । अग्नि। मा० १.१७
पावकमय : वि.पु. (सं०) । अग्निरूप, आग से पूर्ण । 'पावकमय ससि स्रवत न आगी।' मा० ५.१२.६
पावक : पावक+कए । अकेला ही पावक । 'काह न पावक जारि सक ।' मा० २.४७
पावड़े : पांवड़े । जा०म०ई० १६
पावत : वकृ०० (सं० प्राप्नुवत>प्रा० पावंत)। पाता-ते। 'भवननि पर सोभा अति पावत ।' मा० ७.२८.५
पावति : वकृस्त्री० । पाती। 'पावति नाव न बोहितु बेरा।' मा० २.२५७.३
पावती : वा स्त्री०ब० । पातीं। 'सोभा रानी पावतीं।' कवि० १.१३
पावन : वि० (सं०)। (१) पवित्र । 'जन मन अमित नाम किय पावन ।' मा० १.२४.७ (२) पवित्र करने वाला । 'मैं नारि अपावन प्रभु जग पावन ।' मा० १.२११ छं० २ (३) भकृ० अव्यय (सं० प्राप्तुम् >प्रा० पाविउं>अ० पावण)। पाना, पाने को। जिमि पिपीलिका सागर थाहा ।........ पावन चाहा।' मा० ३.१.६
पावनकारी : वि०पू० (सं०) । पवित्र करने वाला । मा० ५.४२.६ ।
पावनताई : सं०स्त्री० (सं० पावनता)। पवित्रता । मा० ७.६६.१
पावनि : पावनी । (१) पवित्र, स्वच्छ । हिमगिरि गुहा एक अति पावनि ।' मा० १.१२५.१ (२) पवित्र करने वाली । 'बंदउँ अवधपुरी अति पावनि ।' मा० 
पावनिहार : वि.पुं० । पाने वाला । मा० १.२५१
पावनी : वि०स्त्री० (सं०) । (१) पवित्र । 'जासु कीरति पावनी ।' मा० ३.३२ छं० ४ (२) पवित्र करने वाली । 'भव अंग भूति मसान की सुमिरत सुहावनि • पावनी।' मा० १.१० छं०
पावनो : पावन+कए. । (१) पवित्र (२) पवित्रकारी। ‘सनेहु......अविचल पावनो।' पा०म०ई० ८ ।
पावस : सं००+ स्त्री० (सं० प्रावृष्>प्रा० पाउस) । वर्षा ऋतु । 
606 
_______________________________________________

पावहि, हीं : आ.प्रब (सं० प्राप्नुवंति>प्रा० पावंति>अ. पावहिं)। पाते हैं। 
__ 'निगम नेति सिव पार न पावहिं ।' मा० ७.६१.४
पावहिंगे : आ०भ०पु०प्रब० । पाएंगे । 'राज बिभीषन कब पावहिंगे।' गी० ५.१०.५
पावहि : आ०मए० (सं० प्राप्नोषि>प्रा. पावसि>अ० पावहि) । तू पाता है, प्राप्त कर । 'तू पुनीत जस पावहि ।' विन० २३७.५
पावहिगो : आ०भ००मए । तू पाएगा। ‘याको फल पावहिगो आगें ।' मा० ६.३३.७
पावहु : आ०मब० (सं० प्राप्नुथ-त>प्रा० पावह>अ० पावहु) । प्राप्त करो, पा सको । 'दिच्छा देहुं ग्यान जेहिं पावहु ।' मा० ६.५७.८
पावहगे : आ०भ००मब० । पावोगे। 'पावगे फल आपन कीन्हा ।' मा० १.१३७.५
पावा : (१) पावइ । पाता है (मिलता है) । 'सुनत नीक आगें दुख पावा।' मा० ६.६.४ (२) भूकृ०० (सं० प्राप्त>प्रा० पाविअ) । पाया, प्राप्त किया। 'सोउ तेहि समाँ पराभउ पावा ।' मा० १.२६२.८ (३) पाया=पाना । 'चह पार जो पावा।' मा० ७.५३.३
पावै : पावइ । पाता है, पाये । 'मनि उदबेगु न पावै कोई ।' मा० २.१२६.२
पावौं : पावउँ । पाऊँ । 'पावौं मैं तिन्ह के गति घोरा ।' मा० २.१६८.४
पावौंगी : आ०भ०स्त्री० उए । पाऊँगी । गी० २.६.१
पाश : सं०० (सं०) । बन्धन, जाल, बागुरा, फन्दा । विन० ६०.८
'पाषंड : (१) सं०० (सं०) । नास्तिक-पाखंड (२) वि० (सं.)। दम्भी, अपवित्र (३) सं० । नास्तिकता। कपट दंभ पाषंड ।' मा० १.३२ क (४) वीरता, निष्ठा, सदाचार आदि का मिथ्या प्रदर्शन, ढोंग । 'पुनि उठत करि पाषंड ।' मा० ३२०.११ (५) माया, छलना । 'तेहिं कीन्ह प्रगट पाषंड।' मा० ६.६५
पाषंडी : वि.० (सं० पाषण्डिन, पाषण्डिक)। दम्भी; मिथ्या प्रदर्शनकारी। पाषंडी हरि पद बिमुख ।' मा० १.११४
पाषाण : सं०० (सं०) । पत्थर । विन० २६.५ 
पाषान, ना : पाषाण । (१) पत्थर । 'सिंधु तरे पाषान ।' मा० ६.३ (२) पत्थर के समान कठोर । 'तिन्ह के हिय पाषान ।' मा० ७.४२ (३) ओला। गरजि तरजि पाषान बरषि...।' विन० ६५.३
पास : (१) संपु+क्रि०वि० (सं० पार्श्व>प्रा० पास) । समीप । 'गए हिमाचल पास ।' मा० १.६० (२) दिशा, ओर, तट । 'सोहत पुर चहुं पास ।' मा० १.२१२ (३) सं०० (सं० पाश>प्रा० पास) । जाल, बन्धन । काल _______________________________________________
607 
पास' मा० ३.३०.१२ 'ब्याल-पास ।' मा० ६.७३.११ (४) क्रीडाविशेष को 
गोरी।
पासंग : सं०० (सं० प्रासंग-बैल आदि के गले में डाली जाने वाली लकड़ी आदि >प्रा० प्रासंग)। तुला का सन्तुलन बनाने हेतु रखा या बांधा जाने वाला पदार्थ (प्रसंगा, प्रसंघा) । 'मेरे प्रासंगहु न पूजिहैं।' विन० २४१.४
पासा : पास । (१) समीप । 'हरषि चले कुंभज रिषि पासा ।' मा० ३.१२.१ (२) ओर, दिशा। 'अति उतंग जलनिधि चहुं पासा ।' मा० ५.३.११ (३) बन्धन । 'सुनत श्रवन छूटहिं भव-पासा ।' मा० ७.१२६.१ (४) क्रीडा विशेष की गोट ।
'पासू : पास+कए । सामीप्य+बन्धन । 'लुबुध मधुप इव तजइ न पासू ।' मा० १.१७.४
पार्स : सं००ब० (सं० पाशक>प्रा० पासय) । धूतक्रीडाविशेष की काष्ठ निर्मित गोटी । 'सुढर पासे ढरनि ।' गी० १.२८.४
पाहन : पाषाण (प्रा० पाहाण) । (१) पत्थर (२) कठोर । 'कपट छुरी उर पाहन टेई ।' मा० २.२२.१ (३) ओला । 'जाचत जल पबि पाहन डारउ ।' मा० २.२०५.२
पाहनी : पत्थर भी । पाहनी पसीज ।' क० ४५
पाहरू : सं०० (सं० प्राहरिक>प्रा० पाहरिअ) । यामिक, पहरेदार । मा० ५.३०
पाहरूई : पहरेदार ही । 'पाहरूई चोर हेरि हिय हहरान है।' कवि० ७.८० ।। 
पाहि, ही : पहिं (सं०
पादयो:>प्रा० पाहि) । चरणों में, पास । 'ब्याकुल गयउ देव रिषि पाहीं।' मा० ७.५६.३
पाहि : आ०-प्रार्थना-मए० (सं.)। तू रक्षा कर । 'अब प्रभु पाहि सरन तकि आयउँ ।' मा० ३.२.१३
पाही : (१) पाहि। 'अस कहि परेउ चरन प्रभु पाही।' मा० ७.१८.८ (२) सं०स्त्री० । गांव से दूर खेती जहाँ प्रायः बसना पड़ता है । 'पाही खेती बट लगन ।' दो० ४७८
पाहुन : वि.पु० (सं० प्राघुण>प्रा० पाहुण)। अतिथि, अभ्यागत । मा० २.२१३.७
पाहुनि : पाहुन+स्त्री० । 'पाहुनि पावन प्रेम प्रान की।' मा० २.२८६.४
पाहुने : पाहुन+ब० । 'प्रिय पाहुने भूप सुत चारी।' मा० १.३३५.३
पाहू : (पा+ह) पैर (पर) भी । 'दीनता कही..... परि पाहू ।' विन० २७५.१
पिंग : वि० (सं०) । रक्त-पीत, ललौंछ पीला, भूरा । 'पिंग नयन ।' हनु० २
पिंगल : पिंग (सं.) । 'पिंगल जटा।' विन० ११.२ 
608 
तुलसी शब्द-कोशा 
पिंगला : एक गणिका का नाम जिसे भगवान ने सद्गति दी थी।
पिंगले : पिंगला ने । 'पिंगलै कोन मति भगति भेई ।' विन० १०६.३
पिंजरन्हि : पिंजरा+संब० । पिजड़ों में । 'कनक पिंजरन्हि राखि पढ़ाए।' मा ७ 
पिंजरा : पिंजड़े में । तेहिं निसि आश्रम पिंजरा राखे ।' मा० २.२१५
पिंजरा : सं०० (सं० पञ्जर) । पक्षियों का डेल=पिंजड़ा ।
पिंजरी : सं०स्त्री० । छोटा पिंजड़ा । 'हा धुनि खगी लाज पिंजरी महँ।' गील ५.२०.२
पिड : सं०पु० (सं.)। पितृश्राद्ध में दिया जाने वाला पिण्डविशेष (पिण्डदान)। 'गोध कहें पिंड देइ निज धाम दियो।' विन० १३८.३ 
पिअ, पिअइ : (सं० पिबति>प्रा. पिअइ) आ.प्रए । पीता है। 'स्वातिहुं पिभइ न पानि ।' दो० २७९
पिअत : वपुः । पीता, पीते। पीते ही । 'सुचि जलु पिअत मुदित मन भयऊ ।' 
____ मा० २.८७.७
पिअर : वि.पु. (सं० पीत=पीतल>प्रा० पीअल) । पीला, पीतवर्ण । 'पिअर उपरना ।' मा० १.३२७.७
पिअहिं : आ०प्रव० (सं० पिबन्ति>प्रा० पिअंति>अ० पिअहिं) । पीते हैं। 
___ 'जहँ जल पिअहिं बाजि गज ठाटा ।' मा० ७.२६.१
पिआइप्र : आ०कवा०प्रए । पिलाइए, पिलाया जाय । 'ताहि पिआइअ बारुनी ।' मा० २.१८० पिआउ आ० -आज्ञा-मए । तु पिला, पान करा । 'मोको मरन अमी पिआउ ।' गी० २.५७.४
पिनाएँ : पिलाने से, पर । 'भयउँ जथा अहि दूध पिआएँ ।' मा० ७.१०६.६
पिनाए : भूकृ.पुब० । पिलाए । 'बचन पियूष पिआए।' गी० ६.२२.३
पिप्रारा : वि.पु. (सं० प्रियतर>प्रा० पिआर) । अतिशय प्रिय । 'रामहि केवल पेम पिआरा ।' मा० २.१३७.१ 
पिनारि, री : वि०स्त्री० (सं० प्रियतरा>प्रा० पिआरी) । अत्यन्त प्रिया । मा० ७.१३० ख 'होइहि संतत पिअहि पिआरी ।' मा० १.६७.३
पिआरे : पिआरा+ब० । 'ते तुम्ह राम अकाम पिआरे ।' मा० ३.६.६
पिनारो : पिआरा+कए। एकमात्र प्रियतर । 'प्रान तें पिआरो बागु ।' कवि० ५.२
पिआवहिं : आ.प्रब० । पिलाते हैं, पान कराते हैं । 'नर-कपाल जल भरि-भरि पिअहिं पिआवहिं ।' पा०म० ६६ _______________________________________________
609 
पिावा : भूकृ००। पिलाया। 'सुर भी सनमुख सिसुहि पिआवा।' मा० १.३०३.५
पिपास : सं०स्त्री० (सं० पिपासा>प्रा० पिआसा>अ. पिआस) । प्यास, तृष्णा । मा० १.४३.२
पिआसा : भूकृ०० (सं० पिपासित>प्रा. पिआसिअ)। तृषित । दे० पियासा ।
पिआसी : पिआसा+स्त्री० । 'लखीं सीय सब प्रेम पिआसी।' मा० २.११८.३
पिआसे : (१) भूकृ००ब० । तृषित । 'पेम पिआसे नैन ।' मा० २.२६० (२) प्यासों ने । 'मनहुं सरोवर तकेउ पिआसे।' मा० १.३०७.८
पिऊषा : पियूषा । अमृत । 'मरनसीलु जिमि पाव पिऊषा ।' मा० १.३३५.५
पिएँ : क्रि०वि० । पिए हुए, पीकर । 'अनंदित लोचन भूग पिएँ।' कवि० १.२
पिऐ : पिअइ । 'पिऐ पपीहा स्वाति जल ।' दो० ३०७
पिक : सं०० (सं०) । कोकिल पक्षी । मा० १.३.१
पिक-बचनि : वि०स्त्री० । कोकिल के समान बोलने वाली। मा० २.२५
पिकबयनी : पिकबनि (दे० बयन)। मा० २.११७.४ 
पिकनि, नी : पिकबयनी । जा०म० १३०
पिकादि : कोकिल आदि मधुर ध्वनिकारी पक्षी। मा०७.२६ ई०
पिघले : भूकृ०पू०ब० । द्रव रूप लेकर बह चले । 'पिघले हैं आँच माठ मानो घिय के ।' गी० ४.१.२
पिधिलि : प्रकृ० । पिघल कर, द्रव रूप लेकर । 'हाट बाट हाटक पिधिलि चलो घी से धनो।' कवि. ५.२४
पिचकनि : पिचक'+संब० । पिचकारियों (में), पिचक्कों (में) । 'भरत परसपर पिचकनि मनहुं मुदित नर नारि ।' गी० २.४७.१४ 
पिचकारि, री : सं०स्त्री० । रङ्ग आदि फेंकने की नलिका । 'झोलिन्ह अबीर पिचकारि हाथ ।' गी० ७.२२.२
पिछोरी : सं०स्त्रो० । कन्धे पर डाली जाने वाली चादर । प्रथित चूनरी पीत पिछोरी ।' गी० १.१०५.३
पितर : सं०० (सं० पित)। (१) दिवंगत पूर्वज (२) देवजाति विशेष = अग्निष्वात्त आदि जो पितलोक में रहते हैं । 'देव पितर सब तुम्हहि गोसाई। 'राखहुं नयन पलक की नाई।' मा० २.५७.१
पितरन : पितर+संब०। पितरों । 'भेंट पितरन को न मड़ह में बारु है।' कवि. ७.६७
पितहि : पिता को, पिता के प्रति । 'मातु-पितहि पुनि यह मत भावा ।' मा० १.७३.२ 
610 
_______________________________________________
पितहु : पिता (के) भी। 'पितह मरन कर मोहि न सोचू ।' मा० २.२११.५
पितां : पिता ने । पिता दीन्ह मोहि कानन राज ।' मा० २.५३.६
पिता : सं०पू० (सं० पित--पिता) । मा० १.६१
पिताहूं : पिता भी, पिता को भी । भली भांति पछिताब पिताहूं।' मा० १.६४.२
पितु : पिता । मा० १.८.६
पितुगह : पिता का घर (नहर) । मा० २.८२.५
पितुबस : पिता के अधीन । मा० १.२३४.८
पित : पिता ही । 'प्रभु गुरु मातु पित हो।' विन० २७.३
पितो : पिता भी । 'भूरि-भाग सिय-मातु-पितो री।' गी० १.७७.३
पित्त : सं०० (सं.)। आयुर्वेद में शरीर-संरचना का तत्त्वविशेष =वात-पित्त-कफ 
__ में अन्यतम । मा० ७.१२१.३०
पिधान : संपुं० (सं.)। पट, ढक्कन, पिहानी । 'सुख के निधान पाये हिय के पिधान लाये।' गी० १.६४.२ (यहाँ डब्बे का अर्थ है)।
पिनाक : सं.पुं० (सं.)। त्रिपुर-बधकारी शिवधनुष । मा० १.२५३.६
पिनाकिहि : पिनाकी को । 'नाहिं पिनाकिहि ने निहोरो।' कवि० ७.१५३
पिनाकी : वि.+सं०० (सं० पिनाकिन्) । पिनकधारी शिव । कवि० ६.४४
पिनाकु : पिनाक+कए । 'हठि न पिनाकु काहूं चपरि चढ़ायो है ।' कवि० १.१०
पिपासा : पिआस (सं.)। मा० १.२०६.८
पिपीलिकउ : पिपीलिका भी। 'चढ़ि पिपीलिकउ.. पारहि जाहिं ।' मा० १.१३
पिपीलिकति : पिपीलिका+संब०। पिपीलिकाओं (के) । 'देखो काल कौतुक पिपीलिकनि पंख लागे ।' गी० ५.२४.३
पिपीलिका : सं०स्त्री० (सं०) । चींटी। मा० ३.१.६
पिबत : पिअत (सं० पिबत्) । विन० ४४.७ ।।
पिबन्ति : आ०प्रब० (सं.)। पीते हैं। मा० ४ श्लोक २
पिय : सं०० (सं० प्रिय) । पति । मा० २.४६
पियत : पिअत । विन० १३२.३
पियरे : पिअर=पियर+ब० । पीले । 'कसे पट पियरे ।' गी० १.४३.१
पियहि : प्रिय पति को । होइहि संतत पियहि पिआरी ।' मा० १.६७.३
पियाहअ : पिआइअ । दो २७१
पियाउ : पिआउ । तू पिला । 'जाचौं जल जाहि, कहै अमिय पियाउ सो।' वि० १८२.३
पियारे : पिआरे । कवि० ७.१६६
पियास : पिआस । विन० १९६.३ _______________________________________________
611 
पियासा : पिआसा । तृषाकुल । 'स्वाति.. सीकरपि यासा ।' विन० ६५.२
पियासी : पिआसो । गी० १.८.५
पियूष : सं.पु. (सं० पीयूष) । अमृत । मा० २.३२६ छं०
पियषा : पियूष । मा० ७.२.६
पिये : पिएँ । 'पुलकति प्रेम पियुष पिये ।' गी० १.७.२
पियो : भूकृ.पु.कए. । पान किया । कालकूट पियो है ।' कवि० ७.१७२
पियौं : आ० उए० पीऊँ, पान करूँ । पीता हूं। 'मुनिहि बूझि जल पियौं जाइ श्रम ।' मा० ६.५७.२
पिराति : वकृस्त्री० । पीडा देती है । 'ढील तेरी बीर मोहि पीर तें पिराति है।' हनु० ३०
पिरातो : क्रियाति०पू०ए० । (तो) पीडा अनुभव करता (सहानुभूति करता)। 'सेइ साधु सुनि समुझि के पर पीर पिरातो।' विन० १५१.६
पिराने : भकृ००ब० । पीडायुक्त हुए। 'बैठिअ होइहिं पाय पिराने ।' मा० १.२७८.२
पिरीते : वि०० ब० (सं० प्रीत)। मित्र, प्रियजन । 'समउ फिरें रिपु होहिं पिरीते ।' मा० २.१७.६
पिरोजा : सं०० (फा० पीरोजः=फीरोजः) । हरितमणि, रत्नविशेष । मा० .१.२८८.४
पिशाच : सं०० (सं.)। मांसभक्षी देव जाति विशेष जो असुरवर्ग में परिगणित है । विन० १६.२ 
पिसाच, चा : पिशाच (प्रा० पिचास) । मा० १.८५.६; ६.६८.४
पिसाचिनि : पिसाची । मा० ५.१०
पिसाची : पिसाच+स्त्री० (सं० पिशाची) । मा० ६.५२.२
पिसुन : सं+वि०पु० (सं० पिशुन) । सूचक; दूसरे के दोषों का प्रचार करने वाला; चुगल । मा० २.१६८.१
पिसुनता : संस्त्री० (सं० पिशनता)। सूचक कर्म; चुगली। मा० ७.११२.१०
पिहानी : सं० स्त्री० (सं० पिधानी>प्रा. पिहाणी) । ढक्कन, आवरण । दो० ३२७
पीजरनि : पिंजरन्हि । गी० २.६६.४
पी : (१) पिय । 'सेवक स्वामि सखा सिय पी के ।' मा० १.१५.४ (२) पू० । पीकर, पान कर । 'पानी पी के कहैं ।' कवि० ५.१८
पीअत : पिअत । कवि० २.१०
पीछे : पाछे। पीछे की ओर । 'प्रेम सों पीछे तिरीछे प्रियाहि चित।' कवि० २.२६
पीछे : पाछे । मा० २.१४३.६ 
612 
_______________________________________________
पीटत वकृ०० (सं० पेटत् - पिट संघाते>प्रा० पिटुंत) । पीटते, आहत करते, चोट. 
देते । 'अनल दाहि पीटत घनहिं ।' मा० ७.३७
पोटहिं : आ०प्रब० (सं० पेटन्ति>प्रा० पिट्टति>अ० पिट्टहिं) । आहत करते-ती हैं। 'नारि बौंद कर पीटहिं छाती ।' मा० ६.४४.४ ।
पीठ : सं०० (सं.)। (१) पीढ़ा, चोकी । 'पलंग पीठ तजि गोद हिंडोरा।' मा० २.५६.५ (२) पृष्ठ भाग । 'कमठ पीठ जामहिं बरु बारा ।' मा० ७.१२२.१५. (३) तीर्थ । दे० पीठु (४) ऊपरी भाग । 'चरन पीठ उन्नत ।' गी० ७.१७.४
पीठा : पीठ । मा० २.६८.१ 
पोठि, ठी: (१) पीठी। मा० २.५६.५ (२) संस्त्री० (सं०
पृष्टि:-प्रकाश . किरण>प्रा० पिट्टि)। चमक, कलई । 'तांबे सों पीठि मनहं तन पायो।' विन० २००.१
पीठी : सं०स्त्री० (सं० पृष्ठ>प्रा० पिट्टी) । पीठ, पृष्ठ भाग । 'जिन्ह के लहहिं न रिपु रन पीठी ।' मा० १.२३१.७
पीठ : पीठ+कए । तीर्थ, पुण्यस्थल । 'जोग जप जाग को बिराग को पुनीत पीठु ।' कवि० ७.१४०
पीड़हिं : आ.प्रब० (सं० पीडयन्ति>प्रा० पीडंति>अ० पीडहिं) । पीड़ा देते हैं । ___'बहु ब्याधि-पीड़हिं संतत जीव कहुं ।' मा० ७.१२१ क
पोड़ा : सं०स्त्री० (सं.) । (१) व्यथा । (२) व्यथा देने की क्रिया । 'पर पीड़ा __सम नहिं अधमाई ।' मा० ७.४१.१
पीड़ित : भूकृ.वि. (सं०) । व्यथिल, पीडाकुल । मा० ७.१०२.३
पोढन्ह : सं०पु+संब० (सं० पीठानम् >प्रा० पीढाण>अ० पीढहं) पीढ़ों (पर)। ___'पोढन्ह बैठारे ।' मा० १.३२८.३
पीत : वि० (सं०) । पीला । मा० १.१९६.११ पीतपट' मा० १.१४७ 'पीत वस्त्र ।' मा० ७ श्लोक १
पौतम : प्रीतम । गी० ५.७.२
पोन : वि० (सं.)। (१) स्थूल । 'मीन पीन पाठीन पुराने ।' मा० २.१९३.३ (२) प्रचुर, पुष्कल । 'प्रेम पीन पन छीज ।' क० ४५
पोनता : सं०स्त्री० (सं०) । स्थूलता, मोटापा । 'पाप ही की पीनता।' कवि० ७.६२
पीना : (१) पीन। 'नित नव राम प्रेम पनु पीना।' मा० २.३२५.२ (२) सं०० (सं० पिण्याक>प्रा० पिण्णाअ) । तिलचूर्ण अथवा तिल की खली से बना खाद्य पदार्थ (गजक) । 'बाहु पोन पाँवरनि पीना खाइ पोषे हैं ।' गी०.. १.६५.३ _______________________________________________
613 
-
पीपर : सं०० (सं० पिप्पल)। अश्वत्थ वृक्ष । मा० २.४५.३ 
पीबो : भकृ००कए० । पीना, पान करना । 'अजहं न तजत पयोधर पीबो।' कृ०६
पीय : पिय । पति । ‘सौंह सांची सिय-पीय की ।' विन० २६३.२ -
पीयूषा : पियूषा । अमृत । मा० ६.२६.६ 
'पीर : पीर । (१) व्यथा। ‘ऐसिउ पीर बिहँसि तेहिं गोई ।' मा० २.२७.५ (२) दया, सहानुभूति । 'काहू तो न पीर रघुबीर दीन जन की ।' विन० ७५.२
'पीरमई : वि० (सं० पीडामय>प्रा. पीडम इअ)। पीडा से ओतप्रोत । 'सकल सरीर पीरमई है ।' हनु० ३८ ।
पीरा : (१) सं० स्त्री० (सं० पीडा) । व्यथा। 'तदपि मनाग मनहिं नहिं पीरा।' मा० १.१४५.४ (२) सहानुभूति-दे० पीर । (३) उत्पीडन । 'जे नर पर पीरा-करहिं ते सहहिं महा भव भीरा ।' मा० ७.४१.३
पोरे : पीले । 'पीरे पट ओढ़े।' गी० १.४२.२
'पील : सं०० (सं0+फा०) । हाथी । कवि० ७.१८
'पोले : वि०पू०ब० (सं० पीतल>प्रा० पीअल =पीअलय) ।.पीत वर्ण । 'नीले पीले कमल ।' गी० २.३०.१
पीवत : पिअत । 'मज्जत पय पावन पीवत जल ।' विन० २४.५
पीवनि : सं०स्त्री० । पीने की क्रिया। 'सुधा तजि पीवनि जहर की।' कवि० ७.१७०
'पीवर : वि०० (सं.)। स्थूल । 'तनु बिसाल पीवर अधिकाई ।' मा० १.१५६.७ 
पी : पिअहिं । पीते-ती हैं। 'चकोरी..'चंद की किरिन पीवै ।' कवि० १.१३
पीसत : वकृ०पु० । पीसते (किटकिटाते) । 'पीसत दांत गये रिस रेते ।' विन० २४१.२
'पीसि : पूकृ० । पीसकर (किटकिटा कर) । ता पर दाँत पीसि कर मीजत।' विन० १३६.७
पुंगीफल : सं०० (सं० पूगी फल) । सुपाड़ी । कवि० ५.७
पुज : सं०० (सं.)। राशि, समवाय, समूह, ढेर । मा० १.०.५
पुजा : पुंज । मा० २.२८.५ 
डरीक : सं०० (सं.)। कमल । गी० ७.३.६
'पुकार : सं० (सं० पूत्कार>प्रा. पुकार) । चिल्लाहट । 'जहँ तहँ करहिं पुकार ।' मा० ६.४६ 'पुकार
पुफारइ : पुकार+प्रए । पुकारता है । 'हाहाकार पुकार सब ।' रा०प्र० ५.५.२ 
614 
_______________________________________________
पकारत : वकृ०पू० । चिल्लाता, चिल्लाते । 'गए पुकारत कछु अधमारे।' मा० ५.१८.६
पुकारहीं : आ० प्रब० । चिल्लाते हैं। 'तेऽतिदीन पुकारहीं।' मा० ६.८५ छं०
पुकारा : (१) पुकार । चीत्कार । 'परि मुह भर महि करत पुकारा।' मा०. २.१६३.४ (२) भूकृ०० । चिल्लाया । 'अर्धरात्रि पुर द्वार पुकारा।' मा०. 
पुकारि : पुकृ० । पुकार कर, चिल्लाकर, हाक देकर । 'कहउँ पुकारि खोरि मोहि नाहीं।' मा० १.२७४.३
पकारिअत : वकृ०-कवा०-०। पुकारे जाते, कहे जाते । 'देवी देव पुकारिअत नीच नारि नर नाम ।' दो० ३६०
पुकारी : पुकारि । 'यह सपना मैं कहउँ पुकारी।' मा० ५.११.७
पुकारे : भूक००ब० । (१) चिल्लाये । 'कछु पुनि जाइ पुकारे।' मा० ५.१८ (२) पुकारने से । 'मढ़े स्रवन नहिं सुनति पुकारे ।' गी० ५.१८.२
पुकारेसि : आ०-पुकारे+प्रए० । वह चिल्लाया। 'परेउ भूमि जय राम पुकारेसि।' मा० ६.६१.७
पुकारो : पुकारयो । 'किधौं बेदन मृषा पुकारो । विन० ६४.२
पुकार्यो : भूक००कए० । घोषित किया । 'प्रभु सों प्रगटि पुकार्यो।' विन० १४५.५
पछिहहिं : पूछिहहिं । 'पुछिहहिं दीन दुखित सब माता।' मा० २.१४६.१
पुजाइ : पू० (सं० पूजयित्वा>प्रा० पुज्जाविअ>अ० पुज्जावि)। पूजा करवा कर । 'एहि भांति देव पुजाइ सीतहि सुभग सिंघासन दियो।' मा० १.३२३ छं० २
पुजाहबे : भकृ०० (सं० पूजयितव्य>प्रा० पुज्जाविअव्व) । पुजाने, पूजा कराने; दूसरों को देवादि पूजन हेतु प्रेरित करने या अपनी ही पूजा कराने । 'बहुत प्रीति पुजाइबे पर पूजिबे पर थोरि ।' विन० १५८.२
पुजावन : भकृ० अव्यय । पूजा कराने । 'संभ सभोत पुजावन रावन सों नित आवें।' कवि० ७.२ 
पुजाहि, ही : आ०प्रब० (सं० पूजयन्ति>प्रा. पुज्जावंति>अ० पुज्जावहिं)। पूजा करवाते हैं । ‘गनपति मुदित विप्र पुजावहीं ।' मा० १.३२२ छ० १
पुट : सं०० (सं.)। (१) दोनी (आदि पात्र)। पिअत नयन पुट रूपु पियूषा ।' मा० २.१११.६ (२) दो जुड़े हुए पात्र या तत्सदृश आवरण । 'पुट सूखि गये मधुराधर वै।' कवि० २.११ (३) जुड़े हुए हाथों आदि की मुद्रा । 'कर पुट सिर राखे ।' गी० १.६.२०
पुटन्हि : पुट+संब० । पुटों (से) । श्रवन पुटन्हि मन पान करि ।' मा० ७.५२ ख तुलसो शब्द-कोश 
615 
पुटपाक : सं०० (सं०) । रसायन (रसौषध) बनाने की विधि में दो पात्रों का मुह एक साथ जोड़कर भीतर औषध बंद करके ऊपर मिट्टी से लेस कर आग में डालते हैं । इस विधि से बनाये पात्र को 'पुटपाक' कहते हैं; यह सम्पूर्ण पाक विधि भी 'पुटपाक' कही जाती है; और औषधि को भी 'पुटपाक' कहते हैं। कवि० ५.२५
पुटी : पुटी+ब० । पुड़ियाँ (पुड़ियों में) । 'भरि भरि परन पुटी रचि रूरी।' मा० २.२५०.२
पुण्य : वि० सं०० (सं०) । पवित्र । 'पुण्यं पापहरं ।' मा० ७.१३० श्लोक ४ 
पुतरि, री : सं०स्त्री० (सं० पुत्तली) । पुतली, आँखों की कनीनिका । मा० २.५९.२
पुतरिका : पुतरी (सं० पुत्तलिका) । गुड़िया, कठपुतली । विन० १२४.४
पृतोह : सं०स्त्री० (सं० पुत्रवधू>प्रा० पुत्तवहू)। पतोहू । मा० २.१५.७
पुत्र : सं०पू० (सं.)। पुत =नरक से त्राण करने वाला= आत्मज । मा० १.१७७
पुत्रकाम : वि० (सं०) । पुत्र की कामना वाला =पुत्रेष्टि (यज्ञ)। 'पुत्रकाम सुभ जग्य करावा ।' मा० १.१८६.५
पुत्रवधू : पुतोहू । मा० २.५६.१
पुत्रवती : वि.स्त्री० (सं.) । पुत्र वाली । मा० २.७५.१
पुत्रि : पुत्री+संबोधन । हे पुत्रि । 'सीते पुत्रि करसि जनि त्रासा ।' मा० ३.२६९
पुत्री : सं०स्त्री० (सं०) । आत्मजा। मा० २.८२.४
पुमि : अव्यय (सं० पुनर्>प्रा. पुणो>अ० पुणु) । फिर, दुबारा । मा० १.४.६
पुनी : (१) वि.पु. (सं० पुण्यिक>प्रा० पुण्णिअ)। पुण्यात्मा, धर्माचारी । 'सब निर्दभ धर्मरत पुनी ।' मा० ७.२१.७ (२) पुनि । फिर भी । 'राम को कहा। दासु दगाबाज पुनी सो।' कवि० ७.७२ 
पुनीत, ता : वि० [सं० ?)। (१) पवित्र, पापमुक्त । 'तिन्हहि मिलें तै होब पुनीता।' मा० ४.२८.८ (२) पवित्र करने वाला । दे० पतित पुनीत ।
पुनीतता : पवित्रता । विन० २६२.१
पुन्य : पुण्य । (१) धर्म, शुभकर्म (पाप का विलोम) । 'सुख दुख पाप पुन्य दिनराती।' मा० १.६.५ (२) शुभ का फल । 'पुन्य बड़ तिन्ह कर सही ।' मा० १.६५ छं० (३) उत्तम प्रारब्ध कर्म (सौभाग्य)। 'कहि न सकउँ निज पुन्य प्रभाऊ ।' मा० १.२१७.१ (४) वि० । पवित्र, पावन । “पुन्य पुरुष कहुं महि सुख छाई ।' मा० १.२६४.१
पुन्यकोस : पुण्य रूपी धन का भंडार । कवि० ७.१७२
पुन्यथल : पवित्र भू-भाग, पुण्य कर्मों का स्थल-तीर्थ । मा० २.३१०.३
पुन्यपुज : पुण्यसमूह, पूण्यराशि । मा० २.१०१.८ 
616 
_______________________________________________
पुन्यमय : वि० (सं० पुण्यमय) । (१) धर्म से परिपूर्ण । मा० २.११३.२ (२) पुण्य. रूप। विन० ४४.७ पुन्य
सिलोक : वि० (सं० पुण्यश्लोक - श्लोककीति>प्रा. पुण्णसिलोक्क)। पवित्र कीति वाला-वाले; पुण्यात्मा। 'पुन्यसिलोक नाथ तर तोरें।' मा० २.२६३.६
पुरं: पुर में । 'करत अकंटक राज पुर।' मा० २.२३५
पुर : सं०० (सं०)। (१) नगर । मा० २.४६ (२) लोक । 'होइहि तिहुं पुर राम बड़ाई।' मा० २.३६.४ (३) त्रिपुरासुर जिसे शिव ने मारा था उस असुर के तीन नगर-दे० त्रिपुर । 'मयन महनु पुर दहनु गहनु जानि ।' कवि० १.१०
पुरंगिनी : संस्त्री० (सं० पुराङ्गना) ! नागर स्त्री । गी० २.४३.३
पुरंदर : सं०पू०. (सं०) । असुर नगरों का विदारणकर्ता-इन्द्र । मा० १.३०२.१
पुरंदर : पुरंदर+कए । कवि० १.६
पुरइ : (सं० पुरे>प्रा० पुरे>अ० पुरइ)। नगर में । 'पुरइ चहत जनु आवन ।' जा०म० ८६
पुरइनि : सं०स्त्री० (सं० पुटकिनी>प्रा० पुडइणी) । कमलवृक्ष, कमलपत्र । मा० १.३७.४
पुरइहि : आ० भ०प्रए० (सं० पूरायिष्यति>प्रा० पूरविहिइ)। पूर्ण करेगा। 'सो पुरइहि जगदीसु परज पन राखिहि ।' जा०म० ६८
पुरई : भूकृ०स्त्री० । पूर्ण की । 'पुरई मंज मनोरथ मोरि ।' गी० ३.१७.७
पुरउब : भकृ०० (सं० पूरयितव्य>प्रा० पूरविअव्व)। पूर्ण करना (है, होगा, चाहिए)। 'पुर उब मैं अभिलाष तुम्हारा ।' मा० १.१५२.५
पुरउबि : पुरउब+स्त्री० । पूर्ण करनी (है, चाहिए)। 'मातु मनोरथ पुर उबि मोरी ।' मा० २.१०३.२ ।।
पुरजन : नागर जन, नगरवासी लोग । मा० १.३०८
पुरट : सं०पू० (सं०) । सुवर्ण । मा० १.२१३
पुरती : (१) नगर की स्त्रियाँ । (२) नगरी रूपी स्त्री (पुर+ती)। 'सवै सोच . संकट मिटे तब तें पुर-ती के ।' गी० १.६.२६
पुरदहनु : (दे० पुर) । त्रिपुर-दाह । कवि० १.१०
पुरपसु : नगरवासी पशु-कुत्ता आदि । मा० २.८३
पुरब : पुरउब । पूर्ण होगा। 'जौं बिधि पुरब मनोरथु काली।' मा० २.२३.३
पुरबासिन्ह : पुरबासी+संब० । नागर जनों (ने) । 'पुरबासिन्ह तब राय जोहारे। मा० १.३४८.५
पुरबासी : वि.पु. (सं० पुरवासिन्) । नगर निवासी । मा० १.१९३.२ _______________________________________________
617 
पुरलोगन्ह : पुरलोग+संब० । पुरवासियों (ने)। 'समाचार पुरलोगन्ह पाए।' मा० १.१७५.१ 'पुरव
पुरवइ : (सं० पूरयति>पूरवइ) आ०प्रए० । पूर्ण करता है-कर सकता है करे। 'तुलसिदास लालसा दरस की सोइ पुरवं जेहिं आनि देखाए।' गी० २.३५.४
पुरवहुं : आo-प्रार्थना--प्रब० । पूर्ण करें। 'पुरवहुं सकल मनोरथ मेरे ।' मा० १.१४.३
पुरवहु : आ०मब० । पूर्ण करो। 'पुरवहु मोर मनोरथ स्वामी।' मा० १.१४६.७
पुरवै : पुरवइ ।
पुरवैगो : आ०भ०पु०प्रए० । पूर्ण करेगा। 'निज बासरनि बरष पुरवैगो बिधि ।' गी० ६.१७.२
पुरनि : पुरुषा=पुरषा+संब० । पुरखों ने, पूर्वजों ने। 'पुरषनि सागर सजे खने अरु सोखे ।' गी० ५.१२.५ .
पुराइ : पू० (सं० पूरयित्वा>प्रा० पूराविअ>अ० पूरावि)। पुरा कर (रचाकर)। 'बीथीं सींची चतुरसम चौके चारु पुराइ ।' मा० १.२६६
पुराई : भूक०स्त्री०ब० । पूरी करायों (रचायीं)। 'चौके भांति अनेक पुराई।' मा० १.२८८.८
पुराकृत : (सं0-~-पुरा= अतीत+कृत) पूर्व जन्म का किया हुआ। 'पुन्य पुराकृत भूरि ।' मा० १.२२२
पुराण : वि०+सं.पु. (सं.)। (१) प्राचीन । (२) ग्रन्थविशेष जिन प्राचीन कथाओं आदि का--सर्ग, प्रतिसर्ग, वंश, वंशानुचरित और मन्वन्तरों के आख्यानों का-संकलन होता है । मा० १ श्लोक ७
पुरातन : वि० (सं०)। (१) प्राचीन । मा० १.१६३.४ (२) पुराना, जर्जर । 'अस्थि पुरातन, छुधित स्वान अति, ज्यों मुख भरि पकरै ।' विन० ६२.४
पुरान : पुराण । (१) पुराण ग्रन्थ । मा० १.७.११ (२) पुराना, प्राचीन । 'जिमि नूतन पट पहिरइ नर परिहरइ पुरान ।' मा० ७.१०६ ग (३) जीर्ण ; जर्जर । 'बाँस पुरान साज सब अठकठ ।' विन० १८६.२ (४) चिरन्तन, शाश्वत । 'पुरुष पुरान ।' गी० १.८८.४ ।।
पुराननि : पुरानन्ह । 'निगम पुराननि गाई ।' कृ० ५१
पुरानन्ह : पुरान+संब० । पुराणों (ने) । 'लव कुस बेद पुरानन्ह गाए ।' मा० ७.२५.६
पुराना : पुरान । (१) पुराण ग्रन्थ । 'कहहिं बेद इतिहास पुराना।' मा० १.६.४ (२) प्राचीन, सबसे पूर्व । शाश्वत । 'परमानंद परेस पुराना ।' मा० १.११६.८ (३) जीर्ण । 'भूमि सयन पटु मोट पुराना।' मा० २.२५.६ 
618 
_______________________________________________
पुरानि : पुरानी । पुराण सम्बन्धी, प्राचीन, जीर्ण, नीरस । 'जाइ अनत सुनाइ मधुकर ज्ञान गिरा पुरानि ।' कृ० ५२
पुरानी : पुरानी+ब० । 'कथा पुरानी।' मा० २.२७८.४
पुरानी : पुरान+स्त्री० । पुराण सम्बन्धिनी, प्राचीन । 'कहि अनेक बिधि कथा पुरानी।' मा० २.२६३.३
पुराने : 'पुराना' का रूपान्तर (ब)। बहुवयस्क, प्रौढ । 'मीन पीन पाठीन पुराने।' मा० २.१६३.३ 
पुरारि, री : त्रिपुरारि । शिव । मा० १.३२.८
पुरारी : पुगरि । मा० १.१०.२ 
परिन : पुरी+संब० । नगरियों (में) । दो० ५५८
पुरिहिं : नगरी में। दो० २४०
पुरी : पुरिहिं । रघुपति पुरी जन्म तब भयऊ ।' मा० ७.१०६.६
पुरी : सं०स्त्री० (सं०) । नगरी । मा० १.३५.३
पुरीष : सं०० (स.) । विष्ठा, उदरमल । विन० १३६.३
पुरु : पुर+कए । अद्वितीय नगर । 'सो पुरु बरनि कि जाइ।' मा० १.६४
पुरुष : सं.पु० (सं.) । (१) नर (नारी का विलोम) । 'तैसिअ नाथ पुरुष बिन नारी ।' मा० २.६५.७ (२) जीवात्मा । 'जिमि अबिबेकी पुरुष सरीरहि ।' मा० २.१४२.२ (३) परमात्मा, ब्रह्म । 'पुरुष प्रसिद्ध प्रकासनिधि ।' मा० १.११६ (४) पुरखा, पूर्वज पुरुष । 'सो सटु कोटिक पुरुष समेता। बसिहि कलपसत नरक निकेता ।' मा० २.१८४.७
पुरुषमय : वि० (सं०) । पुरुषों (नरों) से व्याप्त । 'अबला बिलोकहिं पुरुषमय जगु।' मा० १.८५ छं० 
पुरुषसिंघ, ह : पुरुषों में सिंह के समान श्रेष्ठ । 'पुरुषसिंघ बन खेलन आए ।' मा० ३.२२.३ 'पुरुषसिंह दोउ बीर ।' मा० १.२०८ ख
पुरुषा : पुरुष । पूर्वज पुरुष। 'पुरुषा ते सेवक भए ।' दो० १४३
पुरुषारथ : सं०० (सं० पुरुषार्थ)। (१) चार जीवन-प्रयोजन = धर्म, अर्थ, काम और मोक्ष । (२) पौरुष । 'पुरुषारथ पूरब करम परमेस्वर परधान ।' दो० ४६८ 
परुषारथु : पुरुषारथ+कए । एकमात्र पुरुषार्थ । (१) जीवन का साध्य । मोर ___ तुम्हार परम पुरुषारथु ।' मा० २.३१४.३ (२) पौरुष, पराक्रम । 'जन्म कर्म, प्रतापु पुरुषारथु महा ।' मा० १.१०३ छ ।
पुरुष : पुरुष+कए । ब्रह्म । 'निरवधि गुन निरुपम पुरुषु ।' मा० २.२८८
पुरोडास : सं०० (सं० पुरोडाश) । देवापित नैवेद्य, यज्ञ-पायस । 'पुरोडास चह रासभ खावा ।' मा० ३.२६.५ _______________________________________________
619 
पुरोधा : सं०० (सं० पुरोधस् --पुरोधाः) । पुरोहित । मा० २.२७८.२
पुलक : सं०० (सं०) । हर्षातिरेक का रोमाञ्च । 'पुलक प्रफुल्लित गात ।' मा० १.१४५ पुलक
पुलकइ : (सं० पुलकति) आ.प्रए० । हर्ष-विभोर होकर रोमाञ्चित होता है । 'तन"पुलकइ नहीं।' दो० ४१
पुलकत : वकृ.पु । हर्षवश रोमाञ्चित होता-ते। 'पुनि पुनि पुलकत कृपानिकेता।' 
___ मा० १.५०.४
पुलकति : वकृ०स्त्री० । हर्ष से रोमाञ्चित होती। 'पुलकति प्रेम पियूष पिए।' गी० १.७.२
पलकहिं : आ०प्रब । हर्ष से रोमाञ्चित होते हैं। तन पुलकहिं अति हरषु हियं ।' ___ मा० १.२२४
पुलकालि : पुलकावलि (सं०-पुलक+आलि-रोमाञ्च-पङि क्त) । दो० ५६८ 
पुलकावलि, ली : सं०स्त्री० (सं०) । हर्षकृत रोमाञ्च-श्रेणी। मा० ५.१४.१; १.२५७
पुलकाहीं : पुलकहिं । मा० १.४१.६
पुलकि : पूकृ० । हर्षवश रोमाञ्चित होकर। 'प्रेम पुलकि तन मुदित मन ।' मा० २.२
पुलकित : वि० (सं.)। पुलकयुक्त, हर्षवश रोमाञ्चित । मा० १.२०२.५
पुलकी : भूकृ०स्त्री० ब० । हर्ष से रोमाञ्चित हुईं। 'पुल की तन औ चले लोचन च्वं ।' कवि० २.१८
पुलके : भूकृ००० । हर्षवश रोमाञ्चित हुए । 'कहि पुल के प्रभु गात ।' मा० २.४५
पलकेउ : भूकृ००कए। हर्षवश रोमाञ्चित हुआ । 'तन पूल केउ।' मा० २.२०५
पुलके : पुलकहिं । 'हरष पुलकै नृप ।' कवि० १.२
पुलको : पुलक्यो । कवि० २.१२
पुलक्यो : पुलकेउ । 'सिय बिलोकि पुलक्यो तनु ।' गी० ५.१.४
पुलस्ति : सं०० (सं०)। रावण के पितामह ऋषिविशेष । मा० ५.२३.२
पुलस्त्य : पुलस्ति (सं.)। 'पुलस्त्यकुल ।' मा० १.१७६
पुष्ट : वि० (सं०) । (१) मांसल । “रिष्ट पुष्ट कोउ अति तन खीना ।' मा० १.६३.८ (२) दृढ । 'सुगढ़ पुष्ट उन्नत कृकाटिक ।' गी० ७.१७.१०
पुष्पक : सं०० (सं०) । कुबेर का विमान जो बहुत समय रावण के पास रहा । मा० १.१७६.८
पुष्पकारूढ : पुष्पक पर विराजमान (आरूढ) । मा० ७ श्लोक १ 
620 
तुलसी शब्दकोश 
पुस्तक : सं०० (सं.)। ग्रन्थ, पोथी । मा० १.३०३.८ 
पुहुमि, मी : सं०स्त्री० (सं० पृथ्वी>प्रा० पुहुवी, पुढ़मी)। पृथिवी। मा० २.३१५.८
पुहुमीपाल : पृथ्वीपाल =राजा । दो० ५१५
पूछ : (१) सं०स्त्री० (सं० पुच्छ) । “पूछहीन बानर तहँ जाइहि ।' मा० ५.२५.१ (२) पूछइ । पूछता-ती है । 'पूछ रानि निज सपथ देवाई।' मा० २.१६.१ 'पूछ
पूछइ : पूछइ। पूछता-ती है। 'सोक बिकल पुनि पूछ नरेसू।' मा० २.१४६.५
पूछउँ : पूछउँ। पूछता हूं, पूछू । 'जेहि पूछउँ सोइ मुनि अस कहई ।' मा० ७.११०.१५
पूछत : पूछत । 'पूछत राउ नयन भरि बारी ।' मा० २.१४६.२
पछति : पछति । 'सादर पुनि पुनि पूछति ओही। मा० २.१७.१ 
छन : पूछन । 'नाथ भरत कछु पूछन चहहीं ।' मा० ७.३६.६
पूछब : भकृ०० (सं० प्रष्टव्य>प्रा० पुच्छिअव्ब)। पूछना (होगा-पूछेगे) । 'मुनि पूछब कछु यह बड़ सोचू ।' मा० २.२०६.७
पूछहि : पूहिं । 'अति आरति सब पूछहिं रानी।' मा० २.१४८.१
पूछहु : पूछहु । 'तुम्ह पूछहु मैं कहत डेराऊँ ।' मा० २.१७.३
पूछा : पूछा। (१) पूछइ । (२) प्रश्न किया। 'कोउ किछु कहइ न कोउ किछु पूछा ।' मा० २.२४२.७
पूछि : पूछि । 'भरत कुसल पूछि न सकहिं ।' मा० २.१५८
पछि : पूछी+आ० उए । मैंने पूछी। 'देखि गोसाइँहि पछिउँ माता ।' मा० २.४५.८
पंछिये : पूछिअ । 'बहुरि पूछिये पांचों। विन० २७७.३
पूछिहहिं : आ० भ०प्रब० (सं० प्रक्ष्यन्ति>प्रा० पुच्छिहिति>अ० पुच्छिहिहिं) । पूछेगे-गी। 'धाइ पूछिहहिं मोहि जब ।' मा० २.१४५
पछिहि : पूछिहि । 'जोइ पूछिहि तेहि ऊतरु देवा ।' मा० २.१४६.५
पूछिह : पूछी+आ०मब० । तुमने पूछी। पछि रामकथा अति पावनि ।' मा० ७.१२३.५
पूछी : (१) पूछि । 'सचिउ सभीत सकइ नहिं पूछी।' मा० २.३८.८ (२) पूछो । पूछी कुसल मा० ५.२६
पूछे : पूछे । 'मैं सबु कीन्ह तोहि बिनु पूछे ।' मा० २.३२.२
पूछे : पूछे ! 'पूछे बचन कहत अनुरागे ।' मा० २.२३६.४
पूछेउ : आभूकृपु०+ उए० । मैंने पूछा। पूछेउँ गुनिन्ह रेख तिन्ह खाँची ।' मा० २.२१.७ -