_______________________________________________
671
बच्छपद : बछड़े का खुर तथा उसका चिन्ह । 'भव सागर तरिअ बच्छपद जैसे ।' विन० ११८.२
बच्छल : वि० (सं० वत्सल>प्रा० वच्छल) । पुत्र पर पिता के समान स्नेह करने वाला । 'सरनागत बच्छल भगवाना ।' मा० ५.४३ ६
बच्छु : बच्छ+कए० । अकेला बछड़ा । 'सुमिरि बच्छु जिमि धेनु लवाई ।' मा० २.१४६.३
बच्यो : भूकृ.पुं०कए । शेष रहा, बचा। 'तुलसी अगारु न पगारु न बजारु बच्यो।' कवि० ५.२३
बछल : बच्छल । मा० ७.११.५
बछलता : सं०स्त्री० (सं० वत्सलता)। वात्सल्य, पुत्रस्नेह । 'भगत-बछलता प्रभु के देखी।' मा० ७.८३.७
बज, बजइ : (सं० वाद्यते>प्रा० वज्जइ) आ०प्रए । बजता है। 'तह सिर पदवान बजै ।' विन० ८६.३
बजनिअ : सं० पु० (सं० वादनिक>प्रा० वज्जणिअ) । बाजा बजाने का व्यवसायी । मा० १.३५१.८
बजाइ : पू० (सं० वादयित्वा>प्रा. वज्जावि>अ० वज्जावि) । (१) बजाकर । 'बरहिं सुमन सुर दुदुभी बजाइ ।' मा० १.३४७ (२) धौंसा देकर, विजयवाद्य बजवा कर । 'मनहं करुन रस कटकई उतरी अवध बजाइ ।' मा० २.४६ (३) ताल ठोंककर, ललकार देकर । 'पठो बाटिका बजाइ बल रघुबीर के।' कवि० ५.२ (४) आन-बान के साथ, प्रतिष्ठापूर्वक । 'बजाइ रही पति पांडु बधू की।' कवि० ७.८९
बजाईं : बजाई+ब । 'तब देवन्ह दुदुभी बजाई।' मा० १.८६.६
बजाई : (१) बजाइ । 'देउँ भरत कहुं राज बजाई।' मा० २.३१.८ (२) भूकृ० स्त्री० (सं० वादिता) । 'देखि सुरन्ह दुदुभी बजाई ।' मा० ६.१०३.८
बजाउ : आ० -आज्ञा-मए । तू बजा । 'कहेउ, बजाउ जुझाऊ ढोलू ।' मा० २.१६२.३
बजाए : भूकृ००० । वादित किये । 'बरषि सुमन सुर निसान बजाए ।' गी० ६.२२.५
बजाज : सं०० (अरबी-बज्जाज) वस्त्र व्यवसायी । मा० ७.२८ छं०
बजाय : बजाइ । ललकार कर; घोषित कर । 'नत कहत बजाय तोहि ।' हनु० २६
बजाय उ : भूक ००कए० (सं० वादित:>प्रा. वज्जाविओ>अ. वज्जावियउ)। बजाया। 'देव' निसान बजायउ।' पा०म० १४०
बजायो : बजाय उ । 'बधावनो बजायो ।' कवि० ७.७३
672
_______________________________________________
बजार : सं००+ स्त्री० (अरबी-बाजार) । हाट, आपण ।
बजारी : वि०पू० । बाजारू, दलाल, व्यवसायी, सौदागर (जो भावताव में बकवास करता है) । मिथ्यावादी, वाचाल स्वार्थी। जन बात बड़ो सो बड़ोई बजारी।' कवि० ६.५
बजारु, बजारू : बजार+कए । कवि० ५.२३ 'कहहु बनावन बेगि बजारू ।' मा. २.६.७
बजावत : वकृ०० (सं० वादयत्>प्रा० वज्जावंत)। बजाता-बजाते । 'गाल बजावत तोहि न लाजा ।' मा० ६.३३.३ ।।
बजावति, बजावती : बजावत+स्त्री० । बजाती । 'चुकटी बजावती नचावती कौसल्या माता ।' गी० १.३३.४
बजावन : भक० अव्यय (सं० वादयितुम् >प्रा० वज्जाविउं>अ० वज्जावण) । बजाने। 'जहँ तह गाल बजावन लागे।' मा० १.२६६.२
बजावनी : सं००कए० (सं० वादनम्>प्रा० वज्जावणं>म० वज्जावणउ)। बजाना । 'अजहूँ न छाँड़ें बालु गाल को बजावनो ।' कवि० ५.१८
बजावहिं : आ०प्रब० (सं० वादयन्ति>प्रा. वज्जावंति>अ० वज्जावहिं) । बजाते हैं। 'मुखहि निसान बजावहिं भेरी ।' मा० ६.३६.१०
बजावहु : आ०मब० (सं० वादयत>प्रा० वज्जावह>अ० वज्जावह)। बजावो। 'बजावहु जुद्ध निसाना ।' मा० ६.८६.२
बजावा : आ०प्रए० (सं० वादयति>प्रा० वज्जावइ) । बजाता है-हो । 'पंडित सोह  जो गाल बजावा ।' मा० ७.६८.३
बजावैं : बजावहिं । 'बालिस बजावै गाल ।' गी० १.६५.२
बजेंगे : आ०भ०पू०प्रब० । 'बजगे ब्योम बाजने ।' कवि० ६.२
बजे : बजइ।
बजैहैं : आ०म०प्रब । बजाएंगे। 'ब्योम बिमान निसान बजैहैं ।' गी० ५.५१.४
बज्जत : बाजत (प्रा० वज्जत) । कवि० ६.४७
बद्ध : सं०पू० (सं० वन)। (१) इन्द्र का आयुध । 'मुष्टि प्रहार बन सम लागा।' मा० ४.८.३ (२) बिजली (जो गिर कर विनाशकारी हो) । 'तुम्ह जेहि लागि बज्र पुर पारा ।' मा० २.४६.८ (३) हीरा । 'पदुमकोस महँ बसे बज्र मनो।' गी० १.१०८.७ (४) वि० । कठोर (वज तुल्य)। 'बचन बन जेहि सदा पिआरा ।' मा० १.४.११ (५) इस्पात, दृढ लोहा। (६) वज्रवत् या लोहावत् दृढ । 'लागहिं सैल बज्र तन तासू ।' मा० ६.८२.३
बज्रतन : वज्रतुल्य शरीर वाला, वज्राङ्ग (बजरंगबली) हनुमान । हनु० २
बचन्हि : बज्र+संब० । वज्रों, हीरों (से)। प्रति द्वार द्वार कपाट पुरट बनाइ बहु बज्रन्हि खचे।' मा० ७.२७ छं०
_______________________________________________
673
बज्रपात : इन्द्र के आयुध या गाज का गिरना । मा० ६.८७.७
बज्राघात : (वज्र+आघात) । वज्र या बिजली का प्रहार, बिजली गिरने को कड़क । 'गर्जा बज्राघात समाना ।' मा० ६.६४.१
बच : बज्र+कए । 'उतरु देव "हृदय बज्र बैठारि ।' मा० २.१४५
बझाऊ : वि.पु । उलझाने वाला, फैसाव से युक्त, बाधक । 'काट कुराय लपेटन लोटन ठावहि ठाउँ बझाऊ रे।'विन० १८९.४
बझावौँ : आ० उए । बझाता हूं, फंसाता हूं। 'व्याध ज्यों बिषय बिहंगनि बझावौं।' विन० २०८.२
बट : (१) सं०० (सं० बट) । बरगद वृक्ष । मा० १.५८.७ (२) (सं० वाट = वर्त्म>प्रा० वट्ट)। मार्ग। 'पाही खेती, बट लगन ।' दो० ४७८
बटत : वक०पू० (सं० वटत-वटयत-वट वेष्टने>प्रा० वदंत) । भांजता, लपेट कर बनाता (रस्सी बटता) । 'बाँधिबे को भव गयंद रेनु की रजु बटत।' विन० १२६.३
बटपार, बटपारा : सं०पू० । मार्ग का लुटेरा, पथिकों को लूटने वाला। दो० ५४६ 'मैं एक अमित बटपारा ।' विन० १२५.६
बट-बूट : बरगद का वृक्ष । कवि० ७.१४०
बटाऊ : सं० । पान्थ, राहगीर, राह चलन्तू । मा० २.१२४.१
बटु : (१) बट+कए । बरगद । 'परसि अखय बटु हरहिं गाता ।' मा० १४४.५ (२) सं०० (सं० वटु)। ब्रह्मचारी बालक । 'बिद किए बटु।' मा० २.१०६
बटोर, बटोरइ : आ०प्रए । समेटता है, समेटे । 'जेहि के भवन विमल चितामनि सो कत कांच बटोरें ।' विन० ११६.४ वेदों में विटारिन्' शब्द दीर्घ एवं चौड़े के अर्थ में आता है। उसके 'बटर' भाग से हिन्दी की बटना' क्रिया निष्पन्न है जिसका अर्थ आस-पास से एकत्र होना है। उसी का सकर्मक रूप 'बटोरना' जान पड़ता है।
बटोरत : वकृ०० । समेटता-समेटते । 'बीजु बटोरत ऊसर को।' कवि० ७.१०३
बटोरा : (१) भकृ.पु । समेटा, सब ओर से इकट्ठा किया। 'राम भालु कपि सैन बटोरा।' मा० १.२५.३ (२) बटोरि । समेट कर सँभाल कर । 'चलाहिं न पाउँ बटोरा रे।' विन० १८६.३
बटोरि : पू० । इकट्ठा करके । 'आए दल बटोरि दोउ भाई।' मा० २.२२८.६
बटोरी : बटोरि । मा० ५.४८.५
बटोरै : बटोरइ।
674
_______________________________________________
बटोर् यो : भूकृ००कए० । समेटा, इकट्ठा किया। 'नृप कटक बटोर्यो।' गी० १.१०२.५
बटोहीं : बटोही ने । लिए चोरि चित राम बटोहीं।' मा० २.१२३.८
बटोही : बटाऊ (सं० वर्त्म-पथिक>प्रा० वट्ट-वहिअ) । गी० २.१८.१
बड़ : वि०पू० (सं० बृहत् >प्रा. बड्ड)। बड़ा, विशाल, महत् । 'भागु छोट अभिलाषु बड़ा।' मा० १.८
बड़प्पनु : सं०कए० (सं० बहत्त्वम् >प्रा० बड्डत्तणं>अ० बड्डप्पणु)। बड़ाई, महत्त्व । 'केहिं न सुसंग बड़प्पनु पावा।' मा० १.१०.८
बड़भाग : (१) सं.पुं० । उच्चभाग। (२) वि०पू० । उच्च भाग्यशाली । रा०न० १३
बड़,  बड़भागिनि : वि०स्त्री० । अति भाग्यशालिनी । मा० २.२१४.१
बड़भागीं : वि०स्त्री०ब० । बड़भागिनियां, भाग्यवतियाँ। 'चली गावत बड़भागीं।' . गी० १.६.१२
बड़भागी : (१) बड़भाग+स्त्री० । अति भाग्यवती । 'अतिसय बड़भागी चरनन्हि लागी।' मा० १.२११ छं० (२) वि.पु.। अति भाग्यवान् । 'सुनु जननी सोइ सुतु बड़भागी।' मा० २.४१.७
बड़री : वि०स्त्री० (सं० बृहत्तरा>प्रा० बड्डअरी) । अधिक बड़ी । 'बिकटी भृकुटी बड़री अखियाँ ।' कवि० २.१३
बड़वागि : बड़वानल (सं० वडवाग्नि>प्रा० वडवग्गि)। कवि० ७.६६
बड़वानल : सं०० (सं० वडवानल । समुद्र की आग । मा० ५.३३
बड़ाइ : बड़ाई । मा० १.३२६ छं० १ ।
बढ़ाईं : बड़ाई से । 'जो बड़ होत सो राम बड़ाईं ।' मा० २.१९६.८
बड़ाई : संस्त्री०=बड़प्पन । (१) महत्ता। 'कहाँ कहाँ लगि नाम बड़ाई।' मा० १.२६.८ (२) यश । 'ईसु काहि धौं देइ बड़ाई।' मा० १.२४०.१ (३) प्रशस्ति । 'करि पूजा मान्यता बड़ाई।' मा० १.३०६.४
बड़ि : बड़ी। एक लालसा बडि उर माहीं ।' मा० १.१४६.३
बड़िए : बड़ी ही। 'तेरी बड़िए बड़ाई है ।' गी० ५.२६.२
बड़ी : बड़+स्त्री० (प्रा० बड्डी) । महती । मा० १.१३१.१
बड़ें : (१) बड़े से । 'बड़ें भाग देखेउँ पद आई।' मा० १.१५६.६ (२) बड़े... में । 'नाम प्रताप बड़े कुसमाज बजाइ रही पति पांड बधू की।' कवि० ७.८६
बड़े : (१) बड़ें । बहुत सा । 'ब्याह हाहै बड़े खाए।' गी० १.६५.१ (बहुत-सा खाने पर =अधिक बली होने पर)। (२) 'बड़' का रूपान्तर । 'बड़े भाग उर आवइ जासू ।' मा० १.१.६ _______________________________________________
675
बड़ेरे : वि.पु. (सं० बृहत्तर>प्रा. बड्डयरय) । अधिक बड़े, महत्तर । 'अधिक एक तें एक बड़ेरे ।' मा० २.२५५.५
बड़ेरो : वि०पू०कए० (सं० बृहत्तर:>प्रा० बड्डयरो) । बहुत बड़ा । 'तह रिपु राहु बड़ेरो।' विन० ८७.२
बड़ो : बड़+कए । विशाल । 'लाभ राम सुमिरन बड़ो।' दो० २१
बड़ोइ, बड़ोई : बड़ा ही । 'सो बड़ोई बजारी।' कवि० ६.५
बढ़,  बढ़इ : आ०प्रए० (सं० वर्धते>प्रा० वड्ढइ) । बढ़ता है, विकास पाता है। 'घटइ बढ़इ बिरहिनि दुखदाई ।' मा० १.२३८.१
बढ़ई : सं०० (सं० वर्धकि>प्रा० वड्ढई) । तक्षा, तखा (काष्ठ-शिल्प-व्यवसायी जातिविशेष) । मा० २.२१२.३
बढ़उ : आ०-कामना, संभावना-प्रए० (सं० वर्धताम् >प्रा० वड्ढउ) । बढ़े, बढ़ता रहे । 'चरन रति अनुदिन बढ़उ ।' मा० २.२०५.२
बढ़त : (१) वकृ०पू० । बढ़ता-बढ़ते । विधु बढ़त ।' मा० २.७ (२) बढ़ते समय । 'बढ़त बौंड जनु लही सुसाखा ।' मा० २.५.७
बढ़ति : वक स्त्री० । बढ़ती । 'राम दूरि माया बढ़ति ।' दो० ६६
बढ़न : भक० अव्यय (सं० वधितुम् >प्रा० वढिउं>१० वड्ढण)। बढ़ने । ___ 'बालधी बढ़न लागी।' कवि० ५.३
बढ़हिं : आप्रब० (सं० वर्धन्ते>प्रा० वड्ढं ति>अ० वड्ढहिं)। बढ़ते हैं । (१) उगते हैं । 'काटत बढ़हिं सीस ।' मा० ६.१०२.१ (२) उफनते हैं, उन्नति करते हैं । 'जग बहु नर सरि सर सम भाई । जे निज बाढि बढ़हि जल पाई।' मा० १.८.१३
बढ़हुं : आo-शुभकामना-प्रब० । बढ़ें। 'बढ़हुं दिवस निसि बिधि सन कहहीं।' ____ मा० १.३०६.८ (२) अशुभ कामना । 'बैरिन बढ़हुं विषाद ।' गी० १.२.१०
बढाइ : पूक० (सं० वर्धयित्वा>प्रा० वड्ढाविअ>अ० वड्ढावि)। बढ़ाकर । ___ 'कपट सनेह बढ़ाइ बहोरी ।' मा० २.२७.८
बढ़ाइअ : आ०कवा०प्रए० । बढ़ाया जाय, बढ़ायी जाय । 'तो न बढ़ाइअ रारि ।' मा० ६.६
बढ़ाइहौं : आ०भ०उए । बढ़ाऊँगा। 'प्रभु सो निषादु ह्व के बादु ना बढ़ाइहौं ।' कवि० २.८
बढ़ाईं : भूक स्त्री०+ब० बड़ी कर रखीं, पाल रखीं। 'तुलसी बढ़ाई बादि साल तें बिसाल बाहैं ।' कवि० ५.१३
बढ़ाई : (१) बढ़ाइ । 'बहुत कहउँ का कथा बढ़ाई।' मा० ७.४६.४ (२) भूक. स्त्री० । विकसित की। 'सबन्हि परस्पर प्रीति बढ़ाई।' मा० ७.२३.२
676
_______________________________________________
बढ़ाउ : आ०-आज्ञा-मए० (सं० वर्धयस्व>प्रा० वड्ढाव>अ० वड्ढा)। तू विकसित कर, बढ़ा । 'उर अनुराग बढ़ाउ ।' विन० १००.१०
बढ़ाए : भूक००ब० । (१) परिवधित किये । 'बिधि बिषम बिषाद बढ़ाए।' गी० २.८८.३ (२) बढ़ाए हुए। 'प्रमुदित प्रजा प्रमोद बढ़ाए।' गी० ६.२२.६
बढ़ाय : बढ़ाउ (अ० वड्ढावि) । तू बढ़ा । 'सीय राम पद तुलसी प्रेम बढ़ाय।' बर० ४५
बढ़ायो : भूक००कए० । बढ़ाया, बड़ा किया। 'बल आपनो बढ़ायो है ।' कवि
बढ़ाव, बढ़ावइ : आ०प्रए० (सं० वर्धयति>प्रा० वड्ढावह:/बढ़+प्रेरणा) ।। बढ़ाता-ती है । 'एकहिं एक बढ़ावइ करषा ।' मा० २.१६१.२
बढ़ावत : वकृ०० (सं० वर्धयत्>प्रा० वड्ढावंत)। बढ़ाता-ते । 'हरष बढ़ावत चंद ।' दो० ३७४
बढ़ावन : (१) वि०पू० । बढ़ाने वाला। बिमल बिबेक बिराग बढ़ावन ।' मा०. १.४३.५ (२) सं० । बढ़ाना-ने । 'महि महि धनि लखन कह बलहि बढ़ावन ।' जा०म० ६८
बढ़ावनिहारी : वि० स्त्री० । बढ़ाने वाली। मा० १.१२६.३
बढ़ावनो : सं००कए० । बढ़ाना ! 'बिषम बली सों बादि बैर को बढ़ावनो।' कवि० ५.६
बढ़ावहि : आ.प्रब० (सं० वर्धयन्ति>प्रा० वड्ढावं ति>अ० वड्ढावहिं)। बढ़ाते हैं । 'नाहिं नाना रंग तरंग बढ़ावहिं ।' पा०म० ६३
बढ़ावहि : आ०मए० (सं० वर्धयसि>प्रा० वड्ढावसि>अ० वड्ढावहि) । तू बढ़ाता है । 'बथा कत रटि रटि राग बढ़ावहि ।' विन० २३७.१
बढ़ावा : भूकृ०० । बढ़ाया। 'देखि मोहि जिय भेद बढ़ावा ।' मा० ४.६.१०
बढ़ावै : बढ़ावई। बढ़ाए, बढ़ा सकता है। 'को करि तर्क बढ़ावै साखा।' मा० १.५२.७
बढ़ावौं : आ० उए । बढ़ाऊँ, बढ़ाता हूं। 'सब सों बैर बढ़ावौं ।' विन० १४२८
बढ़ि : (१) पक ० । बढ़ कर । 'कपि बढि लाग अकास ।' मा० ५.२५ (२) बढ़ी। 'साँची बिरुदावली न बढि कही गई है ।' विन० १८०.६
बढ़िआरि : सं०स्त्री० (सं० वृद्धि+ कारि>प्रा० ड्ढिआरि)। बाढ़, सैलाब । ___ 'सुरसरिहू बढ़िआरि ।' दो० ४६८
बढ़ी : भूक०स्त्री० । विकसित हुई । 'बढ़ी परस्पर प्रीति ।' मा० १.३३७.७
बढ़ें: बढ़ने से, बढ़ने पर । 'सागरु ज्यों बल बारि बढ़े। कवि० ६.६
677
बढ़े: भूक००ब० । 'काटे बहुत बढ़े पुनि ।' मा० ६.६७
बढ़ेया : वि०। बढ़ाने वाला । 'बार खाल को कढ़या सो बढ्या उर साल को।' ___ कवि० ७.१३५
बढ़ो : बढ़ यो । 'श्री प्रभु के सँग सों बढ़ो।' दो० ५३२
बढ़्यो : भूकृ०पू०कए । बढ़ा । 'जैवत जो बढ़ यो अनंदु ।' मा० १.६६ छं०
बतकही : संस्त्री० (१) (सं० वार्ता-कथा>प्रा० वत्तकहा>अ०वत्तकही)। वार्तालाप, बातचीत । 'रिपूसन करेह बतकही सोई।' मा० ६.१७.८ (२) (सं. वृत्तकथा>प्रा० वत्तकहा) । इतिवृत्त, आख्यान, चरित्रगाया। हँसहिं मलिन खल बिमल बतकही।' मा० १.६.२ ।
बतबढ़ाव : सं०पु० । वार्ता विस्तार, तर्कवितर्क । 'अब जनि बतबढ़ाव खल करही।' मा० ६.३०.१
बताउ: आ० ---आज्ञा-मए । तू बतला। 'तारा सिय कहँ लछिमन मोहि बताउ।' बर० ३१
बतायो : भूक००कए० । बतलाया । 'सो मगु तोहि न बतायो ।' विन० १६६.३
बतास, बतासा : सं० । (१) वायु । 'कछु दिन भोजन बारि बतासा ।' मा० १.७४.५ (२) झंझावात, वातचक्र । 'बुद्धि बिकल भइ बिषय बतासा ।' मा० ७.११८.१४
बतियाँ : बतिया+ब० । बातें । 'चातक बतियाँ ना रुचीं।' दो० ३१०
बतिया : (१) बात। उक्ति, कथन । रान० ७ (२) संस्त्री० । नवजात कच्चा फल । 'इहाँ कुम्हड़ बतिया कोउ नाहीं ।' मा० १.२७३.३
बत्तिस : संख्या (सं० द्वात्रिंशत् >प्रा० वत्तीसा) । मा० ५.२.८
बत्सल : बच्छल । वात्सल्ययुक्त । विन० ११८.४
बद : (१) आप्रए० । कहता है । 'पावन सुजस पुरान बेद बद ।' मा० ७.३४.५ (२) आज्ञा-मए० (सं० वद)। तू बता। 'मो सन भिरिहि कवन जोधा, बद।' मा० ६.२३.१
बदति : आ.प्रब० (सं० वदन्ति)। कहते हैं । 'इति बेद बदंति न दंतकथा ।' मा० ६.१११ छं०
बदत : व.पु. (सं० वदत्) । कहता-ते । 'सुर बदत जय ।' मा० ६.१०१ छं०
बदति : (१) वक स्त्री० (सं० वदन्ती) । कहती। 'करि बिलापु रोदति बदति ।' मा० १.६६ (२) आप्रए० (सं० वदति)। कहता है। 'इति बदति तुलसीदास ।' विन० ४५.५
बदन : सं०पू० (सं० वदन) । मुख । मा० १.४.८ हैं
678
_______________________________________________

बदननि, बदनन्हि : बदन+संब० । मुखों (से) । 'बदननि बिधु निदरे हैं।' गी० २.२५.१
बदनी : (समासान्त में) वि०स्त्री० । मुख वाली, सदृश मुख वाली । 'बिधु बदनी। मा० १.१०.४
बदनु : बदन+कए । मुख । 'सुरसा बदनु बढ़ावा ।' मा० ५.२.६
बदर : सं०० (सं० वदर) । बेर फल । मा० २.१२५.७
बदरी : संस्त्री० (सं० वदरी)। बेर वृक्ष । 'कदरी बदरी बिटप ।' दो० ३५४
बदरीबन : (१) बेर के वृक्षों का वन (२) हिमालय स्थित तीर्थविशेष जहां नर-नारायण की तपोभूमि है । मा० ४.२५
बदलि : पू० (अरबी-बदल= व्यावसायिक विनमय ; बछाल = बनिया)। बदल कर, विनिमय में ले-दे कर । लिये बेर बदलि अमोल मनि आउ मैं ।' विन० २६१.१
बदलें : (दे० बदलि) बदले में, बिनिमय में । 'काँच किरिच बदले ते लेहीं।' मा ० ७.१२१.१२
बदहिं : आ०प्रब० । कहते हैं, बखानते हैं । 'बिरुद बदहिं मतिधीर ।' मा० १.२६२
बदहि : आ०-आज्ञा-मए । तू बतला । 'सत्य बदहि तजि माख । मा० ६.२४
बदि : पूक० । (१) कह कर (मान कर)। जौं हम निदरहिं बिप्र बदि।' मा० १.२८३ (२) बद कर, निश्चित कर । 'पठए बदि बदि अवधि दसहु दिसि ।' गी० ४.२.४ (३) शर्त लगाकर, होड़ करके । 'कदत करि रघुनाथ सपथ उपरी-उपरा बदि बाद ।' गी० ५.२२.४
बदौं : आ० उए० । कहता हूं, शर्त के साथ-निश्चित बतलाता है। प्रेम बदौं प्रहलादहि को।' कवि० ७.१२७
बद्ध : भूकृ०वि० (सं.) । बँधा हुआ, प्रबन्ध में निबद्ध । मा० ७.१३० श्लोक १ बद्रिकाश्रम (दे० बदरीबन-सं० वदरिकाश्रम)। नर-नारायण का आश्रम-तीर्थ विशेष । विन ० ६०.५
बध : (१) सं०पू० (सं० वध) । कार डालना । मा० ३.२ (२) दे० /बध ।
बध, बधाइ : आ०प्रए० । मार डालता है। मार डाले। 'जौं मगपति बध मेड़ कन्हि ।' मा० ६.२३ ग
बधउँ : आ०प्रए । मार डालता हूं। 'अस बिचारि खल बधउँ न तोही।' मा
बधजोगू : (दे० जोग) बध के योग्य । मा० १.२७५.३
बधब : भक०० । (१) मारा जा सकेगा। 'बालि बधब इन्ह भइ परतीती ।' मा० ४.७.१३ (२) मारा जाऊँगा । 'उतरु देत मोहि बधब अभागें ।' मा० ३.२६.६. (३) मारना होगा। तेहि बधब हम निज पानि ।' मा० ३.२०.५
679
बधाई : सं.स्त्री० (सं० वर्धापिका>प्रा० वडाइआ)। शभ कामना, सभाजना, ___ मङ्गलोत्सव की शुभाशंसा। 'रघबर जनम अनंद बधाई।' मा० २.४०.८ (२) मङ्गलोत्सव के वाद्य । 'बहुबिधि बाज बधाई ।' गी० १.१.५
बधाए : सं.पुं०ब० (सं० वर्धापक>प्रा० वद्धायय) । बधाइयाँ । मा० २.१.१
बधाय : बधाई । “सुजन सदन बधाय ।' विन० २२०.१०
बधाव : बधावा (सं० वर्धाप>प्रा० वद्धाव) । 'गृह गृह बाज बधाव सुभ।' मा० १.१६४
बधावन : बधावा (सं० वर्धापन>प्रा० वद्धावण) । 'गावहिं गीत सुआसिनि बाज बधावन ।' जा०म० ११३
बधावने : बधावन+ब० । बधाइयाँ, समारोह, मङ्गलोत्सव । 'घर घर अवध बधावने ।' रा०प्र० ४.२.१
बधावनो : बधावन+कए । 'आनंद बधावनो मुदित गोप गोपीगन ।' कृ० १७
बधावा : (१) सं०० (सं० वर्धापक>प्रा० वद्धावअ)। मङ्गलोत्सव, (२) मङ्गलोत्सव पर शुभकामना या उपहार आदि; (३) मङ्गल-वाय । 'बाज गहागह अवध बधावा ।' मा० २.७.३
बधि : पूक० । मारकर । 'खल बधि तुरत फिरे रघुबीरा ।' मा० ३.२८.१
बधिक : सं०० (सं० वधिक) । बहेलिया (चिड़ीमार, मृग या जीवी)। मा० ४.३० ख (२) एक व्याध जिसने धोखे से कृष्ण को तीर मारा था । विन० २१२.३
बधिका : बधिक । मा० ३.४२.८
बधिर : सं०पू०+वि० (सं.)। बहरा, श्रवणशक्ति-रहित । मा० ३.५.८
बधिहि : मा०म०प्रए । मारेगा । 'मोहि बधिहि सुख सागर हरी ।' मा० ३.२६ ई०
बधी : भूक०स्त्री० । मार डाली । 'बधी ताड़का।' जा०म० ३६
बधुन : बधन्ह । 'बधुन सहित सुत चारिउ मातु निहारहि।' जा०म० १८५
बधुन्ह : बधू+संब० । बधुओं। 'बधुन्हे समेत चले सुर सर्वा ।' मा० १.६१.१
बधू : संस्त्री० (सं० वधू)। (१) नवविवाहित स्त्री, दुल्हन । 'बध लरिकिनी पर घर आई।' मा० १.३५५.८ (२) पुत्र की पत्नी। (३) पत्नी । 'विप्र-बधू सब भूप बोलाई ।' मा० १.३५४.४ (४) स्त्री । 'बिबुध बधू नाचहिं करि गाना।' मा० १.३४७
बधूटिन्ह : बधूटी+संब० । बधुओं । मा० १.३२७
बधूटीं : बधूटी+ब० । स्त्रियाँ । 'नाहिं गावहिं बिबुध बधूटी।' मा० १.२६५.३
बधूटी : बधू (सं०) । 'सखि सरद बिमल बिधु बदनि बधूटी।' गी० २.२१.१
बधें : मारने से, मारने पर । 'बधे पापु अपकीरति हारें।' मा० १.२७३.७
680
बधे : (१) 'बध' का रूपान्तर । मारने, वध करने । 'पिता बधे पर मारत मोही।' ___ मा० ४.२६.५ (२) भूकृ.पुं०ब० । मार डाले। 'बधे सकल अतुलित बल साली।' मा० ५.२१.६
बधेउ : भूक०कए । मार डाला । 'खर दूषन त्रिसिरा बधेउ ।' मा० ३.२५
बधेहु : आ०- भूक०पु+मब० । तुमने मार डाला | 'बधेहु ब्याध इव बालि बिचारा । मा० ६.६०.५
बधैया : बधाई (सं० वर्धापिका>प्रा० वद्धाइया) । गी० १.६.४
बध्यो : बधेउ । 'बालि बध्यो जेहिं एक सर ।' मा० ६.३३ क
बन : (१) सं०० (सं० वन) । मा० २.४२.२ (२) झुरमुट । (३) जल । जैसे, बनज, बनबाहन मादि । (४) समूह । मा० १.१८५.१
बिन, बनइ, ई : आप्रए० (सं० वनति-अप्रचलित धात>प्रा० वणइ)। (१) बनता है, रचा जाता है। (२) अनुकूल होता है । 'राम देत नहिं बनइ गोसाई ।' मा० १.२०८.५ (३) शक्य होता है। 'बनइ न बरनत नगर निकाई।' मा० १.२१३.१ (४) प्रतीति में आता है। 'देखत बनइ बरनि नहिं जाई।' मा० ३.४०.३ (५) संगत होता है। 'बनइ प्रभु पोसों।' मा० ४.३.४
बनचर : वि० (सं० वनचर)। (१) वन में विचरण करने वाला (२) वन्य जीव वानर आदि । 'बनचर देह धरी छिति माहीं।' मा० १.८८.३
बनचारी : बनचर । मा० २.३२१.२
बनज : सं०० (सं० वनज) । वनजल में उत्पन्न । कमल । 'जय रघुवंस बनज बन भानू ।' मा० १.१८५.१
बनजात, बनजाता : बनम (सं० वनजात)। कमल । 'बरन बरन बिकसे बनजाता।' मा० १.२१२.८
बनत : वकृ०० । बनता, योग्य हो पाता । 'करत बिचारु न बनत बनावा ।' मा० १.४६.२
बनदेव : सं०पू० (सं० वनदेव) । वन के अधिष्ठाता देव । मा० २.५६.३
बनदेवनि : बनदेव+संब० । वन देवों (से) । 'बनदेवनि सिय कहति कहन यों।'  गी० ३.७.३
बनदेवा : बनदेव । मा० २.३१२.७
बनदेबी : बनदेबी+ब। वन की देवियां । 'बनदेबी बनदेव उदारा।' मा०
बनदेबी : बन की अधिष्ठी शक्ति । मा० ५.५६.३
बननिधि : जलनिधि । समुद्र । मा० ६.५
बनपट : वन्य वस्तुओं-वल्कल आदि के वस्त्र । गी० २.३०.३ _______________________________________________
681
बनपाल : वन के रखवाले । कवि० ५.२
बनबास : (सं० वन-वास) वन में निवास । मा० २.२२४.८
बनबासी : वि.पु० (सं० वन वासिन्) । वन में रहने वाला । गी० १.५५.८
बनबासू : बनबास+कए० । वन-प्रवास । 'सुतहि राजु रामहि बनबासू ।' मा० २.२२.६
बनबाहन : (दे० बन तथा बाहन) वन-जल का वाहन नौका । 'जब पाहन भे बन-बाहन से ।' कवि० ६.६
बनबाहनु : बनबाहन+कए । एकमात्र नौका। 'पाहन तें बन-बाहनु काठ को कोमल है।' कवि० २.७
बनमाल : बनमाला।
बनमाला : संस्त्री० (सं० वनमाला) । (१) सभी ऋतुओं के पुष्पों से बनी--बीच बीच कदम्ब-पुष्पों से गुथी-घुटनों तक लम्बी माला। 'आजानु-लम्बिनी माला सर्वत्-कुसुमोज्ज्वला। मध्ये स्थूल-कदम्बाढ्या वनमालेति कीर्तिता ।' 'उर श्रीवत्स रुचिर बनमाला ।' मा० १.१४७.६ (२) वनपुष्पों की माला। 'जटा मुकुट सिर उर बनमाला ।' मा० ३.३४.७
बनरन्ह : बानर+संब० । वानरों । 'देखहु बनरन्ह केरि ढिठाई ।' मा० ६.४०.२
बनरा : बानर । 'उतरे बनरा जय राम रहैं।' कवि० ६.६
बनरुह : सं०० (सं० वनरूह जलरुह) । कमल । 'अरुन-बनरुह लोचनं ।' कृ.
बनवनि : संस्त्री० । बनाव, सजावट । 'सुमन लता सहित रची बनवनि ।' गी० ३.५.३
बनसी : संस्त्री० (सं० वडिश>प्रा० वडिस>अ. वडिसी)। मछली फंसाने का काँटा । 'बुधि बल सील सत्य सब मीना । बनसी सम तिय कहहि प्रबीना ।' मा० ३.४४.८
बनहिं : (१) आप्रब० । बनती-ते हैं। (उपमा...) 'देत न बनहिं निपट लघु लागीं।' मा० १.३४६.८ (२) वन में । 'लछिमन गए बनहिं जब ।' मा० ३.२३
बनहि : वन को । 'भगुपति गए बनहि तप हेतू ।' मा० १.२८५.७
बनहीं : बनहिं । बन में । 'फिरहिं बन-बनहीं।' मा० २.२११.८
बना : भूकृ० । (१) घटित हुआ, जुट गया। 'बना आइ असमंजस आजू ।' मा० १.१६७५ (२) सजा, सुसज्जित हुआ। 'बना बजारु न जाइ बखाना।' मा० १.३४४.६
बनाइ : पू० । बनाकर । (१) रच कर । 'तरु लेखनी बनाइ.. 'महिमा लिखी न जाइ ।' वैरा० ३५ (२) सवार कर (भली प्रकार) । 'बई बनाइ बारि बदाबन ।' कृ० २६ (३) करके । 'लोक बिसोक बनाइ बसाए ।' मा० १.१६.३ (४) कृत्रिम रचना करके (बनावट करके) । 'प्रभु सों बनाइ कहीं जीह जरि जाउ सो।' विन० १८२.६
बनाइअ, ए, य, ये : आ० कवा०प्र० (सं० वान्यते>प्रा. वणावीअइ) । बनाया जाय । 'बेगि बिधान बनाइअ ।' पा०म० १२२
बनाइन्हि : बनाएन्हि । पा०म० ८७
बनाईं : भूक०स्त्री०ब० । सजाई, रचाई। 'कुसुम-कली बिच-बीच बनाई।' मा० १.२४३.७
बनाई : (१) बनाइ । सजाकर । 'लखन बान धनु धरे बनाई।' मा० २.१५१.४ (२) भूकृस्त्री० । रची, सजाई गयी। 'जहाँ स्वयंवर भूमि बनाई ।' मा० १.१३३.४
बनाउ, बनाऊ : सं०० (प्रा० वणाव)+कए० । रचना, सजावट । 'सात दिवस भए साजत सकल बनाउ ।' बर० २० मा० १.३०२.२
बनाएँ : क्रि०वि० (१) बनाए हुए (स्थिति में) । 'कपट विप्र बर बेष बनाएँ।' मा० १.३२१.७ (२) बनाने से । 'तुलसी बनी है राम रावरे बनाएँ। कवि० बनाए : भूकृ.पु.ब० । सजाये, रचे । 'निज कर भूषन राम बनाए।' मा० ३.१.३
बनाएन्हि : आ०-भूक००+प्रब० । उन्होंने बनाया-ये । 'बास बनाएन्हि जाइ।' मा० २.१६६
बनाय : (१) बनाइ । गी० २.२८.५ (२) सं०पू० । बनाव, तैयारी, साधन । 'बने सकल बनाय ।' विन० २२०.६
बनाया : बनावा । रचा। 'सर मंदिर बर बाग बनाया।' मा० ६.५७.१
बनाये : बनाएँ । बनाने से । 'तेरे ही बनाये बलि बनेगी।' विन० १७६.५
बनाव : सं००। (१) रचना, साज-सज्जा । 'बरनि न जाइ बनाव।' मा० १.६५.२ (२) शृगार, बेष रचना । 'निज निज आसन बैठे राजा । बहु बनाव करि सहित समाजा।' मा० १.१३३.५ /
बनाव, बनावइ : आ०प्रए० (सं० बानयति>प्रा० वणावइ)। बनाता है, बनाए । चित्रकार" स्वारथ बिन चित्र बनावें ।' विन० ११६.४
बनावत : वकृ०पू० । बनाता-ते, करता-ते । 'मुनि जप तप जाग बनावत ।' विन० १८५.२
बनावन : भकृ० अव्यय । बनाने, सजाने । 'कहेउ बनावन पालकी ।' मा० २.१८६
बनावहिं : आ०प्रब० । बनाते-ती हैं । (१) गढ़ते-ती हैं । 'नाना जुगुति बनावहिं ।' क० ४ (२) सजाते हैं। 'घाट बाट पुर द्वार बजार बनावहिं ।' जा०मं. १८२

बनावहि : आ०-आज्ञा-मए । तू बना । 'रचि रचि हार बनावहि ।' विन० २३७.४ .
बनावा : भूक०० । बनाया । (१) किया। निश्चित किया। 'करत बिचारु न बनत बनावा ।' मा० १.४६.२ (२) सजाया, सँवारा । 'जटा मुकुट निज सीस बनावा।' मा० २.१५१.२ (३) निष्पन्न किया। 'आपु गई जहँ पाक बनावा।' मा० १.२०१.३ (४) रचा, निर्मित किया। 'हरि मंदिर तहँ भिन्न बनावा ।' मा० ५.५.८ (५) बनाव । साजबाज, शृंगार । 'संग नारि बहु किएँ बनावा ।' मा० ५.६.२
बनावै : (१) बनावइ । 'बिगरी बनावै कृपानिधि की कृपा नई ।' विन० २५२.२ (२) भक० अव्यय =बनावन । बनाने । 'पटतर जोग बनावं लागा।' मा० २.१२०.५
बनि : (१) पू० । बनकर, सज्जित होकर, घटित होकर । 'जद्यपि ताको सो मारग प्रिय जाहि जहाँ बनि आई ।' क० ५१ (२) सं०स्त्री० (सं० वणिज = वणिज्या>प्रा० वणि)। व्यवसाय, वाणिज्य, पारिश्रमिक । 'बहुत काल मैं कीन्हि मजूरी। आजु दीन्हि बिधि बनि भलि भूरी।' मा० २.१०२.६ (३) बनी। सजी हुई । 'चहुं पास बनि गजमनी ।' गी० ७.५.६ (४) मजदूरी। 'खेती बनि विद्या बनिज ।' दो० १८४
बनिक : सं०प० (सं० वणिज - वणिक्) । बनिया, व्यवसायी । मा० १.३.१२
बनिज : संस्त्री० (सं० वणिज्या>प्रा० वणिज्जा>अ० वणिज्ज)। व्यवसाय, ___दुकानदारी आदि । दो० १८४
बनितन, बनितन्हि : बनिता+संब० । वनिताओं, स्त्रियों । 'तुलसिदास ब्रज बनितन को बत समरथ को करि जतन निवारे ।' कृ० ५७
बनिता : सं०स्त्री० (सं० वनिता) । सुसज्जित स्त्री, पत्नी, प्रेयसी, सुन्दरी। मा० २.७६
बनिहिं : बनिहैं। बनेंगे, योग्य होंगे। 'इंद्रिय-संभव दुख हरे बनिहिं प्रभु तोरे।' विन० ११६.५
बनिहि : आ० भ०प्रए० । बनेगा-गी। संगत होगा-गी। 'आन उपाय बनिहि नहिं. ___ बाता।' मा० २.८५.८
बनिहैं : आ०भ० प्रब० । बनेंगे, उपयुक्त होंगे। 'अघ.. अपनायेहि पर बनि हैं।" विन० ६५.३
बनिहै : बनिहि । 'बनिहै बात उपाय न औरे ।' गी० २.११.२
बनीं : भक स्त्रीब० । सची, रची। 'पदकंजनि मंजु बनीं पनहीं।' कवि० १.६
684
बनी : भूक स्त्री०। (१) सजी, रची। 'जस दूलहु तसि बनी बराता।' मा० १.६४.१ (२) सम्पन्न हुई, निभ गई । 'बनी तुलसी अनाथ की।' विन० २७६.३
बनु : बन+कए। मा० २.५५
बने : भूकृ०० ब० । सजे, शृगार किये हुए । 'बने बराती बरनि न जाहीं ।' मा० १.३४६.४
बनै : बनइ। (१) बनता है, बन सकता है। 'सेन बरनत नहिं बने ।' मा० ५.३ छं० १ (२) बन जाय । 'क्यों न बिभीषन की बने ।' गी० ५.४०.१
बनैगी : आ०भ० स्त्री०प्रए । ठीक रहेगी, बात उपयुक्त होगी । 'सहेही बनेगी सब ।' ____ कवि० ७.१३५
बनैहौं : आ० भ० उए ० । बनाऊँगा-गी (सजाऊँगी)। 'बालं बिभूषन बसन मनोहर ___अंगनि बिरचि बनहौं ।' गी० १.८.२
बन्यो : भूकृ.पु.कए । रचा गया, सज्जित हुआ । फबा । 'पहुंची करनि, कंठ कठुला बन्यो।' गी० १.३२.२
बपत : वकृ.पु० (सं० वपत्) । बोता-ते, बोता हुआ, बोते हुए। 'बबुर बीज बपत ।' विन० १३०.२
बपु : सं०० (सं० वपुष) । शरीर । मा० १.८७
बपुरा : वि०० (सं० वर=धूलि>प्रा. वप्पुडा -संभवतः 'वप्रपुट' =धूल की पुड़िआ के अर्थ में मूलतः रहा होगा) । बेचारा, नगण्य , क्षुद्र । 'सिव बिरंचि कहुं मोहइ, को है बपुरा आन ।' मा० ७.६२ ख .
बपुरे : बपुर+ब. (प्रा० बप्पुडया) । बेचारे, तुच्छ । 'कहा कीट बपुरे नर नारी।' मा० २.२६.३
बपुष : बपु। मा०६६८.५
बबा : सं०पु० (फा० बाबा)। पिता । 'ज्यों बालक माय-बबा के ।' विन० २२५.४
बबुर : सं०० (सं० बबुर>प्रा० बब्बुर) । बबूल (वृक्षविशेष जो काँटेदार होता है)। कवि० ७.६६
बबूर : बबुर । मा० १.६६ छं०
बबै : (दे० बबा) पिता ने । 'बबै ब्याह की बात चलाई ।' कृ० १३
बमत : वकृ०० । वमन करते हुए, उगलते हुए । 'रुधिर बमत धरनी ढनमनी ।' मा० ५.४.४
बमन : सं०० (सं० वमन) । उगाल, बान्त । 'तजत बमन जिमि जन बड़भागी।' मा० २.३२४.८ _______________________________________________
685
बय : संस्त्री० (सं० वयस>प्रा० वय नपू) । जीवन की अवस्था (शैशव, यौवन आदि) । मा० १.२२०
बयउ, बयऊ : भूकृ००कए० (सं० उत्तम् >प्रा० ववियं>अ० ववियउ) । बोया, बो दिया । 'तुम्ह कहुं बिपति बीजु बिधि बयऊ ।' मा० २.१६.६
बयदेही : बैदेही । मा० ३.५.६
बयन : (१) (सं० वचन>प्रा. वयण)। बचन । मा० १.३२६ छं० २ (२) (सं० वदन>प्रा० वयण) मुख । दे० बिधुबनी।
बयबिरिध : वि० (सं० वयोवृद्ध) । वयस में बड़ा-बड़े । मा० २.११०.४
बयर : बैर । मा० १.१४ क
बयरु : बयर+कए । शत्रुता । 'बयरु बिहाइ चरहिं एक संगा।' मा० २.२३६.४
बयस : (१) बय । 'स्याम गौर मदु बयस किसोरा ।' मा० १.२१५.५ (२) सं०० (सं० वैश्य>प्रा० वइस) । द्विजातिविशेष ।
बयस-सिरोमनि : (बयस+सिरोमनि) युवावस्था । 'बय किसोर सरि पार मनोहर, बयस-सिरोमनि होने ।' गी० २.२३.२
बयसु : बयस-+-कए । वैश्य (जाति) । 'सोचिअ बयसु कृपिन धनवानू ।' मा० २.१७२.५
बयारि : सं०० (सं० वातालि>प्रा० वायालि) । वायु । मा० २.६७.६
बयारी : बयारि (सं० वाताली>प्रा. वायाली)। परम सुखद चलि त्रिविधः बयारी।' मा० ६.११६.७
बये : बए । बोए । 'बये बिटप बट बेलि ।' रा०प्र० २.३.३
बयो : बयउ । बोया हुआ । 'निज नयननि को बयो सब लुनिए।' कृ० ३७
बर : संपु (सं० वर) । वरदान । 'देहु एक बर भरतहि टीका ।' मा० २.२६.१ (२) वि० । श्रेष्ठ । 'ते बर पुरुष बहुत जग नाहीं ।' मा० १.८.१२ (३) वरण किया हुआ दूल्हा । 'बर दुलहिनि सकुचाहिं ।' मा० १.३५० ख (४) पति । 'सीता बर' । मा० ७.७८.४ (५) अपेक्षाकृत उत्तम, कुछ अच्छा । दे० बरु । (६) सं०० (सं० वट>प्रा० वड़) । बरगद । 'तुलसी भल बर तरु बढ़त ।' दो० ५२६ (७) बल । 'सपनेहूं नहीं अपने बर बाहै ।' कवि० ७.५६ '
बर, बरइ, ई : (सं० वृणोति>प्रा० वरइ) आ०प्रए । वरण करता या करती है (वर हेतु चुनती है)। 'बरइ सीलनिधि कन्या जाही।' मा० १.१३१.४ (२) पत्नी रूप में चुनता है । 'लछिमन कहा तोहि सो बरई ।' मा० ३.१७.१८ (३) (सं० ज्वलति>प्रा० वलइ) जलता या जलती है। "छबि गृह दीपसिखा जनु बरई ।' मा० २.२३०.७
बरउँ : आ० उए० (सं० वृणोमि>प्रा० वरमि>अ० वरउँ) । वरण करती हूं। पतिरूप में प्राप्त करती हैं। 'बरउँ संभु न त रहउँ कुआरी ।' मा० १.८१.५
686
_______________________________________________
बरगद : सं० । वट वृक्ष का फल । हनु० ३६
बरज, बरजई : आ०प्रए० (सं० वर्जति)। रोकता है, रोके ; निषेध करता है करे । 'बस होइ तबहिं जब प्रेरक प्रभु बरजे ।' विन० ८६.४
बरजउँ : आउए । रोकता हं, निषेध करता हूं। 'ता तें मैं तोहि बरजउँ राजा।' मा० १.१६६.१
बरजन : भक० अव्यय । रोकने, निषेध करने । 'रखवारे जब बरजन लागे।' मा० ५.२८.८
बरजहु : आ०मब० । रोको । 'तो मोहि बरजहु भय बिसराई ।' मा० ७.४३.६
बरजि : पूक० । निषेध करके । 'जद्यपि प्रथम बरजि सि राखे । मा० १.१२८.७
बरजिए, बरजिये : आकवा०प्रए । रोकिए, हाँटिए । 'बेगि बोलि बलि बरजिये।' . विन० ८.४
बरजित : भूक०वि० (सं० वजित)। रहित, त्यक्त । 'सकल दोष छल बरजित प्रीती।' मा० १.१५३.७
बरजी : भक०स्त्री०। रोकी गयी। 'स्यानी सखी हठि हौं बरजी।' कवि० ७.१३३
बरजे : भूक००व० । रोके । 'प्रभु बरजे बड़ अनुचित जानी।' मा० २.६६.४
बरज : बरजइ।
बरजोर, बरजोरा : (१) वि० (सं० वर+जोड=श्रेष्ठ बन्धन अथवा बल+जोड़: बल का बन्धन) । बलिष्ठ, सुदृढ । 'को कृपाल बिन पालिहै बिरिदावलि बरजोर ।' मा० २.२६६ (२) क्रि०वि० । बलात्, जबर्दस्ती (छीनकर) । 'ले जातेउँ सीतहि बरजोरा।' मा० ६.३०.५
बरज्यो : भूक०० कए । रोका । 'बिधि न बरज्यो काल के घर जात ।' विन २१६.२
बरत : (१) वकृ.पु । जलता-जलते । 'तह बरत देखहि आगि ।' मा० ६.१०१.४ (२) बरण करता-करते। 'कुबरिहि बरत न नेकु लजाने ।' कृ० ३८ (३) सं०० (सं० व्रत) । 'कृपान धार मग चाल आचरत बरत को ।' गी० ६.१२.१
बरति : (१) वक०स्त्री० । जलती, जलती हुई। कृ० ३० (२) पू० (सं. वर्तयित्वा) । व्यवहार में लाकर । 'जनम पत्रिका बरति के देखह मनहिं बिचारि ।' दो० २६८
बरतेउ : भूकृ०पू०कए । बर्ताव किया । 'बामदेउ सन कामु बाम होइ बरतेउ।' पा०म० २६
बरतोर : सं० । बालतोड़, बाल टूटने से बनने वाला एक प्रकार का फोड़ा। हनु०४१ _______________________________________________
687
बरतोरू : बरतोर+कए । 'जनु छुइ गयउ पाक बरतोरू ।' मा० २.२७.४
बरद : (१) वि० (सं० वरद)। वरदायक, अभीष्ट-दाता । (२) सं.पु. (सं. बलीवर्द>प्रा० वलिछ । बैल । 'बरद चढ़ा बर बाउर । पा०मं० १०६
बरदा : (१) बरद+स्त्री० ! वर देने वाली, अभीष्टदात्री। (२) बरद। बैल ।___'चढ़ यो बरदा घरन्यो बरदा है।' कवि० ७.१५५
बरदान, बरदाना : सं०० (सं० वरदान) । अभीष्ट वस्तु का दान ।' मा० २.२२.५
बरदानि : (बर+दानी) वर देने वाला । 'सीस बस बरदा बरदानि ।' कवि० ७.१५५
बरदानु, बरदान : बरदान+कए । एकमात्र वर । 'होहु प्रसन्न देहु बरदानू ।' मा० १.१४.७
बरदायक : (बर-+दायक) । वर देने वाला=बरदानि ।' मा० १.२५७.७
बरदायनी : वि०स्त्री० (सं० वरदायिनी) । वर देने वाली। 'बरदायनी पुरारि पिभारी।' मा० १.२३५.१
बरन : सं०० (सं० वर्ण) । (१) अक्षर । 'राम नाम बर बरन जुग।' मा० १.१६ (२) ब्राह्मण आति चार जातियां । 'बरन धर्म नहिं आश्रम चारी ।' मा० ७.६८.१ (३) वर्णमाला । 'बरन बिलोचन जन जिय जोऊ ।' मा० १.२०.१ (४) रंग । 'पीत बरन ।' मा० ७.७३.३ 'बरन बरन बिकसे बनजाता।' मा० १.२१२.८ (५) प्रकार (तरह)। 'बरन बरन दिरदैत निकाया।' मा० ६.७६.४ (६) वर्णन । 'जाइ केहि बिधि बरन की।' पा०म०ई०३ 'बरन
बरनइ : आ०ए० (सं० वर्णयति)। वर्णन करता है, बखानता है । 'सहस बदन बरनइ पर दोषा ।' मा० १.४.८
बरनई : बरनइ । मा० १.३२४ छं० २
बरनउँ : आउए । वर्णन करता हूँ। 'बरनउँ राम चरित भवमोचन ।' मा १.२.२
वरनत : वकृ०० । वर्णन करता-करते ! 'बरनत बरन प्रीति बिलगाती ।' मा० १.२०.४
बरनन : सं० (सं० वर्णन) । बखान । मा० ७.६६ ख
बरननि : बरन+संब० । वर्णों (अक्षरों) । 'सब बरननि पर जोउ।' मा०१.२०
बरननिहारु : वि.पु.कए० । वर्णन करने वाला । 'नहिं कोउ सुकवि बरननिहारु ।' गी० ७.८.५
बरनब : भकृ०० । वर्णन करना, बखान । मा० १.३७.२
बरनहिं, बरनहीं : आ०प्रब० । वर्णन करते हैं । 'बरनहिं तत्त्व विभाग ।' मा० १.४४
बरनहु : मा०मब० । वर्णन करो, बखानो। 'बरनहु रघुबर बिसद जसु ।' मा० १.१०६
688
_______________________________________________
बरना : (१) बरनइ । वर्णन करता है। 'चातक बंदी गुन गन बरना।' मा० ३.३८.८ (२) भूक००। वर्णन किया। निज सौभाग्य बहुत गिरि बरना।' मा० १.६६.८ (३) वर्णन किया गया। 'दुखप्रद उभय बीच कछु बरना।' मा० १.५.३
बरनाधम : वि० (सं० वर्णाधम) । जाति में नीच । मा० ७.१००.५
बरनाश्रम : सं०० (सं० वर्णाश्रम) । चार वर्ण ब्राह्मण, क्षत्रिय, वैश्य और शूद्र+आश्रम ब्रह्मचर्य, गार्हस्थ्य, वानप्रस्थ और संन्यास । वर्ण धर्म तथा आश्रम धर्म । मा० ७.२०
बरनि : (१) पूकृ० । वर्णन करके । 'लघु बिसाल नहिं बरनि सिराहीं।' मा० १.६४.३ (२) बरने । वर्णन किये । 'बेदहूं बरनि ।' विन० १८४.४
बरनिअ, ए, य, ये : मा०कवा०प्रए । वर्णन किया जाय-की जाय । 'सिय बरनिम तेइ उपमा देई ।' मा० १.२४७.३ 'कलि करनी बरनिये कहां लौं।' विन० १३६.७
बरनिसि : आ०-भकृस्त्री०+प्रए । उसने बखानी। 'निसिचर कीस लराई बरनिसि बिबिध प्रकार ।' मा० ७.६७ ख
बरनी : (१) भूकृ०स्त्री० । वर्णन की गई। करम कथा रबिनंदिनि बरनी।' मा० १.२.६ (२) बरनि । वर्णन कर (के) । 'चिता अमित जाइ नहिं बरनी। मा० १.५८.१
बरनु : बरन+कए० । वर्ण, रंग । 'घायल लखन बीर बानर-बरनु भो।' कवि०. ६.५६ (वानर वर्ण=भूरा रंग।)
बरने : भूकृ.पुब । बखाने, वर्णन किये । 'जिन्ह बरने रघुबर गुन ग्रामा।' मा० १.१४.४
बरनेउँ : आ०-भूक००+उए । मैंने वर्णन किया। 'जस बरु मैं बरनेउं तुम्ह पाहीं।' मा० १.६६.२
बरनै : भक अव्यय । वर्णन करने । 'रामचंद्र गुन बरनं लागा।' मा० ५.१३.५
बरनै : (१) बरनइ । वर्णन करे-कर सके । 'बरने तुलसीदासु किमि ।' मा० १.१०३ (२) बरनै । वर्णन करने । 'श्रुति सारदा न बरन पारा ।' मा० ७.५२.२
बरनौं : बरनउँ । वर्णन करूं, वर्णन कर सकता हूं। 'बरनौं किमि तिन्ह की दसहि ।' गी० २.१७.३
बरन्ह : बर+संब० । वरों (के), पतियों (के)। 'सुदरी सुदर बरन्ह सह ।' मा० १.३२५ छं०४
बरबर : बर्बर । पा०म० ६२
बरबरनी : सं०स्त्री० (सं० वरवर्णा=वरणिनी)। श्रेष्ठ रूपवती सुन्दर स्त्री। मा० २.११७.३ _______________________________________________
689
बरबस : क्रि०वि० (सं० बलवश) । बलात्, बलपूर्वक । 'बरबस राज सुतहि नृप दीन्हा ।' मा० १.१४३.१
बरबात : संस्त्री० (फा० बर-बस्त-कायदः) । रीति, चालढाल । 'निज घर की बरबात बिलोकह, हो तुम परम सयानी।' विन० ५.२
बरम : सं०० (सं० वर्मन्) । कवच । गी० ७.३१.२
बररै : सं० (सं० वरटक>प्रा० वरडय)। बरी, भिड़ । 'बररै बालक एक सुभाऊ।' मा० १.२७६.३
बरष : (१) सं०० (सं० वर्ष>प्रा० वरिस)। बारह मास का समय । मा० १.७४.४ (२) बरषइ । बरसता है । 'सुमन सुर बरष ।' गी० १.५५.४
बरष, बरषइ, बरषई : आ.प्रए० (सं० वर्षति>प्रा० वरिसइ) । बरसता है । 'जौं बरषइ बर बारि बिचारू ।' मा० १.११.९; मा० ६.६७ छं०
बरषत : वकृ०० । बरसता-ते; बरसाता-ते । 'सुर"'बरषत सुरतरु फूल ।' मा० २.३०८
बरषन : भक० अव्यय । बरसने, बरसाने । 'आराति.'लागे बरषन राम पर अस्त्र सस्त्र बहु भांति ।' मा० ३.१६ क
बरषहिं, बरषहीं : आ.प्रब० । बरसते हैं, बरसाते हैं। 'बिपुल सुमन सुर बरहिं ।' मा० ३.२७
बरषहु : आ०मब० । बरसो, बरसाओ। 'गगन जाइ बरषहु पट भूषन ।' मा० ६.११७.५
बरषाँ : वर्षा ऋतु ने । 'जनु बरषां कप प्रगट बुढ़ाई ।' मा० ४.१६.२
बरषा : सं०स्त्री० (सं० वर्षा) । सावन-भादों का ऋतुविशेष ।' मा० १.२६१.३
बरषासन : (सं० वर्षाशनवर्ष+अशन) एक वर्ष भर का भोजन । मा० २.८०.३
बरषि : पू० । बरस कर, बरसा कर । 'सब अमर हरषे सुमन बरषि ।' मा० १.१०२ छं.
बरषिहैं : आ०भ० प्रब० । (१) बरसेंगे । 'बरषिहैं कुसुम भानुकुल मनि पर।' गी० ५.५०.३ (२) बरसाएंगे । 'बरषिहैं सुमन सुर ।' गी० ५.५१.४
बरषी : बरषि । मा० ५.३४.८
बरषे : भूकृ००० । बरसे, बरसाये । 'फिर सुमन बहु प्रभु पर बरखे।' मा० ६.६७.२
बरषेउ : भूकृ००कए । बरसा, बरसाया । 'पुलक गात लोचल जल बरषेउ।' मा० ७.२.१
बरषैं : बरहिं । 'बर मुसलधार बार बार घोरि के ।' कवि० ५.१६
बरषै : (१) बरषइ । बरसे । 'जौं धन बरष समय सिर ।' दो० २७८ (२) भक० भव्यय । बरसने, बरसाने । पुनि लाग बरष बालु ।' मा० ६.१०१.४
690
_______________________________________________
बरष्षत : बरषत । कवि० ६.४७
बरस : बरिस, बरष । 'दस चारि बरस के दूख ।' गी० ६.२२.४
बरस, बरसइ : बरषइ । 'ऊसर बरस मेह ।' दो० २६८
बरसत : बरसत (सं० वर्षत>प्रा० वरिसंत) । दो० ४०२
बरसति : वकृ स्त्री० । बरसती, वर्षा करती। 'सुरमंडली सुमन चय बरसति ।  गी० ७.१७.१२
बरसन : बरषन । मा० ३.१६ क (पाठान्तर)।
बरहि : (१) बर+हि । वर के लिए । 'बोरे बरहि लागि तपु कीन्हा ।' मा० १.६७.२ (२) सं०पु० (सं० वहिन् >प्रा० बरिहि) । मयूर । 'जन बर बरहि नचाव ।' मा० १.३१६
बरह्यो : भूकृपु०कए। ('बरहा' उस नाली को कहते हैं जिसमें से पानी ले जाकर क्यारी तक पहुंचाया जाता है। उससे सींचने की क्रिया को 'बरहना' कहते हैं । ) बरहे से सींचा । 'सो थाक्यो बरह्यो एकहिं तक देखत इनकी सहज सिंचाई ।' कृ० ५६
बराइ, बराई : पूक० (सं० वारयित्वा>प्रा० वराविअ>अ० वरावि)। (१) बचाकर, निरस्त करके । 'हम सब भाँति करब सेवकाई । करि केहरि अहि बाघ बराई ।' मा० २.१३६.५ (२) छाँट कर, चुनकर । ‘फल खात बराइ बराइ।' रा०प्र० ५.३.७ (३) जलाकर।
बराएँ : क्रि०वि० । बचाकर, बचाते हुए। 'सिय राम पद अंक बराएँ।' मा० १.१२३.६
बराक : वि०पु० (सं० वराक) । बेचारा, तुच्छ । 'को बराक मनुजाद ।' गी० ५.२२.५
बराकी : वि०स्त्री० (सं० वराकी)। तुच्छ, दीन, बेचारी। ‘महाबीर बांकुरे, बराकी बाँह पीर ।' हनु० २३
बराट : सं०० (सं० वराट) । कौड़ी। 'हौं लालची बराट को।' कवि० ७.६६
बरात : बराता । मा० १.६२.८
बरातहि : बरात को । 'लै अगवान बरातहि आए ।' मा० १.६६.१
बराता : सं०स्त्री० (सं० वरयात्रा>प्रा० वरयत्ता=वरत्ता) । मा० १.६२७
बरातिन्ह : बराती+संब० । बरातियों (ने)। 'रथ गज बाजि बरातिन्ह साजे ।' मा० १.३३६.५
बराती : सं०+वि.पु. (सं० वरयात्रिन्>प्रा० वरयत्ती) । बरात के सदस्य गण। मा० १.४०.७ _______________________________________________
691
बराबरि, बराबरी : (१) सं०स्त्री० । समानता । 'तो कि बराबरि करत अयाना ।' मा० १.२७७.२ (२) वि.स्त्री० । समान । 'सब पर मोरि बराबरि दात्या ।' मा० ७.८७.७ (३) तुलनीय । 'नगरु कुबेर को सुमेरु की बराबरी ।' कवि० ५.३२
बराय : बराइ। (१) (सं० ज्वालयित्त्वा>प्रा० वलाविअ>अ. वलावि) । जलवाकर । 'मानिक दीप बराय बैठि तेहि आसन हो ।' रा०न० ७ (२) बरा कर, छांट-चुनकर । 'निगम अगम मूरति महेसमति जुवति बराय बरी।' गी० १.५७.३
बरायन : सं०० (सं० वर= कुंकुम+अयन) । केसर आदि का पात्र, महावर का पात्र (?) । बिहँसत आउ लोहारिनि हाथ बरायन हो ।' रा०न० ५
बरायो : भूकृ००कए० । बराया हुआ, चुना हुआ। 'महाबीर बिदित बरायो ___ रघुबीर को।' हन० १०
बरासन : (बर+आसन) । श्रेष्ठ आसन । मा० ७.१००.६
बराहँ : बराह (भगवान्) ने । 'बराह"अनायास उधरी ।' मा० २.२६७.४
बराह, बराहा : (१) सं०० (सं० वराह) । सूअर । मा० १.१२२.७ (२) भगवान् का अवतार विशेष ।
बराहु, बराहू : बराह+कए । 'देखि बिसाल बराहु ।' मा० १.१५६
बरि : पूक० । वरण करके (चुन कर) । 'पूजी मन कामना भावतो बरु बरि के।' ___ गी० १.७२.२
बरिआइ : बरिआई।
बरिआईं : बरिआई से, बलपूर्वक, जबर्दस्ती से । 'जीते सकल भूप बरिआईं।' मा० १.१५४.६
बरिआई : सं०स्त्री० (सं० बलीयस्ता>प्रा० बलीआया>अ. बलीआई)। अति बलवत्ता (जबर्दस्ती) । 'चल न बिप्रकुल सन बरिआई। मा० १.१६५.५ ।
बरिआता : बराता । बरात । मा० १.६५.७
बरिआर, बरिआरा : वि०० (सं० बलीयस्तर>प्रा० बलीआर) । अत्यन्त बलशाली । ___ 'तप बल विप्र सदा बरिआरा ।' मा० १.१६५.३
बरिनिया : सं०स्त्री० । वारी जाति की स्त्री। रान०८
बरिबंड, बरिबंडा : वि.पु. (सं० बलिन् +बण्ड == एकाकी)। अकेला = अद्वितीय बलवान् । बेजोड़ बली, अतुल्य शूर । 'मनुज कि अस बरिबंड।' मा० ३.२५; १.१७६.२
बरिबे : भक०० । वरण करने (ब्याहने) । 'बरिबे कौं बोले बयदेही बरकाज के ।' कवि० १.८
बरिय : आ०कवा०प्रए । वरण कीजिए । 'न बरिय बर बोरेहि ।' पा०म० ५५
692
_______________________________________________
बरियाई : बरिआई । 'ए राखहिं सोइ है बरियाई।' कृ० ५६
बरियार : बरिआर । गी० २.२८.४
बरियो : वि.पु.कए० (सं० बलीयान् >प्रा० बलीयो) । 'कोसल पति सब प्रकार बरियो ।' गी० ५.४६.४
बरिस : (१) बरष (सं० वर्ष>प्रा० वरिस) । 'चौदह बरिस रामु बनबासी।' मा० २.२६.३ (२) (समासान्त में) वि.पु । वर्षा करने वाला । 'सुभाव सब सुख-बरिस ।' कवि० ७.११५ (३) दे० /बरिस ।

बरिस, बरिसइ : बरषइ । 'जन तहँ बरिस कमल सित श्रेनी।' मा० १.२३२.२
बरिसहिं : बरहिं (सं० वर्षन्ति>प्रा० वरिसंति>अ० वरिसहिं) । 'सुर सुमन बरिसहिं ।' मा० १.३२७ छं० १
बरिसा : (१) बरिसइ (२) भूकृ०० । बरसाया । 'बारिद तपत तेल जनु बरिसा । मा० ५.१५.३
बरिसि : बरषि (सं० वृष्टवा>प्रा० वरिसिअ>अ० वरिसि) । 'सुमन बरिसि सुर हनहिं निसाना।' मा० १.३०६.४
बरिसो : भकृ.पु.कए । बरसा हुआ । 'राख को सो होम है, ऊसर को सो बरिसो।' विन० २६४.३ ।।
बरिहि : आ०भ०प्रए० (सं० वरिष्यति>प्रा० वरिहिइ) । वरण करेगी। 'मोहि तजि आनहि बरिहि न भोरें।' मा० १.१३३.६
बरीं : भूकृ०स्त्री०ब० । वरण की, ब्याहीं । 'जीति बरी निजबाहुबल बहु सुन्दर बर नारि ।' मा० १.१८२ ख
बरी : (१) भूकृस्त्री० । वरण की, ब्याही । 'राम बरी सिय। मा० १.२६५.५ (२) संस्त्री० (सं० वटी>प्रा० वडी) । बड़ा (दही-बड़ा आदि) । 'बरो-बरी ___ को लोन ।' दो० ५४६
बरीसा : बरिस । 'पुर न जाउँ दस चारि बरीसा।' मा० ४.१२.७
बरु : वर+कए० । (१) वरदान । 'नप सन अस बरु दूसर लेहू।' मा० २.५०.४ (२) फिर भी अच्छा हो कि । 'राम दूत कर मरौं बरु।' मा० ६.५६ (३) पति। 'जस बरु मैं बरनेउँ तुम्ह पाहीं ।' मा० १.६६.२ (४) संभव है कि । 'भएँ ग्यानु बरु मिटै न मोहू ।' मा० २.१६९.३ (५) बलु । 'दास तुलसी को बड़ो बरु है ।' विन० २५५.४ ।
बरकु : बरु । चाहे, भले ही, संभव है कि । 'निज प्रतिबिंब बरुकु गहि जाई ।' मा० २.४७.८
बरुन : सं०पू० (सं० वरुण) । जल के देवता । मा० १.१८२.१०
बरुना : सं० स्त्री० (सं० वरुणा) । काशी में गङ्गा की एक सहायक नदी। विन.. २२.३
 _______________________________________________
693
बरुनालय : सं०० (सं० वरुणालय)। समद्र । 'करुना बरुनालय साई हियो है।' कवि० ७.१५७
बरूथ : वरूथ । समूह । मा० ४.२१
बरूथन्हि : बरूथ+संब०। समूहों (को)। 'रथ बरूथन्हि को गर्न ।' मा० ५.३ छं. १
बरूथा : बरूथ । मा० १.१८१.५
बरे : भूकृ००ब० । (१) वरण किये (सं० वृत>प्रा० वरिय) । 'बरे तुरत... बिप्र ।' मा० १.१७२ (२) (सं० ज्वलित>प्रा० वलिय)। जले (जलने पर)। 'हरे चरहिं तापहि बरे ।' दो० ५२
बरेखी : सं०स्त्री० (सं० वरेक्षा>प्रा० वरेक्खा)। वरान्वेषण; दूल्हे की खोज (या वर-वरण) । 'रहि न जाइ बिन किए बरेखी।' मा० १.८१.३
बरेहु : (१) आo-भ०+आज्ञा+मब० । तुम (यज्ञ हेतु) वरण करना। 'नित नूत द्विज सहस सत बरेहु ।' मा० १.१६८ (२) आ०-भूकृ.पु+मब० । तुमने (पति रूप में) वरण किया। 'बरेहु कलेस करि बरु बावरो।' पा०म०छं०६
बरै : बरइ । (१) वरण करे । 'जेहि प्रकार मोहि बरे कुमारी ।' मा० १.१३१.७ (२) दग्ध होता है। 'जरै बरै अरु खीझि खिझाव ।' वैरा० ५७
बरोरू : वि०स्त्री० (सं० वरोरू)। श्रेष्ठ ऊरुओं वाली । मा० २.२६.४
बर्ग : संपुं० (सं० वर्ग) । समूह, जाति, सजातीय गण । मा० ७.११६.३
बर्जित : बरजित । रहित । बर० ३५
बर्न : बरन । वर्ण । 'बर्न विभाग न आश्रम धर्म ।' कवि० ७.८५
बर्बर : वि० (सं०) । असभ्य, नीच, क्रूर । मा० ६.२५
बर्हि : बरहि । मयूर । विन० १४.७
बल : सं०० (सं.)। (१) शक्ति, पराक्रम । मा० ३.२.१२ (२) सेना । 'रिपु बल धरषि हरषि कपि ।' मा० ६.३५ क (३) कृष्ण के अग्रज राम । 'अति हित बचन कहो बल भया ।' क० १६
बलउ : बल तो। 'बिधि बस बल उ लजान, सुमति न लजावहु ।' जा०म० ६०
बलकल : सं०० (सं० वल्कल)। बक्कल =वृक्ष आदि की छाल । मा० २.६२
बलकहीं : आ.प्रब० (सं० वल्कयन्ति-वल्क शब्दे) । बकते हैं। 'बेद बुध बिद्या पाइ बिबस बलकहीं ।' कवि० ७.६८
बलकावा : भूकृपु । बकवासी बनाया, ऊलजलूल कहलाया। 'जोबन स्वर केहि नहिं बलकावा।' मा० ७.७१.२
बलदाऊ : (दे० बल तथा दाऊ) । कृष्ण के अग्रज बलराम । कृ० १२
694
बलनि : बल+संब० । बलों= शक्तियों+सेनाओं (के)। 'जीते लोकनाथ नाथ बलनि भरम ।' विन० २४६.२
बलबीर, बलबीरा : बल में वीर, शारीरिक शक्ति में शूरवीर । 'सचिव सयान, बंधु बलबीरा ।' मा० १.१५४.२
बलमीक : सं० (सं० वल्मीक) । बामी=चींटी, दीमक आदि द्वारा बनाया हुआ मिट्टी का ऊँचा स्तुप जिसमें सांप का निवास माना जाता है । 'मरइ न उरग अनेक जतन बलमीक बिबिध बिधि मारे । विन० ११५.४
बलमूल : अत्यन्त शक्तिशाली । कवि० ५.७
बलय : सं०० (सं० वलय) । चूड़ी, कंगन । 'मंजीर नूपुर बलय धुनि ।' गी० ७.१८.५
बलराम : कृष्ण के अग्रज के दो नाम हैं-बल तथा राम । हिन्दी में परशुराम और रामचन्द्र से अलग करने के लिए 'बलराम' कहा जाता है।
बलवंत, बलवंता : वि०पू० (सं० बलवत् प्रा० बलवंत) । बलशाली । मा० ३.१६.१०
बलवान, बलवाना : बलवंत मा० । १.१२२; १.५६.६
बलवानु : बलवान+कए । रा०प्र० ५.६.६
बलसालि, बलसाली : वि०पू० (सं० बलशालिन) । बलवान् । मा० ५.२१.६
बलसीव, बलसीवा : (दे० सींवा)। बल की सीमा, अत्यन्त बलशाली। कपासिंधु बलसींव ।' मा० ४.५
बलसीम : बलसीव । कवि०६.४५
बलसील, बलसीला : वि० (सं० बलशील)। बल हो जिसका शील हो=प्रकृत्या बल शाली। मा० ६.२३.५
बलाइ : सं० स्त्री० (अरबी-बला) । संकट, विपत्ति । 'बानरु बड़ी बलाइ घने घर घालि है।' कवि० ५.१० (२) अपने पर दूसरे की विपत्ति लेने के अर्थ में मुहावरा है । 'बलाइ लेउँ सील की।' कवि० ६.५२
बलाक : सं० (सं०) । एक प्रकार का बगुला । मा० १.३८.५
बलाहक : सं०पु० (सं० बलाहक)। मेघ । मा० ६.८७.४
बलि : सं०० (सं.)। (१) दैत्यवंश का प्रसिद्ध राजा। सिबि दधीचि बलि ।' मा० २.३०.७ (२) देवोपहार, नैवेद्य, भेंट । 'बैनतेय बलि जिमि यह काग ।' मा० १.२६७.१ (३) यज्ञ में पशु बध । 'मैं एहिं परसु काटि बलि दीन्हे ।' मा० १.२८३.४ (४) न्योछावर । 'भइ बड़ि बार जाइ बलि मै आ ।' मा० २५३.२ (५) अव्यय (प्रा० क्ले) । भला बिचार तो करो कि । 'है निर्गुन सारी बारीक बलि ।' कृ० ४१
बलिछरन : वि०पु० । दैत्यराज बलि को छलने वाले । विन० २१५.३
_______________________________________________
695
बलित : भूकृ०वि० (सं० वलित)। वक्र, लहरदार । 'मंजु बलित बर बेलि बिताना ।' मा० २.१३७.६
बलिवान : सं०पू० (सं०) । उपहार विशेष जिसे देवबलि, पितबलि और भूतबलि (पशु-पक्षियों को देय अन्न आदि) भेदों में विभक्त किया है। गी० १.५.४
बलिपसु : यज्ञ में देवोपहार हेतु मारा जाने वाला पशु । मा० २.२२.२
बलिभागा : (सं० बलिभाग) प्रत्येक देवादि के उपयुक्त नैवेद्य का पृथक-पृथक् अंश (दे० बलिदान) । मा० २.८.५
बलिहारी: (१) (दे० बलि) न्योछावर । "रति सतकोटि तासु, बलिहारी ।' मा० ३.२२.६ (२) मैं न्योछावर हो जाऊँ, धन्य हो (मुहावरा)। 'जैसे हो तैसे सुखदायक अजनायक बलिहारी।' कृ०६
बली : बलवान (सं० बलिन्) । मा० ६.७८.८
बलीमुख : सं०० (सं० वलीमुख)। वानर (सिकुड़न युक्त मुख वाला) । मा० ६.४६.७
बलु : बल+कए । 'हरि माया बल जानि जियें ।' मा० १.५१
बलैया : सं०स्त्री० (अरबी--बलैयत= बलया) । ब्याधि, दुःख, दुश्चिन्ता (अपने ऊपर लेने का मुहावरा है)। 'राय दसरस्थ की बलया लीजै आलि री।' कवि० २.१२
बल्लभ : सं०+वि.पु. (सं० वल्लभ)। (१) प्रिय। 'समर भूमि भए बल्लभ प्राना।' मा० ६.४२.८ (२) पति । 'बल्लभ गिरिजा को।' विन० १.२.११ (३) श्रेष्ठ, महान् ।
बल्लभहि : वल्लभा को, प्रिय पत्नी को। 'को विबेकनिधि बल्लभहि तुम्हहि सका उपदेसि ।' मा० २.२८३
बल्लभा : बल्लभ+स्त्री० । प्रिया, पत्नी । गी० ३.१०.२
बल्लभी : बल्लभा । कृ० २२
बल्लव : सं.पुं० (सं०) । अहीर।
बल्लवी : बल्लव+स्त्री० । अहीरनी ।
बल्ली : सं०स्त्री० (सं० वल्ली) । लता। दे० भुजबल्ली । गी० २.४६.३ बिब
बवह : आ०ए० (सं० वपति>प्रा० ववइ)। बोता है। 'बवै सो लुन निदान ।' वैरा० ५
बवहिं : आप्रब० (सं० वन्ति>प्रा० वर्वति>० वर्हि)। बोते हैं । दो. ४८७
बवा : भक०० (सं० उप्त>प्रा० वविध)। बोया । बवा सो लनि ।' मा० २.१६.५
