_______________________________________________
377
झुलाइ : पूकृ० । झुला कर, झले पर आन्दोलित कर । 'मथुर झुलाइ मल्हावहीं ।' गी० १.२२.१०
झुलाव, झुलावइ : (सं० दोलयति>प्रा० झुल्लावइ-आन्दोलित करना) आ०प्रए० । झुलाता-ती है । 'कबहुं पालने घालि झुलावै ।' मा० १.२००.८
झुलावत : वकृ.पु । झूले पर आन्दोलित करता-ते । गी० १.१२.१ . .
झलावहिं : आ०प्रब० (सं० दोलयन्ति>प्रा० झल्लावहिं>अ० झुल्लावहिं)। झुलाते-ती हैं । 'झूलहिं झुलावहिं ओसरिन्ह ।' गी० ७.१८.५
झुलावै : झुलावइ । 'पालने रघपति झुलावै ।' गी० १.२३.१
झुलावौं : आ०उए । झुलाऊँ । 'पोढ़िए लालन पालने हौं झ लावौं ।' गी० १.१८.१
झूँठ : झूठ । मिथ्यावचन । 'जो कह झूठ मसखरी जाना।' मा० ७.६८.६ .
झूठ : वि० (सं० जुष्ट>प्रा० झुट्ठ) । मिथ्या। मा० ७.३६.७
झूठइ : मिथ्या ही । 'झुठइ भोजन झूठ चबेना । मा० ७.३६.७
झूठा : झूठ । धोखे से भरा, मिथ्या । जेहिं कृत कपट कनक मृग झूठ।' मा० ६.६६७ झूठि . झूठि+स्त्री० । झूठी, मिथ्या। 'झूठ न होइ देवरिषि बानी ।' मा० १.६८.७
झूठें : झूठे.. से । 'झूठे अघ सिय परिहरी ।' दो० १६६
झूठे : वि०पु०ब । निरर्थक, मिथ्या। 'देखे सुने भूपति अनेक झूठे झूठे नाम ।' गी० १.८७.२
झूठेउ : झूठ हो । 'झूठेउ सत्य जाहि बिनु जानें ।' मा० १.११२.१
झूठेहुँ : झूठमूठ भी। 'झूठेहुं हमहि दोष जनि देहू ।' मा० २.२८.३
झूठेहु : झूठेहुं । 'मो कहँ झूठेहु दोष लगावहिं ।' कृ० ४
झूठो : झूठा+कए० ! मिथ्या, निस्सार । 'झूठो है झूठो है झूठो सदा जग ।' कवि० ७.३६
झूने : वि०पु० (सं० झूर्ण, जूर्ण>प्रा० झुण्ण = झुण्णय) । झीने, झाँझरे । 'ओढ़िबो झने खेस को।' कवि० ७.१२५
झूमक : सं०० । राग विशेष, लोकगीत विशेष । 'चाँचरि झूमक कहैं सरस राग ।' गी० ७.२२.५
झूमत : वकृ० । झूमता-झूमते, घूर्णन करते । 'झूमत द्वार अनेक मतंग ।' कवि० ७.४४
झूमि : पूकृ० । पूणित होकर । कवि० ६.३१
झूरो : वि.पु.कए ० । सूखा । हनु० ३
झूलत : वकृ०० । झूले पर आन्दोलित होते । 'झूलत राम पालले सोहैं ।' गी० ११.२४.१
378
_______________________________________________
झूलन : भकृ० अव्यय । झूलने । 'राधी के रुचिर हिंडोलना झूलन जैए।' गी० ७.१८.१
झूलहिं : आ०प्रब० । झूलते-ती हैं । 'झूलहि झुलावहिं ओसरिन्ह ।' गी० ७.१८.५
झोंटी : सं०स्त्री० (सं० झुण्ट>प्रा० झुटी= झोंटी) । उलझा हुआ। केशसमूह । मा० २.१६३.७
झोटिंग : सं०० (सं० जोटिङ्ग)। शिव, शिवीपासक श्मशानसाधक योगी+ झोंटाधारी। 'प्रथम महा झोटिंग कराला।' मा०६.८८.१
झोपरी : सं०स्त्री० (प्रा० झुपड़ी) । झोंपड़ी, कुटी, तृणकुटीर । 'ख्याल लंका लाई कपि राड़ की सी झोपरी ।' कवि० ६.२७
झोरी : संस्त्री० (सं० झोलिका>प्रा० झोलिआ>अ० झोली)। लम्बी थेली। ओझरी की झोरी काँधे ।' कवि० ६.५०
झोलिन्ह : झोली-+संब० । झोलियों (में) । 'झोलिन्ह अबीर पिचकारि हाथ।' गी० ७.२२.२
झोसिमत : वक० पुंकवा० । झुलसे जाते । 'तात तात तोंसित झौंसित झारहीं।' कवि० ५.१५

## ट

टँकोर, टँकोरा : सं०स्त्री० (सं० टं+कोर-कुर शब्दे+घन) । टंकार इवनि । मा. ३.१६ छं०
टँकोरा : टकोर । मा० ६.६८.२
टंकिका : सं०स्त्री० (सं.)। टांकी, पत्थर आदि काटने की छेनी । दो० ३४२
टई : (१) सं०स्त्री० (सं० तय गतो) । चाल, चालाकी । 'करत फिरत बिनु टहल टई है।' विन० १३६.७ (२) बाधा, आतङ क । 'भृगुपति की टारी टई ।' गी० ५.३७.४
टकटोरि: पू० । टटोल कर, स्पर्श से देखभाल कर । 'टकटोरि कपि ज्यों नारियरु सिरु नाइ सब बैठत भए ।' जा०म०७० ११
टकोर : टँकोर । 'ट' ध्वनि । 'प्रभु कोन्हि धनुष टकोर ।' मा० ३.१६ छं.
टर, टरइ, ई : (सं टलति-टल वैक्लव्ये>प्रा० टलइ-चलित होना, खिसकना, हटना) आप्रए । टलता है। (१) स्थान से हटता है। लगे उठावन टरइ न टारा।' मा० १.२५१.१ (२) मुकरता है, मुकर सके । 'तब मागेहु जेहि बचनु न टरई ।' मा० २.२२.७
टरत : वकृ०० । टलता-ते । 'नेम को निबाह एक टेक न टरत ।' विन० २५१.२
टरति : वक०स्त्री० । टलती, हटती । 'नयन नि आगे तें न टरति मोहन मुरति । कृ० २८
टरहिं, टरहीं : आ०प्रब० । टलते हैं, हटते हैं। 'प्रभुहि बिलोकहिं टरहिं न टारे।' मा० ६.४.७; ३.४०.६
टरिहै : आ०म०प्रए० (१) (सं० टलिष्यति>प्रा० टलिहिइ)। टलेगा। 'चातक ज्यों एक टेक ते न टरिहै।' विन० २६८.२ (२) (सं० टालयिष्यति>प्रा०. टालिहिइ) । टालेगा, हटायेगा। थपिहै तेहि को हरि जो टरिहै।' कवि. ७.४७
टरी : भूक०स्त्री० । टली, विचलित हुई (टूटी) । 'घोर धुनि सुनि सिव की समाधि टरी है।' गी० १.६२.५
टरे : भूकृ०पु । टले, हटे । मा० ५.३५ छं० १
टर : टरइ । 'टर न कपि चरन ।' मा० १.३४ क
टर् यो : भूकृ००कए० । टला, हटा । मा० ६.४७.६
टसकतु : व.पु.कए । टस-से-मस होता, स्थान से हिलता। 'न नेकु टसकसु है।' कवि० ६.१६
टहल : (१) सं०स्त्री० । घरेलू कामकाज । 'नीचि टहल घर के सब करिहौं।' मा०. ७.१८.७ (२) कार्य, प्रयोजन । 'करत फिरत बिन टहल टई है।' विन १३६.७
टांकी : टंकिका । 'जो पय फेनु फोर पबि टांकी।' मा० २.२८१.८
टाँच : सं०स्त्री० (सं० तञ्चा---तञ्चु गती)। चाल, चालाकी ।
टाँचन : टाँच+संब० । चालाकियों, वञ्चनाओं (से)। देह-जीव-जोग के सखा सब टाँचन टांचो।' विन० २७७.२
टाँचो : भूक.पुं०कए । ठगा, प्रतारित किया। विन० २७७.२
टाँठे : क्रि०वि० । टाँठ-कठोर होकर, उग्रता के साथ । 'कोमल काज न कीजिए टाँठे।' कवि० ६.२८
टाक : सं०पू० (सं० ट) । चौथाई खण्ड । 'राम नाम लेत मागि खात टूक-टाक हौं।' हनु० ४०
टाट : सं० । बोरा, सन का फट्ठा। 'सिअनि सुहावनि टाट पटोरें।' मा० १.१४.११
380
_______________________________________________
टाटिका : (१) सं०स्त्री० (सं० तटिका>प्रा० तट्टी) । टट्टी, वृति । (२) छप्पर का ठाट जिस पर फूस छाया जाता है । 'बिरचि हरि भगति बर टाटिका कपट दल हरित पल्लवनि छावौं ।' विन० २०८.२
टाप : सं०स्त्री० । घोड़े का खुर । 'टाप न बूड़ बेग अधिकाई।' मा० १.२९६.७
टारति : वक.स्त्री० । हटाती (बिताती) । 'सीय निमेष कलप सम टारति ।' गी०
टारन : भ०० अव्यय । टालने (को); खिसकाने (को)। 'दीप बाति नहिं टारन कहऊ ।' मा० २.५६.६
टारा : भूकृपु । हिलाया-डुलाया, हटाया (हुआ) । 'टरइ न टारा।' मा. १.२५१.१
टारि : पूक टाल, हटा (कर ) । 'भ्रम न सकइ कोउ टारि ।' मा० १.११७
टारी: (१) टारि । 'जौं मम चरन सकसि सठ टारी।' मा० ६.३४.६ (२) भकृ. स्त्री० । हटाई । 'ईस अनेक करवरें टारी ।' मा० १.३५७.१
टारें : टालने, हटाने से । न चाप सज्जन बचन जिमि टारें टरै।' जा०म०छं० ११
टारे : भूक००० । हटाये । 'प्रभुहि बिलोकहिं टरहिं न टारे ।' मा० ६.४.७
टारेउ : भूकृ.पु०कए० । टाला, विचलित किया । 'छल करि टारेउ तासु ब्रत।' मा० १.१२३
टार् यो : टारेउ । 'भवतरु टरै न टार्यो।' विन० २०२.२
टाहली : वि.पु । टहलुआ, टहल करने वाला, घरेलू सेवक । 'सबनि सोहात है सेवा सुजान टाहली।' कवि० ७.२३
टिट्टिभ : सं०० (सं०) । टिटिहरी पक्षी । मा० ६.४०.६
टिपारे : सं००ब० । चौतनियां, टोपियाँ । 'सीसनि टिपारे, उपबीत पीत पट _ कटि ।' गी० १.७१.१
टिपारो : सं००कए । टोपी, चौतनी । गी० १.४३.२
टीका : (१) सं०पु० (प्रा० टिक्क) । तिलक (राजतिलक, राज्याभिषेक) । 'करहु हरषि हिय रामहि टीका।' मा० २.५.३ (२) श्रेष्ठ, सर्वोत्तम (तिलक के समान सुशोभित) । 'रावनु जातुधान कुल टीका।' मा० ६.३८.६
टीड़ी : सं०स्त्री० । टिड्डी; पतिंगा विशेष जो समूह में उड़कर खेती आदि पर टूटता और खा जाता है । मा० ६.६७.२
टुक, टूक : वि० (सं० स्तोक) ! थोड़ा, छोटा, खण्ड । 'पंख करो टुक टूक ।' दो० २८२, टुक । (१) टुकड़ा, खण्ड । दो० २८२ (२) रोटी का टुकड़ा, चौथाई रोटी । 'खाए टूक सब के ।' कवि० ७.७३
टूकनि, टूकन : टूक+संब० । टुकड़ों. रोटी के खण्डों। 'कूकर टूकनि लागि ललाई।' कवि० ७.५७
_______________________________________________
381
टूका : टूक । खण्ड । 'अजहुं न हृदय होत दुइ टूका ' मा० २.१४४.६
टूकु : टूक+कए । एक टुकड़ा, एक भी खण्ड । 'चाहै चारु चीर पं लहै न टुकु ____टाट को।' कवि० ७.६६
टूट : (१) भूकृ०० (सं० त्रुटित>प्रा० तुट्ट)। भग्न हो गया। 'छुअत टूट रघुपतिहि न दोषू ।' मा० १.२७२.३ (२) टूटइ । 'टूट न द्वार परम कठिनाई।' मा० ६.४३.४
टूट, टूटइ : (सं० त्रुट्यति>प्रा. तुट्टइ-टूटना, विच्छिन्न होना) आ.प्रए । टूटता है।
टूटत : वकृ००। (१) भग्न होता, होते । 'टूटत ही धनु भयउ बिबाहू ।' मा० १.२८६.८ (टूटते ही) (२) आक्रमण करता-ते । 'टूटत अति आतुर अहार बस ।' विन० १०.३
टूटि : (१) पूकृ० । टूट कर । गी० २.५८.२ (२) भूकृ०स्त्री० । टूटी हुई। .
टाटियौ : टूठी हुई भी । 'टूटियो बांह गरे परै ।' विन० २७१.४
टूटिहि : आ०भ०प्रए । टूटेगा। 'अवसि राम के उठत सरासन टूटिहि ।' जा०म०६१
टूटें : टूटने से, टूटने पर । 'होइहहिं टूटें धनुष सुखारे ।' मा० १.२३६.३
टूटे : (१) भूकृ०पु० ब० । भग्न हुए । 'उर लागत मूलक इव टूटे ।' मा० ६.२५.६ (२) टूटें । टूटने पर । 'श्रीहत भए भूप धनु टूटे ।' मा० १.२६३.५
टूटेउ : भूकृपु०कए । भग्न हो गया । 'टूटेउ कुबर फूट कपारू ।' मा० २.१६३.५
टूटै : टूटइ । टूट सके । 'माधव मोह फांस क्यों टूट ।' विन० ११५.१
टूट्यो : टूटे उ । कवि० १.१०
टेंक : टेक । मा० २.३२४ ।
टेई : भूकृ०स्त्री० । तेज की, पैनाई । 'कपट छुरी उर पाहन टेई।' मा० २.२२.१
टेक, टेका : सं०स्त्री० । (१) दृढ़ आग्रह । 'सकइ को टारि टेक जो टेकी।' मा० २.२५५.८ (२) स्थिरता। 'साधन कठिन न मन कह टेका।' मा० ७.४५.३ (३) आश्रय, आधार, अवलम्ब । 'सोक सरि बूड़त करीसहि दई काहु न टेक।' विन० २१७.३ (४) उपाय (मार्ग) । 'जैबे को अनेक टेक, एक टेक दबे की।' कवि० ७.८२
टेकि: पूक० । सहारा लेकर । 'जानु टेकि कपि भूमि न गिरा।' मा० ६.८४.१
टेकी: (१) टेकि । पकड़ कर (आग्रह करके, ग्रहण करके) । 'भरद्वाज राखे पद टेकी।' मा० १.४५.४ (२) भूकृ०स्त्री० । पकड़ी, ग्रहण की। 'सकइ को टारि टेक जो टेकी।' मा० २.२५५.८
382
_______________________________________________
टेढ़ : वि० सं० तिर्यक+अर्घ>प्रा० तियड्ढ) । वक्र, कुटिल । 'टेढ़ जानि सब बंदइ काहू ।' मा० १.२८१.६
टेढ़ी : वि.स्त्री० । वक्र । 'तिलक भाल टेढ़ी भौहैं।' गी० १.६३.३.
टेढ़े : वि०० (बहु०) । 'सूधे टेढ़े सम विषम ।' दो० ५००
टेपारो : टिपारो। 'तनियाँ ललित कटि बिचित्र टेपारो सीस ।' कु० २
टेरत : वक.पु । पुकारता, पुकारते । 'भुज उठाइ ऊँचे चढ़ि टेरत ।' गी. २.१४.१
टेरि : (१) पू । पुकार कर । 'अरु हौंहु कहत हौं टेरि ।' विन० १६०.७ (२) आ०-आज्ञा-मए । तू पुकार । 'टरि कान्ह गोबर्धन चढ़ि गया।' कृ० १६
टेरी : भूकृ.स्त्री० । पुकारी । 'प्रानबल्लभा टेरी।' गी० ३.१०.२
टेरें : पुकार कर । 'तेहि तें कहहिं संत श्रुति टेरें ।' मा० १.१६१.३
टेरे : (१) भूक००० । पुकारे, बुलाये । मा० १.६३.४ (२) टेरें । पुकारने से। 'अभय किये 'बारक बिबस नाम टेरे।' विन० १३८.१ (३) पुकार कर । 'भज उठाइ कहौं टेरे।' विन० २२७.१
टेव : सं०स्त्री० । स्वभाव, प्रकृति । 'या की टेव लरन की।' क०८
टेवैया : वि० । देने वाला, पैना करने वाला, तेज करने वाला।' 'कोटि जलच्चर . दंत टेवैया ।' कवि० ७.५२
टोटक : सं०० (सं० त्रोटक । रोगनिवारण आदि के हेतु ओझा आदि द्वारा कराया हुआ तान्त्रिक उपायविशेष जिसमें भोजन आदि कोई अभिमन्त्रित वस्तु को चौराहे आदि पर रख आते हैं, फिर घूम कर नहीं देखते। 'स्वारथ के साथिन्ह तज्यो तिजरा को सो टोटक, औचट उलटि न हेरो।' विन० २७२.२
टोटकादि : त्रोटक आदि तान्त्रिक उपाय । हनु० ३०
टोने : 'टोना' का रूपान्तर । हिमालय की थारू जाति के जन्तर-मन्तर को 'टोना' कहते हैं जिसमें मारण, वशीकरण आदि की क्रिया होती है। वशीकरण आदि का मन्त्रविशेष । 'प्रभु किधौं प्रभु को प्रेम पढ़े प्रगट कपट बिन टोने ।' गी० २.२३.३
टोलू : सं०० (टोल+कए०) । टोली, सजातीय दल । 'देखि निषादनाथ निज टोलू ।' मा० २.१६२.३ (प्रा० 'टोल' टिड्डीदल का अर्थ देता है)
_______________________________________________
383
## ठ
ठई : भूक०स्त्री० (सं० स्थापिता>प्रा० ठविआ)। (१) स्थिर की, ठहरायी । 'को जाने चित कहा ठई है।' विन० १३६.७ (२) रखी। 'सो तो कछु एको चित न ठई।' कृ० ३६ (३) स्थित हुई, ठनी । 'ठवनि भली ठई है।' गी. १.६६.२
ठए, ठये : भूक००ब० । ठाने, आरम्भ किये । 'समय सम गान ठए ।' गी० १.३.२
ठकुरसोहाती : सं०स्त्री० । स्वामी (ठाकुर) को अच्छी लगती (सोहाती) हुई बात = चाटुकारिता, चापलूसी । 'हमहं कहबि अब ठकुरसोहाती।' मा० २.१६.४
ठकुराइनि : ठाकुर+स्त्री० । स्वामिनी । कवि० ७.१७०
ठकुराई : सं०स्त्री० । स्वामित्व, राज्य । 'अब तुलसी गिरिधर बिनु गोकुल कौन करिहि ठकुराई ।' कृ० ३२
ठग : सं०पू० (सं० ठक>प्रा. ठग) । वञ्चक, धोखा देकर लूटने वाला । मा० १.७६.७
ठगति : ठग+वकृ०स्त्री० । ठगती, वञ्चित करती। गी० २.८२ ३
ठगि : (१) पूक० । लुटकर, ठगे जाकर, ठक्क होकर, निस्तब्ध होकर । 'तेउ यह चरित देखि ठगि रहहीं।' मा० ७.६.६ (२) ठगी। 'ठगि सी रहो।' कवि० १.१ (३) ठगे । 'रहे ठगि से नृपति ।' गी० १.५१.१
ठगिनि, ठगिनी : ठग+स्त्री० । गी० २.८२.३
ठगी : ठग+भूक०स्त्री० । ठग ली गई, धोखा खा गई, स्तब्ध रह गई । 'तुलसिदास  ग्वालिनी ठगी। कु० ८
ठगु : ठग+कए । अद्वितीय वञ्चक । 'भलो ठग्यो ठगु ओही।' कृ. ४१
ठगे : भूक००ब० । लुट गये, स्तब्ध (लुटे-से)। 'बिलोकि सुर नर मुनि ठगे।' मा० १.३१६ छं० ठगोरी
ठगोरी : ठगौरी । 'तुलसिदास ग्वालिनी ठगी-सी, आयो न उतर कछ, कान्ह ठगोरी लाई ।' कृ० ८ सं०स्त्री० (सं० ठक-पुटी>प्रा० ठगउड़ी)। ठग द्वारा दी हुई बिसली पुड़िया जिससे मूछित करके ठगी का काम करता है । मोहनी । 'नखसिख अंगनि ठगोरी ठोर ठौर हैं।' गी० १.७३.४
ठग्यौ : भूक.पुं०कए । ठग लिया, धोखे में डालकर लूट लिया । 'भलो ठग्यो ठगु ओही।' क° ४१
ठट : सं०० (प्रा० थट्ट समूह) । झुड । 'उनेह सिथिल गोप गाइन्ह के ठट हैं।' कृ० २०
384
_______________________________________________
ठटहिं : आ०प्रब० । सजाते हैं, जुगाड़ बनाते हैं। 'ठटहिं जे कूर कुठाट ।' दो० ४१७
ठदु : ठट+कए० । बनाव, साजसवार । गी० १.८०.३
ठटुकि : पूकृ० । अचानक रुके रह कर, ठहर कर । 'ठटुकि रहे एक टक पल रोकी।' - मा० ५.४५.३
ठटो : आo-आज्ञा-मब० । बनाओ । 'नट ज्यों जान पेट-कुपेटक कोटिक चेटक कौतुक ठाट ठटो।' कवि० ७.८६
ठट् टा : ठट । 'मर्दहु भालु कपिन्प के ठट्ठा।' मा० ६.७९.११
ठठई : सं० स्त्री० । ठट्टापन, हँसोड़पन, परिहास+नि:सार तथा रूक्ष व्यवहार। 'हरि परे उरि सँदेसह ठठई ।' कृ० ३६
ठठाइ : पू० । ठट्ठा मारकर, ठहाका लगाकर । 'हंसब ठठाइ फुलाउब गालू ।' मा० २.३५.५
ठठाइयत : वक०-कवा०-० । ठोंका जाता, ठोंके जाते; आहत किये जाते। 'खाती दीपमालिका ठठाइयत सूप हैं।' कवि० ७.१०१
ठनियत : वकृ.पु.कवा । ठाना जाता, किया जा रहा । 'दीनबंधु द्वारे हठ, ठनियत है ।' विन० १८३.३
ठनी : भूक०स्त्री० । ठन गयी, होने लगी। 'राम कृपा और ठनी।' गी० ५.३६.२
ठयऊ : भूक पु०कए० (सं० स्थापितम् >प्रा० ठवियं>अ० ठवियउ) । ठाना, __ आरम्भ किया, स्थापित किया, निश्चित किया। ‘एहि बिधि हितु तुम्हार मैं ठयऊ।' मा० १.१३३.२
ठयो : ठयऊ। (१) ठाना, निश्चित किया । 'तब यह मंत्र ठयो।' गी० १.४७.२ (२) सजाया, बनाया । 'चतुर जनक ठयो ठाट इतौ री।' गी० १.७७.३
ठवनि : सं०स्त्री० (सं० स्थापना>प्रा० ठवणा>अ० ठवणी-ठवणि) । (१) खड़े होने में पैरों की विशेष स्थिति । 'ठवनि जबा मगराज लजाएँ।' मा० १.२५४.८ (२) बनाव, साज सँवार । 'समय समाज की ठवनि भली ठई है।' गी० १.९६.२ (३) सदृश स्थिति । 'लंक मगपति ठवनि ।' गी० ७.५.२ ।।
ठहर : सं० स्थान । 'ठहर ठहर परे कहरि कहरि उठे ।' कवि० ६.४२
ठहरानी : भूक० स्त्री० । ठहरी, स्थिर हुई, निश्चित की जा सकी। 'एकउ जुगुति न मन ठहरानी।' मा० २.२५३.७
ठहरु : ठहर+कए । एक भी ठिकाना, आश्रय ! 'जो पै मो को होतो कहूं ठाकुर ठहरु ।' विन० २५०.१
ठही : भूकृ० स्त्री०=ठई । ठहरी, व्याप्त हो रही। 'लागि दवारि पहार ठई।' कवि० ७.१४३
ठाँव : ठावें। विन० १५१.३
_______________________________________________
385

ठाउँ, ठाऊँ : (१) सं०पु०कए० (सं० स्थाम>प्रा० ठामं>अ० ठावु) । स्थान । 'लै रघुनाथहिं ठाउँ देखावा ।' मा० २.८६.५ (२) पद । 'पायउ अचल अनुपम ठाऊँ ।' मा० १.२६.५ (३) आश्रय, सहारा । 'जग दूसरो न ठाकुर न ठाकुर ठाऊँ।' विन० १५३.१
ठाकुर : सं०पू० (सं० ठक्कुर) । स्वामी, राजा । कवि० ७.१७०
ठाट : ठट । (१समूह, प्रबन्ध, बन्धान । 'चेटक कोतुक ठाट ठटो।' कवि० ७.८६ (२) बनाव, साज । 'चतुर जनक ठयो ठाट इतो री ।' गी० १.७७.३
ठाटहु : आ०मब० । ठीक-ठाक करो, जमाओ, सजाओ। 'ठाटहु सकल भर के ठाटा।' मा० २.१६०.१
ठाटा : (१) भूकृ.पु । गूथ दिया, जमा दिया। 'सुख महं सोक ठाटु धरि ठाटा।' मा० २.४७.५ (२) ठाट । 'ठाटहु सकल भर के ठाटा।' मा० २.१६०.१
ठाटिबो : भकृ०पु०कए० । सजाना, रचना, ठाट बनाना । 'काया नहिं छाड़ि देत ठाटिबो कुठाट को।' कवि० ७.६६
ठाटु, ठाटू : ठाट+कए । (१) साजबाज, बन्धान । 'सुख महं सोक ठाटु धरि ठाटा।' __ मा० २.४७.५ (२) प्रबन्ध, तैयारी । 'करहु कतहुं अब ठाहर ठाटू ।' मा० २.१३३.१
ठाढ़ : भूकृ०० (सं० स्तब्ध>प्रा. ठड्ढ) । खड़ा, खड़े । 'ठाढ़ भए उठि सहज सुभाएँ।' मा० १.३६०.५
ठाढ़ा : ठाढ़+कए । 'अहमिति मनहुं जीति जगु ठाढ़ा।' मा० १.२८३.६
ठाढ़ि : ठाढ़ी । 'सुनि सुर बिनय ठाढि पछिताती।' मा० २.१२.१
ठाढ़ीं : ठाढ़ी+ब० । खड़ी हुई । 'मंगल द्रब्य लिएँ सब ठाढ़ीं।' मा० १.२८८.६
ठाढ़ी : ठाढ़+स्त्री० (सं० स्तब्धा>प्रा० ठड्ढी) । खड़ी। 'नयनन्हि नीरु रोमावलि ठाढ़ी।' मा० १.१०४.२
ठाढ़ें : क्रि०वि० । खड़े-खड़े, स्तब्ध होकर । 'काहुं न लखा देख सबु ठाढ़ें।' मा० १.२६१.७
ठाढ़े : भूकृ००ब० । खड़े । मा० १.१४५.१
ठाढ़ेइ : खड़े ही । 'पंचबटी पहिचानि ठाढ़ेइ रहे।' गी० ३.१०.१
ठाढ़ो : ठाढ़ा । 'रावन भवन चढ़ि ठाढ़ो तेहि काल भो ।' कवि० ५.४
ठाना : भूकृ० । चालू किया। 'सुनि बचन सुजाना रोदन ठाना।' मा० १.१६२ छं०
ठानि : (१) पूकृ० । ठान कर, निश्चित कर । 'मरनु ठानि मन रचेसि उपाई।' मा० १.६६.५ (२) आ० -आज्ञा-मए । तू ठान कर। 'भजहि ऐसे प्रभुहि तुलसी कुटिल कपट न ठानि ।' विन० २१५.७
386
_______________________________________________
ठानी : (१) भूक०स्त्री० । आरम्भ की। 'अति निर्मल बानी अस्तुति ठानी।' मा० १.२११ छं० २ (२) ठानि । ठान कर । गी० १.४.२
ठायँ : स्थान पर । ते लजात होत ठाढ़े ठायँ ।' विन० ८३.६
ठालीं : ठाली+ग० । 'ठालों ग्वालि जानि पठए अलि कह्यो है पछोरन छूछो। क० ४३
ठाली : वि० स्त्री० । निठल्ली, ठलुई, निकम्मी (जिसे कुछ काम न हो) । 'ठाली ग्वालि ओरहने के मिस आइ बकहि बेकाहिं। क० ५
ठाव: ठाय । स्थान पर । 'ठा ठाव राखे अति प्रीती।' मा० २.१०.३
ठाव : सं०० (सं० स्थाम= स्थान प्रा० ठाम>अ० ठा) स्थान । 'ठावहिं ठाउँ बझाऊ रे ।' विन० १८९.४ (ठावहिं ठाउँ स्थान ही स्थान प्रत्येक स्थान)
ठाहर : ठहर । ठहराव, स्थान । करहु कतहुं अब ठाहर ठाटू ।' मा० २.१३३.१
ठाहरु : ठाहर+कए० । (१) स्थान (अङ्ग, भाग) । ‘मरम ठाहरु देखई।' मा० २.२५ छं० (२) अवसर । 'जूझिबे जोगु न ठाहरु ।' कवि० ६.२८ (३) आश्रय, अवलम्ब । 'तुम्ह ही बलि हो मो को ठाहरु हेरे।' कवि० ७.६२
ठीक : (१) सं०स्त्री० । ठेका, ठहराव, स्थिरता, विराम, निश्चय । 'नीके के ठीक दई तुलसी ।' कवि० ७.८८ (२) वि० । स्थिर, निश्चित, उचित । 'ठीक प्रतीति कहै तुलसी ।' कवि० ७.१३१ (३) व्यवस्थित, समञ्जस । 'करम बचन मन ठीक लेहि, तेहि न सके कलि धूति ।' दो० ८८
ठीका : ठीक (सं० स्थितिका>प्रा० ठिइक्का) । ठहराव, धैर्य, निश्चय, दृढ़ता। 'करि बिचारु मन दीन्ही ठीका।' मा० २.२६६.७
ठुमुक : बच्चों की गति चेष्टानुकरण, ठहर ठहर कर कर निरन्तर चाल । 'ठुमुकु तुमुकु प्रभु चलहिं पराई ।' मा० १.२०३.७
ठूठ : सं०० । स्थाण, पत्रादिरहित वक्ष । 'सेवत कलि तरु ठूठ।' दो० ७६
ठेकाने : 'ठेकाना' का रूपान्तर । टिकाव, आधार, स्थान । 'बड़े ठेकाने ठौर को हौं।' विन० २२६.३
ठेलि : पूक० । ठेल कर, धकिया कर, धक्का दे देकर । 'ढकनि ढकेलि पेलि सचिव चले ल ठेलि।' कवि० ५.८
ठोकि: पूक० । ठोक बजा कर, पात्रादि पर 'ठों' ध्वनि के साथ आघात देकर, परीक्षा करके । 'ठोंकि बजाइ लखे गजराज ।' कवि० ७.५४ (२) आघात देकर । 'ठोंकि ठोंकि खये।' गी० १.४५.२
ठोरी : क्रि०वि० । संगम दशा में, स्थान पर । 'छबि सिंगार मनहुँ एक ठोरी।' मा० १.२६५.७
ठोसु : ठोस+कए० । अन्त:सार युक्त, दृढ़, भरा हुआ । 'राम प्रीति प्रतीति पोली, कपट कर तब ठोसु।' विन० १५६.१
_______________________________________________
387
ठौर : सं००। (१) स्थान । 'ठोर ठौर दीन्ही आगि।' कवि० ५.३ (२) आश्रय । ___नाहिन ठोर कहूं।' विन० ८६.१
ठोरी : ठोरी । 'लोचन लाहु ल ह्यो एक ठोरी ।' गी० १.१०४.३
ठौर : ठोर+कए० । एक भी स्थान, आश्रय । 'औरु कहाँ ठोरु रघुबंसमनि मेरे ।' विन० २१०.१
## ड
डग : संपु । पदविक्षेप, एक पदक्रम । 'धरि धीर दए मग में डग द्वै।' कवि० २.११
डिग, डगइ : आ.प्रए । चलित होता है, हिलता है, स्थान से कुछ चलता है । ___'हगइ न संभु सरासन कसें ।' मा० १.२५१.२
डगत : व.पु. । विचलित होता-ते, लड़खड़ाता-ते । 'चूड़त लखि पग डगत लखि।' दो० ५२०
डगति : डगत+स्त्री० । हिलती । 'डोलति नहिं डगति ।' गी० २.८२.२
़डगमगत : वकृ०० । लड़खड़ाता-ते, हिलता-ते । मा० ६.७०.८
डगमहि, डगमहीं : आ०प्रब० । हिलते-डोलते हैं। 'छभित पयोधि कुधर डगमगहीं ।' मा० ६.७.६
डगमगानि : भकृ०स्त्री० । हिल-डोल गयी; काँप उठी। 'डगमगानि महि दिग्गज डोले ।' मा० १.२५४.१
डगमगाहिं : डगमगहिं । मा० ५.३५.१०
डगमगे : भूक००ब० । डांवाडोल हो गये। मा० ६.८६ छं०
डगरि : पूकृ० । डगर पर चलकर, राह पकड़ कर, अपना रास्ता लेकर । 'डगरि चले हंसि खेलि ।' कृ० २६
डगरो : सं०पु०कए । मार्ग । 'रामभजन..... मोहि लगत राज-डगरो सो।' विन० १७३.५
डगहिं, डगहीं : आ०प्रब० । चलित या च्युत होते हैं । 'डगहिं न ताल बंधान ।' मा० १.३०२ (२) कम्पित होते हैं, लड़खड़ाते हैं । 'चलत कटक दिगसिंधुर डगहीं।' मा० ६.७६.६
388
_______________________________________________
डगि : पू० । डगमगा कर, लड़ाखड़ा कर । 'सिथिल अंग पग मग डगि डोलहिं ।। मा० २.२२५.४
डगे : भक० ब० । हिले, डगमगाए । 'डगे दिगञ्जर ।' कवि० ६.७
डग्यो : भक०० कए । हिला । 'डग्यो न धनु ।' गी० १.८६.७
डटया : वि० । डाँटने वाला । कौन सुने चहुं ओर डटया ।' कवि० ७.५१
डफ : सं० । ढपली, वाद्य विशेष । खजड़ी जैसा एक बाजा ।
डफतार : डफ । ताल देने वाली ढपली । गी० १.२.१३
डफोरि : पूकृ० । डफार लगाकर, हाँक देकर, ललकार भरी पुकार देकर । 'तुलसी त्रिकूट चढ़ि कहत डफोरि के।' कवि० ५.२७
डमरु, डमरू : सं०० (सं.) । वाद्य विशेष । मा० १.६२.५
डमरुआ : सं०० (सं० डमरूक)। एक रोग जिझमें गांठें सूज कर डमरू के समान हो जाती हैं। 'अहंकार अति दुखद डमरुआ।' मा० ७.१२१.३५
डर : सं० (सं० दर>प्रा० डर)। मा० १.२१८.५ (२) भय का कारण । 'एकहि डर डरपत मन मोरा ।' मा० १.१६६.८
डर, डरइ : आ०प्रए । डरता है । 'कान्ह डरै तेरे डर तें।' कृ० १७
डरउँ, डरऊँ : आ. उए । डरता-ती-हूं। 'बसउ भवन उजरउ, नहिं डरऊँ।' मा० १.८०.७
डरत : वपु । डरता, डरते । 'तव भय डरत सदा सोउ काला।' मा० ३.१३.८
डरनि : (१) सं०स्त्री० । डरने की क्रिया । (२) डर+कए । डरों (से) । हार्यो हिय खारो भयो भूसुर डरनि ।' विन० २४७.३
डरपत : व.पु. (सं० दर+आत्मन् >प्रा० हरप्प)। अपने आप में डरता-डरते। 'एकहिं डर डरपत मन मोरा ।' मा० १.१६६.८
डरपति : वक०स्त्री० । अपने आप में भय खाती। ता तें तेहि डरपति अति माया।' मा० ७.११६.५
डरपसि : आ०मए० । तू स्वत: डरे। 'जनि सनेह बस डरपसि भोरें।' मा० २.५३.८
डरपहिं : आ०प्रब० । स्वत: डर जाते हैं । 'डरपहिं धीर गहन सुधि आएँ। मा० : २.८३.४
डरपहि : डरपसि । 'जनि डरपहि।' विन० ८४.४
डरपहु : आ० मब० । स्वत: (अपने आप ही-अकारण) डरो। 'जनि डरपहु सुर सिद्ध सुरेसा।' मा० १.१८७.१
डरपाव, डरपावई : आ०प्रए० । अपने आप ही, अकारण, भय देता है। 'उत्पाद __ गहि स्वल्प सपेला ।' मा० ६.५१.८
डरपे : भूक ०ब० । स्वतः डर गये । 'डरपे सुर भए असुर सुखारी।' मा० १.८७.७.
_______________________________________________
389
डरहिं, डरहीं : आ० (१) प्रब० । (वे) डरते-ती हैं । 'कालहु डरहिं न रन रघुबंसी।' मा० १.२८४.४ (२) उब० । (हम) डरते-ती-हैं । 'तिय सुभायें कछु पूछत डरहीं।' मा० २.११६.६
डरहि, डरही : आ०मए । तू डरता है। 'बायस इव सब ही तें डरही।' मा० ७.११२.१४
डरहु : आमब० । तुम डरते हो । 'डरहु दरिद्रहि पारसु पाएँ ।' मा० २.२१०.२
डरहुगे : आ०भ००मब० । डरोगे । 'कुटिल मन मलिन जिय जानि जो डरहगे।' विन० २११.४ ।
डरि : प्रकृ० । भय खा कर । 'बिदा भई देबी सों जननि डर डरिक ।' गी० २.७२.४
डरिबे : भक०० डरना । 'लौकिक डर डरिबे हो ।' कृ० ३६
डरिये : आ.भावा० । डरा जाय, डरना पड़ता है। निज आचरन बिचारि हारि हिय मानि जानि डरिये ।' विन० १८६.१
डरिहैं : आ०भ०प्रब० । डरेंगे । 'डरिहैं सास ससुर चोरी सुनि ।' क० १३
डरिहै : आ०भ० प्रए० । डरेगा । 'सपनें नहिं कालहु तें डरिहै।' कवि० ७.४७
डरी : भूकृ०स्त्री०ब० । डर गयीं। तासु बचन सुनि ते सब डरौं ।' मा० ५.११.८
डरु : (१) डर-+कए। एकमात्र भय । 'मन डरु लोचन लालची।' मा० १.४८ (२) आ० आज्ञा-मए । तू डर । 'रामहि डरु करु राम सों ममता प्रीति प्रतीति ।' दो० ६५
डरे : भकृ००ब० । डर गये । 'डरे कुटिल नृप प्रभु हि निहारी। मा० १.२४१.६
डरेउँ : आo-भूक००+उए । मैं डर गया। 'अपभय डरेउँ न सोच समूलें।' मा० २.२६७.३
डरेउ : भकृपु०कए० । डर गया। निज भयँ डरेउ मनोभव पापी ।' मा० १.१२६.७
डरैं : डरहिं । 'कबहूं प्रतिबिंब निहारि डरैं।' कवि० १.४
डरा : डरइ । 'सो परि डरै मरै रजु अहि तें।' विन० १८८.५
डरैगी : आ०भ० स्त्री०प्रए । भयभीत होगी। हनु० २५
डरौं : डरउँ । (१) डरता हूँ। लेहि तें बूझत काजु डरौं ।' जा०म० २२ (२) डरूँ, _ डरता होऊँ । 'अनघ नाम अनुमानि डरौं ।' विन० १४१.१
डर् यो : डरेउ । 'भव भय बिकल डर्यो।' विन० ६१.४
डसत : वकृ०० (सं० दशत् >प्रा० डसंत)। दंश करता, डसता, डसते रही ।  'भव भुअंग तुलसी नकुल डसत ग्यान हरि लेत ।' दो० १८०
डसाई : (१) भू००स्त्री० । बिछायी। 'गुहँ सवारि साथरी डसाई।' मा० २.८६.७ (२) कृ० । बिछाकर । 'ठे कपि सब दर्भ डसाई।' मा० ४.२६.१०
390
_______________________________________________
डसाए : भूक०बहु० । बिछाये । 'पलँग डसाए ।' मा० १.३५६.१
डसहौं : आ०भ० उए । बिछाऊँगा । । जागें फिरि न डसहो।' विन० १०५.१
डहकत : वकृ००। (१) ठगता, प्रवञ्चित करना । 'बहु बिधि डहकत लोग फिरौं ।' विन० १४१.३ (२) छीना झपटी करता-ते। 'खेलत खात परसपर डहकत ।' कृ० ११ (३) विश्वासघात करते । 'डहकत एकहि एक ।' दो० ५४७
डहकति : वकृ० स्त्री० । (१) छल करती+(२) दहकता, जल जलाती। 'डहकति है उजिअरिआ निसि नहिं घाम ।' बर० ३७
डहकाइबो : भक००कए० । ठगाना, (अपने को) प्रतारित करा लेना। 'डहके ते डहकाइबो भलो।' दो० ४३१
़डहकायो : भूकृ.पु.कए. । (अपने को) ठगाया। 'अलहं विषय कह जतन करत, जद्यपि बहु बिधि डहकायो।' विन० १६६.४
डहकि : पूक । वञ्चना करके । 'डहकि डहकि परिचेहु सब काहू ।' मा० १.१३७.३ (२) होड़ लगाकर, अवज्ञा करके । 'बाल बोलि डहकि बिरावत ।' क० २
डहके : भूक००ब० । (१) ठग गये, ठग लिये, प्रतारित किये । 'कलि डहके कह को न ।' दो० ५४६ (२) ठगने । 'डह के तें डहकाइबो भलो।' दो० ४३१
डहार : सं०० (सं० दहर>प्रा० डहर । बालक । 'कायर कर कपूत कलि घर घर सहस डहार ।' दो० ५६०
डाँग : सं० । पशु विशेष । गी० २.४७.१२
डाँटति : डाटति । 'निपटहि डाँटति निठुर ज्यों।' कृ० १४
डाँटे : डाटे । 'डाँटे बानर भालु सब ।' रा०प्र० ३.६.५
डाँडि : पू० (सं० दण्डयित्वा>प्रा० डंडिअ>अ० डंडि) । दण्डित कर । 'केसरी कुमार सौ अदंड कैसो डांडि गो।' कवि० ६.२४ ।
डाड़ियत : वक पुकबा० (सं० दण्ड्यमान>प्रा० डंडीअंत) । दण्डित किया जाता-किये जाते । 'डांडियत सिद्ध साधक पचारि ।' गी० २.४६.६ ।
डाँड़ी : संस्त्री० (सं० दण्डिका>प्रा० डंडिआ>आ० डंडी)। छोटा डाँडा। 'मरकत भंवर डाँड़ी कनक मनि जटित ।' गी० ७.१६.३
डाँड़ो : सं०पू०ए० (सं० दण्ड:>प्रा० डंडो)। छड़ी, दण्ड, छत्र आदि का दण्डाकार भाग । गी० ७.१८.२
डाकिनि, डाकिनी : संस्त्री० (सं० डाकिनी)। श्मशानादि की देवी, शिशु भक्षिणी पिशाची, डायन । मा० २.१३२.६
डाटत : वक०० । डाँटता-ते, भर्त्सना करता-ते । खिझे तें डाटत नयन तरेरे ।' कृ०३
डाटति : वकृ०स्त्री० । भर्त्सना करती, फटकारती । 'मातु काज लागी लखि डाटति।' कृ० १०
_______________________________________________
391
डाटन : भक० अव्यय । डाटने, भर्त्सना देने । 'मोहि दास ज्यों डाटन आयो।' गी०
डाटहिं : आ०प्रब० । डाटते हैं, भत्संना देते हैं । 'कपि जयसील मारि पुनि डाटहिं ।' मा० ६.५३.५
डाटि : पू० । डपट कर, भत्सित करके । 'आँखि देखावहिं डाटि ।' मा० ७.६६ ख
डाटे : भूक००ब० । डपटे हुए, भत्सित हुए (पर) । डाटे नवहिं अचेत ।' रा०प्र० ५.५.६
डाटेहिं : डाटने पर ही, डपटने से ही । 'डाटेहि पै नव नीच।' मा० ५.५८
डाढ़ : सं०स्त्री० (सं० दाढ़ा=दंष्ट्रा)। दाढ़ । जबड़ा।
डाढ़त : वकृ० (सं० दग्ध>प्रा. डड्ढ-+-वक० =डड्ढंत)। जलता-ते । कवि० ५.१२
डाढ़न : भकृ० अव्यय (अ० डड्ढ+अण=डड्ढण) । जलाने । 'तुलसीदास जगदध जवास ज्यों अनघ मेघ लगे डाढ़न ।' विन० २१.२
डाढ़नि : डाढ़+संब० । दाढ़ो, दंष्ट्राओं, जबड़ों। 'बैठो काज डाढ़नि बीच।' गी. ५.६.२
डाढ़ा : सं०पू० । दाहक अग्नि जो दूर.दूर तक तिनकों में फैल जाती है। जिमि तन पाइ लाग अति डाढ़ा ।' मा० ६.७२.२
डाढ़े : भूकृ०० ब० । दग्ध हुए, जले । 'तुलसी तिहुं ताप न डाढ़े।' कवि० ७.१२७
डाढ़ो : भूक०कए. (सं० दग्धः>प्रा० डड्ढो)। जल गया। 'सब असबाबु डाढ़ो।' कवि० ५.१२।
डाबर : संपु । पोखर, क्षुद्र तालाब । मा० २.१३६.७
डार : (१) संस्त्री० (सं० दाला>प्रा० डाला>अ० डाल)। शाखा । 'प्रभु तरु तर कपि डार पर ।' मा० १.२९ क (२) डारि । फेंक कर । निज निज मरजाद मोटरी सी डार दी।' कवि० ७.१८३ V
डार, बारइ, ई : (सं० दालयति, द्राडयति-दल विशरणे, द्राट विशरणे>प्रा. डालइ) आ०ए० । डालता है, फेंकता है, गिराता है । 'डारइ परसु परिध पाषाना।' मा० ६.७३.२; ८५ छं०
डारउ : आ-आशंङ का, संभावना-प्रए० (सं० द्राडयतु>प्रा० डालउ)। गिराये, डाले । 'जाचत जल पबि पाहन डारउ ।' मा० २.२०५.३
डारत : वक०० (सं० द्राडयत्>प्रा० डालंत) । गिराता-ते । 'डारत कुलिस कठोर ।' दो० २८३
डारन : डार+संब० । डालों, शाखाओं (पर)। 'अवनि कुरंग बिहग द्रुम डारन ।' गी० २.१४.२
392
डारहिं, डारहीं : आ०प्रब० (सं० द्राडयन्ति>प्रा० डालंति>अ० डालहिं) । गिराते हैं, फेंकते हैं । 'जहँ तह अवनि पटकि भट डारहिं ।' मा० ६.८१.६, ३.२० छं० ३
डारा : भूक०० । डाला, फेंका । 'अति रिस मेघनाद पर डारा।' मा० ६.५१.२
डारि : (१) पूकः । डाल (कर)। 'दीन्हि मुद्रि का डारि तब ।' मा० ५.१२ (२) डारु । तू डाल । 'रोम रोम छबि निहारि आलि वारि फेरि डारि ।' गी० २.१७.१
डारिए : आ०कवा०प्रए । डालिए, डाला जाय । 'नीच को डारिए मारि ।' विन० २५८.४
डारिबी : भकृ०स्त्री० । डालनी, छोड़ देनी ।' निपटहि डारिबी न बिसारि ।' गी० ७.२६.३
डारियत : वक०कवा०पु । डाला जाता । 'रोगसिंधु क्यों न डारियत गाय खुर के।' हनु० ४३
डारिये : डारिए।
डारिहउँ : आ०भ० उए । डालंगा । 'बेगि सो मैं डारिहउँ उखारी।' मा० १.१२९.५
डारी : (१) डारि । 'मम दिसि देखि दीन्ह पट डारी ।' मा० ४.५.४ (२) भूकृ. . स्त्री० । डाल दी। 'ठगोरी डारी।' गी० १.१००.१ ।।
डारु : आ० आज्ञा-मए० (सं० द्राडय>प्रा० डाल>अ० डालि, डालु) । फेंक, छोड़ दे । 'लकुट कर तें डारु ।' कृ० १४ ।
डारे : (१) भूकृ.पुं०ब० । डाले, फेंके। 'कोटिन्ह आयुध रावन डारे।' मा० ६.८३.४ (२) डारइ। (३) डाल देवे। 'रुचिर काँचमनि देखि मढ़ ज्यों कर तल तें चितामनि डारे ।' गी० २.२.३
डारेन्हि : आo-भूकृ००+प्रब० । उन्होंने डाला-डाले । 'डारेन्हि ता पर एकहि बारा।' मा० ६.८२.२
डारेसि : आ०-भकृ०पू०+प्रए० । उसने डाला-डाले । जहँ तह पटकि पटकि भट डारेसि ।' मा० ६.६५.६
डारो : डार्यो। 'डेल सो डारो।' कृ० ३४
डारौं : आ०उए । डालू, डालता हूँ, डाल सकता हूँ। 'काचे घट जिमि डारों फोरी ।' मा० १.२५३.५
डार् यो : भूक००कए । डाला, फेंक दिया । दो० ३०३
डावर : सं०० । पुत्र, लड़का।
डावरे : डावर ने, लड़के ने । “सोई बाँह गही जो गही समीर डावरे ।' हनु० ३७
डाँवाडोल : वि० (सं० दाम+दोल>प्रा० दामाडोल>अ. दावाँडोल ?)। (रस्सी में पड़े झूले के समान) कम्पित, विचलित । 'कालु लोकपाल मेरे डर डावांडोल हैं।' कवि० ५.२१ तुलसा शब्द-कोश
393
डासत : वक०० (सं० दाशयत्>प्रा. डासंत) । बिछाता, बिछाते । 'डासत ही गई बीति निसा सब ।' विन० २४५.४
डासन : सं.पु० (सं० दाशन>प्रा० डासण) । बिछोना। 'लोभइ ओढ़न लोभइ - डासन ।' मा० ७.४०.१
डासि : पू० । बिछाकर । 'ए महि परहिं डासि कुस पाता।' मा० २.११६.७
डासी : डासि । मा० २.६७.५
डिंडिम : (१)। सं०पु । ध्वनि विशेष । (२) डिमडि र ध्वनि से बजने वाला वाद्यविशेष (सं०) । 'तांडवित नत्य पर डमरु डिडिम प्रवर ।' विन०
१०.५ :
डिंडिमीं : सं.स्त्री० ब० । डिडिमियाँ, डौंडी बाजे । मा० १.३४४.२
डिंब : सं०० (सं.)। शिशु । 'अनुकूल बंबक अंब ज्यों निज डिब हित सनमानि के ।' गी० ३.१७.३
डिंभ : सं०पु० (सं.) डिब । कवि० ७.८१
डिगति : डगति । 'डिगति उबि अति गुबि ।' कवि० १.११
डिठि : डीठि । नजर (दष्टि दोष)। 'डिठि मुठि निठुर नसाइहौं।' गी० १.२१.२
डिठिआरो : वि०पू०कए । दष्टि वाला, नेत्रयुक्त । 'अंध कहें दुख पाइहै, डिठिारो केहिं डीठि ।' दो० ४८१
डीठ : भूक.पु. (सं० दृष्ट>प्रा० दिट्ठ) । देखा, देखें। 'दई पीठ बिन डीट मैं ।' विन० १४६.४
डीठा : डीठ । देखा । 'पित बैभव बिलास मैं डीठा ।' मा० २.६८.१
डोठि : संस्त्री० [सं० दृष्टि>प्रा० दिट्टि) । 'नेत्र नेत्र ज्योति । 'लोचन सजल डीठि भइ थोरी।' मा० २.१४५.३
डोठी : डीठि । मा० १.२३१७
डीठे : भूकृ.पुब० । देखे । 'अनमवे सुने अरु डीठे।' विन० १६६.२
डेरा : सं०पू० (सं० द्वार>प्रा० देर ?) । शिविर, पड़ाव (मुकाम) । 'राम करहु तिन्ह के उर डेरा ।' मा० २.१३१.८ (२) शिविर के लोग तथा सामान । 'डेरा चले लवाइ ।' मा० २.१६७
डेरा, डेराइ, डेराई : (सं० दरायते>प्रा० डराइ ---भय करना, डरना) आ०प्रए० । (१) डरता-ती है। 'अभय होइ जो तुम्हहि डेराई।' मा० १.२८४.५ (२) डरे, डर जाय । 'जब सिय कानन देखि डे राई ।' मा० २.८२.३
डेराऊँ : आ० उए । डरता हूं । 'तुम्ह पूछह मैं कहत डेराऊँ ।' मा० २.१७.३
डेरात : वकृ० । डरता। 'तैसो कपि कौतुकी डेरात ढीले गात के के।' कवि० ५.३
डेराति, डेराती : वक०स्त्री० । डर जाती । 'चित्र लिखित कपि देखि डेराती ।' मा. २.६०.४
394
______________________________________________
डेराना : भू००पु । डर गया। 'मुनि गति देखि सुरेस डेराना।' मा० १.१२५.५
डेराने : भूक०० ब० । डर गये । 'उग्र बचन सुनि सकल डेराने ।' मा० ६.४२.६
डेरावहिं : आ०प्रब० । डराते हैं, भय दिखाते हैं, भयभीत करते हैं। 'कपि लीला करि तिन्हहि डेरावहिं ।' मा० ६.४४.५
डेराहिं, डेराहीं : आ०प्रब० । डरते हैं । भय खाते हैं। 'कुटिल काक इव सबहि डेराहीं।' मा० १.१२५.८
डेराहु, डेराहू : आ० मब० । डरो, भयभीत होओ। 'जनि हृदय डेराहू ।' मा० ६.३२.६
डेरे : 'डेरा' का रूपान्तर । शिविर, रुकाव, आश्रय (द्वार)। 'दीन वित्तहीन हौं बिकल बिन डेरे ।' विन० २१०.४
डेरो : डेरा+कए । निवास । 'हृदय करहु तुम डेरो।' विन० १४३.८
डेल : सं० । ढेला, मिट्टी या पत्थर का लोंदा (निरर्थक वस्तु) । 'नाहिन रास रसिक रम चाख्यो ता ते डेल सो डारो।' कृ० ३४
डेवढ़ : वि० (सं० द्वयर्ध>प्रा० देवड्ढ) । ड्योढ़ा, ड्योढ़े। 'बिधि तें डेवढ़ लोचन लाहू ।' मा० १.३१७.५
डोंगर : सं०० (प्रा० डुंगर=डोंगर) । पर्वत, पहाड़ी 'चित्र विचित्र बिबिध मृग डोलत डोंगर डांग ।' गी० २.४७.१२
डोरि : डोरी रस्सी । 'लसति पाटमय डोरि ।' मा० १.२८८
डोरिआए : भूकृ००० । डोरी में बाँधे हुए। कोतक संग जाहिं डोरिआए।' मा० २.३०३.४
डोरी : सं०स्त्री० (सं० दोरी>प्रा. डोरी) । रस्सी। 'मम पद मनहि बाँध बरि डोरी ।' मा० ५.४८.५
डोल : (१) डोलइ। 'चिक्करहिं दिग्गज डोल महि ।' मा० १.२६१ छं० (२) हिलती थी। तब बल नाथ डोल नित धरनी।' मा० ६.१०४.५
डोल, डोलइ : (सं० दोलते-दुल उत्क्षेपे>प्रा० डोल्लइ-हिलना, आन्दोलित होना, डगमगाना, चलित होना) आ०प्रए । आन्दोलित होता-ती है। 'अचल. सुता मनु अचल बयारि कि डोलइ ।' पा०म० ५८
डोलत : वकृ०० । (१) हिलते, घूमते, भटकते । 'दीन मलीन छीन तनु डोलत ।' कृ० ३५ (२) काँपते (में), आन्दोलित होते (समय) । 'डोलत धरनि सभासद खसे ।' मा० ६.३२.४
डोलति : वकृस्त्री० । हिलती, काँपती। 'चलत दसानन डोलति अवनी।' मा० १.१८२५
डोलहिं : आ०प्रब० (सं० दोलन्ते>प्रा. डोल्लंति>अ० डोल्लहि) । (१) विचल होते हैं । 'समदम नियम नीति नहि डोलहिं ।' मा० ७.३८.८ (२) चलते-फिरते हैं (अचेतनवत् गति लेते हैं)। 'सिथिल अंग पग मग डगि डोलहिं ।' मा०.२.२२५.४
डोलहि : आ.मए० । तू डोल, भटकता रह । “जनि डीलहि लोलुप कुकुरु ज्यों।" कवि० ७.३०
डोला : (१) भू००० । कापा, हिला, चलित हुआ। 'पीपर पात सरिस मनु डोला ।' मा० २.४५.३ (२) स०ए० (सं० दोल>प्रा० डोल =डोलअ)। झूला, पालकी । 'हमहि दिहल करि कुटिल करमचंद मंद मोल बिनु डोला रे।" विन० १८९.२
डोलावा : भकृ०० (सं० दोलित>प्रा० डोल्लाविअ)। हिलाया, विचल किया । 'काहि न सोक समीर डोलावा ।' मा० ७.७१.३
डोलावौं : आउए । चलाता हूं। 'जहं तहँ चितहि डोलावौं ।' विन० २३२.२
डोलावौंगी : आ०भ० स्त्री०ए० । 'हिलाऊँगी । 'अम भए बाउ डोलावौंगी।' गी.. २.६.२
डोलिहैं : आ०भ० प्रब० । हिलेंगे, काँप जायगे । “भूलिहैं दस दिसा सीस पुनि डोलि हैं।' कवि० ६.२०
डोली : (१) सं-स्त्री. (सं० दोला>अ० डोली)। पालकी। 'जाइ समीप राखि निज डोली।' मा० २.१८८.४ (२) भूकृ०स्त्री० । विचल हो गयी । 'सो मति डोली।' मा० १.१९२ छं० (३) हिल गयी । 'डोली भूमि गिरत दसकंधर । मा० ६.१०३.५
डोले : भूकृ०० ब० । (१) हिले, कांप उठे । 'डगमगानि महि दिग्गज डोले ।' मा० १.२५४.१ (२) विचलित (च्युत) हुए । 'जे सपनेहुं निज धरम न डोले ।" मा० २.१८६.६
डोलै : डोलइ । कवि० ७.१४८
डोल्यो : भक०पू० कए० । हिला । 'परम धीर नहिं डोल्यो।' गी० ३.१३.३
डोल्लहिं : डोलहि । भटक रहे हैं, घूम-घाम रहे हैं। 'कोटिन्ह एंड मुड बिन __डोल्लहिं ।' मा० ६.८८.१०
डोआ : सं० । बड़ा चमचा । 'लकड़ी डोआ करछुली ।' दो० ५२६
396
_______________________________________________
ढँढोरी : भूकृ०स्त्री० (सं० ढुण्डिता=गवेषिता>प्रा० ढंढोली) । ढंढ़ी, खोजी । __'सारद उपमा सकल ढंढोरी।' मा० १.३४६.७
ढँग : सं० । रीति, शैली, प्रकार । गी० १.२.१४
ढकनि : ढका+संब० । धक्कों (से) । 'ढकनि ढके लि।' कवि० ५.८
ढका : धक्के से । 'ढकाँ ढकेलि ढाहि गो।' कवि० ६.२३
ढकाँ : (१) सं०० । धक्का । 'नेकु ढका दैहैं हैं हैं ढेलन की ढेरी सी।' कवि० ६.१० (२) घेरा । 'बासर ढासनि के ढका ।' दो० २३६
ढकेलि : पूकृ० धकेल कर, धक्का देकर । 'ढकनि ढकेलि पेलि सचिव चले लैठेलि।' कवि० ५.८
ढकेल्यो : भूक पु०कए । धक्का देकर गिराया। कवि० ७.७६
ढनमनी : भू० कृ०स्त्री० । ढुलमुला गई, लुढ़क गयी, अस्त-व्यस्त होकर पसर गयी। 'रुधि बमत धरनी ढनमनी।' मा० ५.४.४
ढरके : ढलने पर। 'गए कोस दुइ दिनकर ढरके।' मा० २.२२६.१
ढरत : वकृ.पु । ढल रहा । (१) साँचे में ढलता। 'जोबन नव ढरत ढार ।' गी० २.४३.३ (२) अनुकूल प्रवाह में चल रहा । 'राम सब को सुदर ढरत ।' विन० १३४.६ (३) मय ढलता।
ढरनि: संस्त्री० । ढलने की क्रिया । बहाव । (१) चाल, शैली, रीति । 'तुलसी ढरेंगे राम आपनी ढरनि ।' विन० १८४.५ (२) ढर्रा, मार्ग, स्वभाव । 'तो मथुराहिं महा महिमा लहि सकल ढरनि ढरिबे हो।' कृ० ३६ (यहाँ उचित मार्ग से तात्पर्य है)
ढरहिं, ढरहीं : आ.प्रब० । ढलते हैं, चलाए जाते हैं। 'ब्यजन चारु चामर सिर ढरहीं।' मा० १.३५०.४ ।
ढरिए, ढरिये : आ० भावा० । ढलिए, गति लीजिए, चलिए । 'ढरनि आपनी ढरिए ।' विन० २७१.१
ढरिबे : भूकृपु० । ढलने, प्रवाहित होने, चलने । 'सकल ढरनि ढरिबे हो।' कृ० ३६
ढरिहै : आ०भ०प्रए । ढलकेगा, बहेगा। 'नीर नयननि ढरिहै ।' विन० २६८.४
_______________________________________________
397
ढरे : भूकृ.पु०३० । ढले, चले, पड़े । 'पासे सुढर ढरे री।' गी० १.७६.३
ढरैगे : आ०भ०पू०प्रब० । ढलेंगे, गति लेंगे। 'ढरेंगे राम आपनी ढरनि ।' विन०. १८४.५
ढहा : भक०० । ध्वस्त हो गया , 'राज समाज ढहा है।' गी० २.६४.२
ढहाए : भकृ००ब० । गिराये । 'गढ़ ते पर्बत सिखर ढहाए ।' मा० ६.४६.१०
ढहावहि, ढहावहीं : आ०प्रब० । (१) ध्वस्त करते हैं। 'सुभट भटन्ह ढहावहीं ।' मा०. ६.८८ छं० (२) गिराते हैं। निसिचर सिखर समह ढहावहिं ।' मा०. ६.४१.८
ढहावा : भूकृ०० । ध्वस्त कर धराशायी किया। 'भवन ढहावा ।' मा० ६.४४.३
ढहे : भूकृ.पुं०ब० । ध्वस्त हुए । 'ढहे समूल बिसाल तरु ।' रा०प्र० ६.३.५
ढाँकी : पूक० । ढाँक कर, आवृत कर । मा० २.११७.६
ढाके : भूक००ब० । (प्रा० ढक्किय=ढंकिय) । आवत किये। 'भीमता निरखि __कर नयन ढाँके ।' कवि० ६.४५
ढाबर : वि.पु. । गंदला, कँदैला, मलिन । 'भूमि परत भा ढाबर पानी।' मा० ४.१४.६
ढार : सं०स्त्री० । (१) ढाल, ढलकाव, बहाव । (२) मदिरा ढालने की क्रिया । (३) साँध लेने की क्रिया । 'जोबन नव ढरत ढार दुत्त मत्त मृग मराल । गी० २.४३.३ (नये सांचे में यौबन-मदिरा ढल रही है जिससे मृग आदि मतवाले हो रहे हैं)
ढार, ढारह : (सं० धाडययि-ध्राड्ढ विशरण>प्रा० ढालइ-ढालना, बहाना, उडेलना, प्रतिमा आदि को सांचा देना) आ.प्रए० । ढालता-ती है। 'नारि चरित करि ढा रइ आंसू ।' मा० २.१३.६ (मन्थरा आँसू साँचे में मानों ढाल कर बहा रही है जैसे कोई स्त्री मदिरा ढलका रही हो)
ढारत : वक० पु । ढलकाता-ते; बहाते । 'दूध दह्यो माखन ढारत है।' क०६
ढारति : वक स्त्री० । ढालती, बहाती। 'बरत बारि उर ऊपर ढारति ।' गी० ५.१६.२
ढारि : (१) पू० । उँडेल (कर) । 'ऊपर ढारि देहिं बहु बालू ।' मा० ६.८१.७ (२) प्रति गा गढ़ कर । 'सोभा को सांचो सवारि, रूप जातरूप ढारि, नारि बिरचो बिरंचि, संग सोही।' गी० २.२०.३ (३) आ०-आज्ञा-मए । तू ढाल, ढलका । 'जोगि जन मनि मंडली में जाइ रीती ढारिक० ५३
ढारीं : भूक०स्त्री०ब० । ढाली गई, ढाल कर बनाई गई । 'नाना रंग रुचिर गच ढारी ।' मा० ७.२७.३
ढारी : भक०स्त्री०ए० । ढाली गयी। 'अति बिस्तार चार गच ढारी।' मा० १.२२४.२
398
_______________________________________________
ढारो : ढार्यो । 'मैं ढारो बिगारो तिहारो कहा ।' कवि० ७.१०१
ढार् यो : भूक पु०कए० । ढाल दिया, ढलका कर फेंक दिया, हानि कर डाली। 'खायो के खवायो के बिगार्यो ढार्यो लरिकारी ।' कृ० १६
ढसनि : ढास+संब० । ढासों, ठगों, लुटेरों। 'बासर ढासनि के ढका, रजनी चहुंदिसि चोर ।' दो० २३६
ढाहत : वकृ०पू० । ढहाता-ते, ध्वस्त कर गिराता-ते । मा० २.३४.४
ढाहि : पूक० । ढहाकर, ध्वस्त-धराशायी करके । 'बंक गढ़ लंक सो ढका ढकेलि ढाहि गो।' कवि० ६.२३
ढाहिबे : भक०० । ढहाने, ध्वस्त करने । कवि० ६.२६
ढाहे : भूक. पु० । ध्वस्त कर गिरा दिये । 'ढाहे महीधर ।' मा० ६.४६ छं०
ढाग : क्रि०वि० । समीप में । 'अनुज सहित मिलि ढिग बैठारी ।' मा० ६.४६.३
ढिठाईं : ढिठाई से, धृष्टता करने से । 'सेवकु समय न ढीठ ढिठाई।' मा० २.२२७.७
ढिठाई : सं०स्त्री० । धृष्टता । 'सो मैं सब बिधि कोन्हि ढिठाई ।' मा० २.२६८.८
ढोठ : वि०पू० (सं० धृष्ट>प्रा० धिट्ठ) । हठी, दुराग्रही, अशिष्ट । निर्भय । मा. २.२२७.७
ढीठु : ढीठ+कए । अद्वितीय धष्ट । 'दिहुं मिलि कीन्ह ढीठु हठि मोहू ।' मा० २.३१४.६
ढोठे : ढीठ+ब० । धृष्टतापूर्ण । 'बचन कहत अति ढीठे।' विन० १६९.३
ढीठो : सं०स्त्री० । धृष्टता भी। 'प्रभु सों मैं ढीठो बहुत दई है।' गी० २.७८.१
ढोठ्यो : ढीठो । 'बहुत हौं ढीठ्यो कई ।' मा० १.३३६ छं० ३
ढील : (१) वि०पू० (सं० शिथिल>प्रा० सिढिल्ल=ढिल्ल) । सुस्त । 'पील उद्धरन सील सिंधु ढील देखियतु ।' विन० २४८.४ (२) संस्त्री० । शिथिलता। 'मेरी बार मेरे ही अभाग नाथ ढील की ।' कवि० ७.१८
ढोलि : (१) ढील । शिथिलता। (२) पू० । शिथिल करके, ढीला करने पर। 'ढीलि दिएँ गिरि परत महि। दो० ४०१
ढीली : वि०स्त्री० । शिथिल । 'ढीली करि दाँवरी बावरी ।' कृ० १६
ढोले : वि०पू०ब० । शिथिल । 'डेरात ढीले गात के के।' कवि० ५.३
ढेक : सं० । पक्षिविशेष । मा० ३.३८.५
ढेर : सं०पू० राशि । कवि० ७.४६
ढेरी : ढेर । मा० २.११४.५
ढेरु : ढेर+कए । एकीभूत राशि । 'सुषमा को ढेरु कैधौं ।' कवि० ७.१३६
ढेरै : ढेरहि । ढेर को । 'रंक लूटिबे को मानो मनिग न ढेरै ।' गी० ५.२७.३
ढेलन : ढेला+संब० । ढेलों, मृत्पिण्डों। ढेलन की ढेरी सी।' कवि ६.१०
