996
_______________________________________________
संबंध : सं०० (सं.) । (१) अनेक को एकभाव देने वाला आन्तरिक भाव-बन्धन । (२) वर पिता और वधू पिता का भाव बन्धन । मा० १.३२६ छं० २ ।
संबत : सं०० (सं० संवत् - अव्यय) । (१) वर्ष । 'प्रति संबत अस होइ अनंदा।' मा० १.४५.२ (२) ज्योतिष के अनुसार ६० वर्षों के संवत्सर जो नामों से जाने जाते हैं । इनकी ब्रह्म, विष्णु और रुद्र नामों से तीन विशतियाँ मानी गयी हैं। जय, विजय आदि संवतों के नाम हैं । 'जय संबत फागुन सुदि पाँचै गुरु दिनु ।" पा०म० ५
संबतु : संबत+कए० । एक वर्ष । 'लघु जीवन संबतु पंच दसा।' मा० ७.१०२.४
संबरारि : सं०० (सं० शम्बरारिशम्बर दैत्य के शत्रु)। प्रद्युम्न =कामदेव । गी० ७.७.३
संबल : सं०० (सं.)। पाथेय, पथिक के लिए मार्गन्यय आदि आवश्य साधन; साधन-सामग्री । मा० १.३८
संबलु : संबल+कए० । कोई साधन । एक भी पाथेय । 'सुरालयहू को न संबलु मेरे ।' कवि० ७.६२
संबाद, संबादा : सं०० (सं० संवाद)। (१) वार्तालाप । मा० ७.५५.५ (२) कथान कथन, उपदेशात्मक प्रश्नोत्तर । मा० १.३६ (३) समाचार (खबर)। 'छन महं ब्यापेउ सकल पुर घर घर यह संबाद ।' मा० १.६८
संबादु, संबादू : संबाद+कए । मा० २.३०८: ६६.३
संबुक : सं०० (सं० शम्बक) । घोंघा। मा० २.२६१.४
संभव : सं०पू० (सं०) । (१) उत्पत्ति । 'जग संभव पालन लय कारिनि ।' मा० १.६८.४ (२) (समासान्त में) । उत्पन्न । 'दुसह बिरह-संभव दुख मेटे ।' मा० ७.६.१
संभारि : पू० । (१) संभाल कर, व्यवस्थित कर । 'उठि संभारि सुभट पुनि लरहीं।' मा० ६.६८.६ (२) स्मरण करके । 'पुनि संभारि उठी सो लंका।' मा० ५.४.५
संभारी : संभारि । (१) संभाल कर, सोच-विचार कर । 'रे कपिपोत बोल संभारी ।' मा० ६.२१.१ (२) स्मरण करके । दीनदयाल घिरिदु संभारी । हरहु नाथ मम संकट भारी।' मा० ५.२७.४
संभार् यो : भूकृ००कए । स्मरण किया। 'तम मारुतसुत प्रभु संभार्यो ।' मा ६.६५८
संभावित : वि० (सं०) । सम्मानित, कीर्तिशाली। 'संभावित कहं अपजस लाह । ___मरन कोटि सम दारु दाहू ।' मा० २.६५.७
संभु : शंभु (प्रा०) । मा० १.१.३
997
संभूत : वि० (सं.)। उत्पन्न । 'संभु सुक्र संभूत सुत ।' मा० १.८२
संभ्रम : सं०० (सं०) । (१) हड़बड़ी, त्वरा, झटपट । 'संभ्रत चलि आई सब रानी ।' मा० १.१६३.१ (२) सम्मान, आदर । 'सहित सभा संभ्रम उठेउ रबिकुल कमल दिनेसु ।' मा० २.२७४
संभ्राज : आ०प्रए० (सं० संभ्राजते) । शोभित (दीप्त) हो रहा है (था)। 'राम संभ्राज सोभा सहित सर्वदा ।' विन० २७.५
संमत : वि (सं०) सं० । (१) गुप्त रूप से अभिप्रेत या मान्य मत । 'बंधु कहइ कटु संमत तोरें।' मा० १.२८१.१ (२) मन्त्रणा। समुझि सयाने करहु अब सब मिलि संमत सोइ ।' मा० २.२५४ (३) सिद्धान्त रूप से स्वीकृत तथा समर्थित । 'श्रुति संमत सज्जन कहहिं ।' मा० ७.६५ (४) संमानित । बिष बिबेकी बेद बिद संमत साधु सुजाति ।' मा० २.१४४
संमोह : सं०० (सं०) । भ्रम । महामोह (अहंकार का सूक्ष्मरूप =अस्मिता)। विन० ५३.६
सम्राज : सं०० (सं० साम्राज्य) । चक्रवर्ती का राजत्व । 'संम्राज सुख पद बिरागी।' विन० ३६.२
संयुक्त : (दे० संजुक्त) । सहित, सम्पृक्त । विन० ६१.७
संयुत : वि० (सं०) । संयुक्त । मा० २ श्लोक २, ३.४ छं.
संशय : सं०० (सं०) । सन्देह । अनिश्चयात्मक बोध । एक ही वस्तु में अनेक की द्वैविध्यपूर्ण प्रतीति (जिसमें निर्णय न हो) । मा० ३.११.६
संसउ : संसय+कए । एक ही सन्देह । 'यहु संस उ सबके मन माहीं ।' मा० २.२५२.८
संसकृत : (सं० संस्कृत) संस्कार सम्पन्न भाषा, देववाणी । 'का भाषा का संसकृत।' दो० ५७२
संसय : संशय (प्रा.) । मा० ७.३०.७
संसर्गा : संपुं० (सं० संसर्ग)। संगति, सम्पर्क । मा० ७.४६.७
संसार : सं.पु. (स.) । (१) जगत्, विश्व-प्रपञ्च । विदित सकल संसार ।' मा० १.२७१ (२) जन्म-मरण चक्र । 'गुनागार संसार दुख।' मा० ३.४५ (३) ज्ञान द्वारा नष्ट होने वाले जागतिक सम्बन्ध (पिता-पुत्र आदि) । मा० ७.१३० श्लो० २
संसारपार : संसार से परे=जरामरण रहित = अविनाशी । मा० ७.१०८ छ ४
संसारा : संसार। मा० १.१२.१०
संसारी : वि०पू० (सं० संसारिन) । (१) संसार सम्बन्धी । (२) संसरण (जन्म मरण-चक्र) प्राप्त करने वाला । (३) बद्ध जीव या प्रवाह-जीव । 'तब ते जीव भयउ संसारी।' मा० ७.११७.५
998
_______________________________________________
संसारू : संसार+कए० (अ० संसारु)। जगत् । मा० १.८६.२
संसृत : वि० (सं०) । सांसारिक, संसार में उपाजित । 'भजहि मोहि संसृत दुख ___ जाने ।' मा० ७.४१.६
संसृति : सं०स्त्री० (सं.)। (१) सृष्टि । (२) संसार-जन्म-मरण चक्र । 'देहि ___ भगति संसृति रारि तरनी।' मा० ७.३५.६
संसृतिचक्र : सं०पू० (सं०) । संसार में जन्म-मरण का आवर्तन-आवागमन । विन० १३६.७
संहर्ता : वि.(सं० संहत ) । संहारकर्ता, प्रलयंकर । मा० ६.७.४
संहार : सं०पु० (सं०) । (१) समेट कर एकीभूत करने की क्रिया । (२) सर्वनाश,. प्रलय। मा० १ श्लो० ५
संहारे : भूकृ००ब० । मार डाले । मा० ६.६२.१० (पाठान्तर) ।
स: : सर्वनाम (सं.)। वह । मा० २ श्लो०१
सइल : सं०पु० (सं० शैल>प्रा० स इल) । पर्वत । कवि० ६.४४
सई : सं०स्त्री०। (१) (सं० स्यन्दिका)। एक नदी जो आजकल रायबरेली जिले __ में होकर बहती है । 'सई तीर बसि चले बिहाने ।' मा० २.१८६.१ (२) (अरबी -- सई) लाभ (हासिल) । 'पूजी बिनु बाढ़ी सई ।' गी० ५.३७.४
सउछाह : (सं० सोत्साह-दे० उछाह) उत्साह सहित । कवि० ६.३१
सक : (१) सकइ । सकता है। 'पुरुष त्यागि सक नारिहि ।' मा० ७.११५. (२) संस्त्री० (सं० शङ्का -फा० शक)। सन्देह, दुविधा। 'राम चाप तोरब सक नाहीं।' मा० १.२४५
सक, सकइ : मा०प्रए० (सं० शक्नोति >प्रा० सक्कइ) । सकता-ती है; समर्थ होता-होती है । 'कहि न सकइ फनीस सारदा ।' मा० ७.२२.५
सकउँ : आ० उए० (सं० शक्नोमि>प्रा० सक्कमि>अ० सक्क उँ) । मैं सकता-ती हूं। 'सकउँ पूत पति त्यागि । मा० २.२१
सकत: वकृ.पुं० । सकता-ते । 'सनमुख होइ न सकत मन मोरा ।' मा० ५.३२.६.
सकति : (१) वकृ०स्त्री० । सकती (समर्थ होती)। कहि न. सकति कछ, सकुचति ।' जामं० १०० (२) सं०स्त्री० (सं० शक्ति) । सामर्थ्य । 'सभ के सकति संभु धन भानी ।' मा० १.२६२.६ (३) शस्त्रविशेष, साँग । 'गई गगन सो स कति कराला ।' मा० ६.८४.७
सकतु : सकत+कए । 'घराधर धीर भारु सहि न सकतु है ।' कवि० ६.१६
सकरुन : वि० (सं० सकरुण) । करुणायुक्त, आर्त । मा० ६.७०.५
सकल : (१) वि० (सं०) । कलासहित= सम्पूर्ण कलाओं (अंशों) से सम्पन्न; सम्पूर्ण, सब । मा० १.१.२ कौशलयुक्त सकल ताड़ना के अधिकारी । मा. ५.५६.६ (२) (सं० शकल>सकल) खण्ड, अंश, लेश । 'जहँ सुख सकल सकल दुख नाहीं। यहां द्वितीय 'सकल' लेशपर्याय है।
सकलंक : कलङ कयुक्त (लाञ्छित+चिह्नयुक्त)। मा० १.२३७
सकलंकू : सकलंक+कए । मा० २.११६.३
सकसि : आ०मए० (सं० शक्नोषि>प्रा० सक्कसि) । तू सकता है, सके । 'जौं मम चरन सकसि सठ टारी।' मा० ६.३४.६
सकहिं, सकहीं : आ०प्रब० (सं० शक्नुवन्ति>प्रा० सक्कंति>अ० सकहिं) । सकते हैं। ____ 'सेष सहस सत सहहिं न गाई ।' मा० ७.११.६, ६.२६७.८
सकहु : आ०मब० (सं० शक्न थ>प्रा० सक्कह>अ० सक्कह) सकते हो, सको।  'सकहु त आयसु धरहु सिर ।' मा० २.४०
सकाई : सकइ । 'जिमि थल बिनु जल रहि न सकाई।' मा० ७.११६.५
सकाना : भूकृ००। शक किया, शङ्काकुल हो गया, हिचका, सहम गया । 'छत्रिय तनुधरि समर सकाना ।' मा० १.२८४.३
सकानी : भूकृ०स्त्री० । शङि कत हुई, सहम गयी। 'कोलाहल सुनि सीय सकानी ।' मा० १.२६७.५
सकाम : वि० (सं.)। कामनासहित, लौकिक फल प्राप्ति की इच्छा से युक्त । मा० ७.१५.३
सकारें : क्रि०वि० (सं० श्व:काले>प्रा० सकाले =सकालेण>अ. सकालें)। सबेरे, प्रातः। 'अवधेस के द्वार सकारें गई।' कवि० १.१
सकाहिं : आप्रब० । शङ् का करते हैं, हिचकते हैं, संकोच अनुभव करते हैं। 'बरनत अगम सुकबि सकाहिं ।' गी० ७.२६.४
सकिअ : आ० भावा० । सकिए, सका जाय । 'बुधि बल जीति सकिअ जाही सों।' ___ मा० ६.६.५
सकिलि : पू० (सं० संकिल्य)। सिकल कर, सब ओर से एकत्र होकर । 'सकिलि धवन मग चलेउ सुहावन ।' मा० १.३६.८
सकिहि : आ०भ०प्रए० । सकेगा-गी। सहि न सकिहि सिय बिपिन कलेसू ।' मा० २.६६.६
सकी : भूक०स्त्री० । समर्थ हुई । 'न सकी सँभारि ।' मा० २.२८६
सकु : सक+कए० । कुछ भी शक, शङका । 'हम हैं तुम्हरे तुम्ह में सकु नाहीं।' कवि० ७.६४
सकुच : सं०स्त्री . । संकोच । 'सीय सकुच बस उतरु न देई ।' मा० २.७६.१
सकुच, सकचई : आ०प्रए० (सं० संकुचित>प्रा० संकुच्चइ) । संकोच करता है, सिकुड़ता है, मन में सिमटन-सी अनुभव करता-ती है। 'छुअत जो सकुचइ सुमति सो।' दो० ४०६
सकुचउँ : आ० उए । संकोच अनुभव करता हूं । 'सकुचउं तात कहत एक बाता।' मा० २.२५६.२
सकुचत : (१) वकृ०० । संकोच करता-करते । 'प्रस्न करत मन सकुचत अहहीं।' मा० ७.३६.६ (२) सिकुड़ता । 'कछु कहि न सकत, मुसुकत सकुचत।' कृ० १७
सकुचति : वक०स्त्री० । संकोच करती (सिकुड़ती)। 'सकुचति महि जिमि हृदय हमारे ।' मा० २.१२१.३
सकुचनि, सकुचन्ह : सकुच+संब० । संकोचों (के कारण)। गी० १.६६.१ 'सकुचन्ह कहि न सकत ।' मा० १.३०७.५
सकुचब : भकृ०० । संकोच करना । 'नाथ न सकू चब आयसू देता ।' मा० २.१३६.८
सकुचमय : वि० । संकोचपूर्ण । मा० १.३३६.४
सकुचहिं : आ०प्रब० । संकोच करते हैं, हिचकते हैं । मा० १.२८६
सकुचा, सकुचाइ, ई : सकुचइ । 'कहति सिय सकुचाइ।' गी० ७.२७.२ तेहि बिलोकि माया सकुचाई।' मा० ७.११६.७ ।
सकुचाइ, सकुचाई : पू० । संकोच करके । मा० २.२७०.७ 'सुनत फिरा मन अति सकुचाई।' मा० ६.३५.३
सकुचाउँ : सकुचउँ । 'मैं पूछत सकुचाउँ।' मा० २.१२७
सकुचाउँगो : आ०भ००उए । संकुचित होऊँगा। हौं निपटहि सकुचाउँगो।' गी० ५.३०.२
सकुचात : सकुचत । (१) संकोच अनुभव करते । 'देखि लोग सकुचात जमी से ।'  मा० २.२१५.५ (२) सिमटते, सिकुड़ते । 'सूखे सकुचात सब ।' कवि० ५.२०
सकुचाति : सकुचति । सिकुड़ती, संकोच अनुभव करती । 'सकुचाति मही पद पंकज छ ।' कवि० २.१८ ।
सकुचाना : भूकृ.पुं० । संकुचित हुआ, सिकुड़-सा गया। 'अंगद बचन सुनत . सकुचाना।' मा० ६.२१.४
सकुचानि, सकुचानो : भूकृ०स्त्री० । संकुचित हुई । मा० ७.६ 'बानी कहत साधु महिमा सकुचानी।' मा० १.३.११
सकचाने : भक०पुब० । संकुचित हुए, सिकुड़ गये । 'काम क्रोध कैरव सकुचाने ।'  मा० ७.३१.४
सकुचाहिं, सकुचाही : सकुचहिं । (१) संकोच अनुभव करते हैं। निज गुन श्रवन सूनत सकुचाहीं।' मा० ३.४६.१ (२) सिमटते हैं । 'बर दुलहिनि सकुचाहिं ।' मा० १.३५० 'राम लला सकुचाहिं देखि महतारी हो ।' रा०न० १८
सकचाहुं : आ०-संभावना-प्रब० । वे संकोच करें। 'अब ते सकुचाहुं सिहाहूं।' विन० २७५.४
_______________________________________________
1001
सकुचि : पू० । (१) संकोच अनुभव करके । 'सकुचि दीन्हि रघुनाथ ।' मा० ५.४६ (२) सिकुड़कर, सिमट कर । 'बैठो सकुचि साधु भयो चाहत ।' कृ० ३
सकुचिअ, सकुचिये : आ०भावा० । संकोच करना पड़ता है, संकुचित हुआ जाय । 'कहि सुनि सकुचिअ सूम खल ।' दो० ३६१
सकुचिये : सकुचिअ । संकोच हो । 'प्रगट कहत जो सकुचिये अपराध भर्यो हौं ।' विन० २६७.४
सकुचिहि : आ०म०प्रए । संकोच करेगा, सिमट जायगा। 'सकुचिहि मोहि बिलोकत सोई ।' मा० २.१४५.८
सकुची : भूक.स्त्री० । संकुचित हुई। मा० २.११७.२
सकुचे : भूकृ००ब० । संकुचित हुए। मा० २.२६०.७
सकुचेउ : भूकृ००कए० । संकुचित हुआ, सहमा, झिझका। 'कोप भवन सुनि ___ सकुचेउ राऊ।' मा० २.२५.१
सकुचै : सकुचइ । 'सिय सकुचति, मन सकुचं न ।' मा० १.३२६
सकुचैहैं : आ०भ०प्रब० । संकोच अनुभव करेंगे, सकुचेंगे। 'जमपुर जात बहुत ___ सकुचैहैं ।' गी० ५.५१.३ ।।
सकुन : सं०० (सं० शकुन)। पक्षी । मा० १.३४६.६
सकुनि : सं०० (सं० शकुनि)। दुर्योधन का एक मित्र जिसने द्यूतक्रीडा में पाण्डवों ___ को हराया था। दो० ४१८
सकल : वि० (सं.)। कुलसहित, वंश समेत । 'राम सकुल रन रावन मारा ।' मा० १.२५.५
सकृत : (१) अव्यय (सं० सकृत्) । एक बार । 'सकृत प्रनाम किहें अपनाए ।' मा० २.२६६.३ 'सकृत उर आनत जिनहिं जन होत तारन तरन ।' विन० २१८.४ (२) एक (गोस्वामी जी का विशिष्ट प्रयोग) । सम्यक ग्यान सकृत कोउ लहई ।' मा० ७.५४.३ 'जो सुख-सिंधु सकृत सीकर ते सिव बिरंचि प्रभूताई।' गी० १.१.११
सके : भूक००ब० । मा० ७.३३.२
सकेउ : भूक००कए० । सका (समर्थ हुआ) । 'बिधि न सकेउ सहि मोर दुलारा।' मा० २.२६१.१
सकेली : संकलि । बटोर के, समेट कर । आयउँ 'इहाँ समाज सकेली।' मा० २.२६८.५
सकैं : सकहिं । 'ठाढ़ो द्वार न दे सके।' दो० ३८२
सकै : सकइ। (१) सकता है। 'सोऊ रघुबीर बिन सके दूरि करि को।' हनु० ४२ (२) सके, सकता हो । मा० २.२७६ छं०
1002
_______________________________________________
सको : सक्यो । 'सीव न चापि सको कोउ तब ।' कृ० ३२
सकोच : (१) संकोच । मा० २.३१४.७ (२) प्रार्थना । 'जासु सनेह सकोच बस राम प्रगट भए आइ ।' मा० २.२०६
सकोचह : आ०प्रए । प्रार्थना करता है, अनुनय आदि से विवश करता (संकोच में डालता-ती) है । 'गोरि गनेस गिरीसहि सुमिरि सकोचइ ।' जा०म० १००
सकोचत : वकृ०० । प्रार्थनाओं से अनकल बनाता-बनाते । ‘सोचत सकोचत बिरंचि हरि हर को।' गी० १.६६.२ ।।
सकोचहीं : आ०प्रब० । प्रार्थनाओं से अभीष्ट पाने हेतु विवश या अनुकल करते हैं। 'सफल सिहि सकोचहीं।' जा०म०/०१०
सकोचिनि : वि०स्त्री० (सं० संकोचिनी)। सिकोड़ने वाली। 'मोचिनि बदन सकोचिनि ।' रान० ७
सकोचा : सकोच । संकोच+प्रार्थना। पूछा सिवाह समेत सकोचा।' मा० १.५७.६
सकोची : संकोची। (१) संकोचशील । 'बालक सुठि सुकुमार सकोची।' गी० १.१०१.३ (२) अभ्यर्थनाशील । 'सोचत सकोचत सकोची बानि धरी है।' गी० १.६२.२
सकोचु, सकोचू : (१) सकोच+कए । संकोच, सिमटन । 'तन सकोचु मन परम उछाहू ।' मा० १.२६४.३ (२) मानसिक संकोच । 'अंतरजामी प्रभूहि सकोच ।' मा० २.२६६.५
सकोप, सकोपा : क्रोधसहित । मा० ७.१११ क; १३ ।
सकोपि : पूक० । सकोप होकर, क्रुद्ध होकर । 'उहाँ सकोपि दसानन सब सन कहत रिसाइ ।' मा० ६.३२
सकोरी : भक०स्त्री० (सं० संकोटिता=संकोचिता>प्रा० संकोडिआ)। सिकोड़ ली, कुञ्चित को। 'सुनि अघ नरकहु नाक सकोरी।' मा० १.२६.१
सकोरे : भूकृ०० (सं० संकोटित>प्रा० संकोडिय) । सिकोड़े हुए, आकुञ्चित किये, समेटे हुए। 'तकत सुभौंह सकोरे ।' गी० ३.२.४
सकोहा : सकोप (सं० सक्रोध>प्रा० सक्कोह)। क्रुद्ध । 'रावन आवत सुनेउ सकोहा ।' मा० १.१८२.६
सकौं : सकउँ । गी०५२०.१
सक्ति : शक्ति । (१) सामर्थ्य, क्षमता । (२) अर्हता, योग्यता । (३) कौशल, दक्षता । 'अजित अमोघ-सक्ति करुनामय ।' मा० ६.११०.६ (४) भगवान की योगमाया (लक्ष्मी या सीता) । 'परम सक्ति समेत अवतरिहउँ।' मा० १.१८७.६ (५) दुर्गा, पार्वती। मा० १.६८.३ (६) एक प्रकार का खड्ग या शस्त्रविशेष । मा० ३.१९ छं० (७) सांग (प्रहरणविशेष)। 'मुरुछा भई सक्ति के लागें ।' मा० ६.५४.८ (८) देवी ।
सक्तिन्ह : सक्ति+संब० । शक्तियों, देवियों। 'सक्तिन्ह सहित सकल सुर तेते ।' मा० १.५५.१
सक्यो : सकेउ । 'नाम सक्यो नहिं धोइ ।' दो० ५३१
सक : सं०० (सं० शक्र) । इन्द्र । मा० १.४.१०
सक्रसुत : इन्द्र-पुत्र-जयन्त । मा० ५.२७.५
सक्रारि : इन्द्रजित् = मेघनाद । मा० ६.२७
सक्रोध : वि० (सं.)। सकोप, क्रुद्ध । मा० ३.२६.२१
सखन्ह : सखा+संब० । सखाओं (को)। 'प्रथम सखन्ह अन्हवावहु जाई।' मा० ७.११.२
सखर : वि० (सं.)। खर-युक्त । (१) खर नामक राक्षस से युक्त । (२) तीव्र (खर) वीर-रौद्र आदि रसों से युक्त । मा० १.१४ घ
सखहि : सखा को (से)। पूछत सखहि ।' मा० २.२१६.६
सखा : सखा ने । 'लखन सखां सब कीन्ह सुपासू ।' मा० २.१०५.१
सखा : सं०० (सं.)। साथ खेलने वाला मित्र, सहचर । मा० १.१५.४
सखाउ : सखा भी । 'सब सुमति साध सखाउ !' गी० ७.२५.५
सखि : सखी+संबोधन (सं०) । हे सखी । मा० २.२०.८
सखिन, सखिन्ह : सखी-संब० । सखियों (ने)। 'सखिन्ह सिखावन दीन्ह ।' मा० २.५०
सखियाँ : सखी+ब० । 'सखियां सिखावतीं। कवि० १.१३ ..
सखीं : सखियाँ । 'मुदित मातु सब सखी सहेली।' मा० २.१.७
सखी : सं०स्त्री० (सं.)। सहचरी, मित्र स्त्री । मा० १.२२८.७
सगन : वि० (सं० सगण)। गणों सहित, सभी साथियों युक्त । कृ०६१
सगर : सं०पू० (सं.)। रामचन्द्र के एक पूर्वज । विन० १८.२
सगरम : सगर्भ । गर्भवती । 'सब सगरभ सोहहिं सदन ।' रा०प्र० ४.१.३
सगरे : वि०पू०ब० (सं० सकला:>प्रा० सगलया>अ. सगलय)। सब-के-सब, बहुत । 'तनु पोषक नारि नरा सगरे ।' मा० ७.१०२.५
सगर्भ : वि० (सं.)। (१) गर्भवती। (२) गम्भीर अर्थ की व्यञ्जना वाला, गूढ अर्थ-युक्त । 'नारद बचन सगर्भ सहेतू ।' मा० १.७३.३
सगलानि : (दे० गलानि) क्रि०वि० । ग्लानिपूर्वक, खेद के साथ, दुःख अनुभव करते हुए । 'ध्रुवं सगलानि जपेउ ।' मा० १.२६५
1004
_______________________________________________
सगाईं : सगेपन में, घनिष्ठता (आत्मीयता) में। 'सब सुचि सरस सनेह सगाई।' ____मा० २.३१४.१
सगाई : सं०स्त्री० (सं० स्वकता>प्रा० सगाया)। सगापन, आत्मीयता । 'जहं लगि जगत सनेह सगाई ।' मा० २.७२.५
सगुण : (१) वि० (सं०) । गुणयुक्त। (ब्रह्म-सन्दर्भ में) । सत्यसंकल्पता, सत्यकामता, सर्वज्ञता, सर्वक त्व, व्यापकता, अजरामरता, निरीहता आदि कल्याण गुणों से सम्पन्न (जो वैष्णवदर्शन की मान्यता है) स्वेच्छा से मायागुणों द्वारा रूप लेकर साकार होने वाला। मा० ३.११.११ (२) सं०पु. (सं० सद्गुण>प्रा० सग्गुण) । उत्तम गुण-दे. सगुनु ।
सगुन : (१) सगुन । कल्याण गुण युक्त ब्रह्म राम (जो मायागुणों से परे होने के कारण निर्गुण भी है) । 'अगुन सगुन बिच नाम सुसाखी।' मा० १.२१८ (२) मायागुण ग्रहण कर साकार । 'अगुन सगुन दुइ ब्रह्म सरूपा।' मा० १.२३.१ 'राम सगुन भए भगत पेमबस ।' मा० २.२१६.६ (३) सं०० (सं० शकुन> प्रा० सगुण) । मङ्गलसूचक पक्षी आदि चिन्ह । 'सगुन होहिं सुंदर सकल ।' मा० ७ दोहा २
सगुननि : सगुन+संब० । शकुनों (ने) । गी० १.४७.३
सगुनिअन्ह : सगुगिआ (शकुन-शाता) संब० । सगुन जानने वालों ने । 'कहेउ सगुनिअन्ह खेत सुहाए।' मा० २.१६२.४ ।।
सगुनु : सगुन+कए० (दे० सगुण) । सद्गुण । मा० २.२३२.५
सगुनोपासक : (दे० सगुण) लीलावतारी पुरुषोत्तम के आराधक; लीलारस के भोक्त-वात्सल्य, सख्य तथा माधुर्य भावों के भक्त । 'सगुनोपासक मोच्छ न लेहीं।' मा० ६.११२.७
सगे : वि००० (सं० स्वक>प्रा० सग)। आत्मीय । “सगे सजन प्रिय लागहि जोसें ।' मा० १.२४२.२
सगो : वि०पु०कए० (सं० स्वक:>प्रा० सगो) । आत्मीय, सगा। सोइ सगो सो सखा सोइ सेवक ।' कवि० ७.३५
सगौरि : गौरी (उमा) के सहित (शिव) । हनु० १३
सघट : वि०+क्रि०वि० (सं०) । घटसहित, घड़ा लिये हुए । मा० १.३०३.४
सघन : वि० (सं०)। (१) मेघयुक्त । (२) गहन, अविरल । 'पुरइनि सघन  ओट जल ।' मा० ३.२६ क
सचकित : वि० (सं.)। विस्मयाविष्ट, अकचकाये हुए। मा० २.२२६ छं०
सचर : वि० । गतिशील, चलनात्मक, जंगम । 'अचर सचर चर अचर करत को।' मा० २.२३८.८
_______________________________________________
1005
सचराचर : वि० (सं०) । चराचर सहित, स्थावर तथा जंगम पदार्थों सहित, चेतन-जड़ तत्त्वों से युक्त । मा० ७.२१
सचान : सं०० (सं० शशादन>प्रा० ससान) । श्येन, बाज पक्षी। 'जनु सचान बन झपटेउ लावा।' मा० २.२६.५
सचि : (१) पू० (सं० संचित्य>प्रा० संचिअ>अ० संचि) । संचित कर, समेट कर । (२) साँचे में ढालकर । 'राखीं सचि कबरी पीठ पर ये बात बकुचौंहीं।' कृ० ४१
सचिउ : सचिव+कए । मन्त्री । 'सचिउ सभीत सकइ नहिं पूछो।' मा० २.३८.८
सचि-पचि : (सचि+पचि) संचित कर+कष्ट उठाकर । 'करौं जो कुछ धरौं सचि-पचि सुकृत सिला बटोरि ।' विन० १५८.४
सचिव : सचिव ने । 'सचिव सँभारि राउ बैठारेमा० २.४४.२
सचिव : सं०पू० (सं.)। मन्त्री। मा० २.३६.८
सचिवन, सचिवन्ह : सचिव+संब० । सचिवों (ने, से, के, को)। 'सचिवन अस मत प्रभुहि सुनावा ।' मा० ६.६.४ 'सचिवन्ह सहित बिभीषन आए। मा० ५.२४.६
सचिवहि : सचिव को । “सचिवहि अनुजहि प्रियहि सुनाई।' मा० २.८७.६
सची : शची । इन्द्राणी । मा० २.१४१
सच : सं००कए० (सं० सत्त्वम् >प्रा० सच्च>अ० सच्चु)। (१) उत्साह,. उल्लास । 'सिर धरि बचन चले सच पाई।' मा० १.२८७.६ (२) सुख, तुप्ति, तुष्टि । बिनोदु सुनि सचु पावहीं।' मा० १.६६ छं० (३) विनोद, आमोद-. प्रमोद । 'हंसहि संभुगन अति सचु पाएँ ।' मा० १.१३४.५
सचेत, सचेता : वि.पु० (सं० सचेतस्) । चेतनायुक्त, सजग । मा० २.३०२
सचेतन : वि० (सं०) । चेतनायुक्त, प्राणी (विशेषतः तर्कशील मानव) । मा० १.८५.३
सचेतू : सचेत+कए । सजग, जाग्रत्, पूरे होश-हवास के साथ । 'बैठ बात सब सुनउँ सचेतू ।' मा० २.१७६.५
सच्चरित : वि० (सं०) । सदाचारी, उदार, उदात्त चरित्रयुक्त । मा० ७.२८ छं०
सच्चिदानंद : सं०वि० (सं०) । ब्रह्म का यह स्वरूप-लक्षण है। (१) वह सत्स्वरूप =अपरिणामी, निर्विकार है। (२) चित् = पूर्ण चैतन्य युक्त है। (३) आनन्द का अधिष्ठान है। तीनों का असीम धनीभूत रूप ब्रह्म । मा० ७.२५
सच्चिदानंदमय : सत्, चित तथा आनन्द गुणों से परिपूर्णब्रह्म । मा० २.८७
सच्चिदानंदा : सच्चिदानंद । मा० १.१४४.१
सच्चिदानंदु : सच्चिदानंद+कए । एकीभूत सत्, चित् ओर आनन्द । 'सीय रघुचंदु 'जन . भगति सच्चिदानंदु ।' मा० २.२३६
1006
सज, सजई : आ०प्रए० (सं० सज्जते, सज्जयति>प्रा० सज्जइ) । सजता है। सजाता है, बनाता-संवारता है, व्यवस्थित करता है। 'मो कहें तिलक साज सज सोऊ ।' मा० २.१८२.२ 'दलि दुख सजइ सकल कल्याना।' मा० २.२५५.७
सजग : वि०+क्रि०वि० (सं० सजागर>प्रा. सजग्ग)। जागरूक, सावधान ।  'काजु संवारेहु सजग सबु ।' मा० २.२२
सजत : वकृ०० । सजाते-बनाते-संवारते । 'भयउ पाखु दिन सजत समाजू ।' मा० २.१६.३
सजति : वक स्त्री० । सजाती-सँवारती । 'भूषन सजति ।' मा० २.२६
सजन : (१) सं०० (सं० सज्जन)। उदार पुरुष । (२) (सं० स्वजन) आत्मीय जन । 'सास ससुर र सजन सहाई।' मा० २.६५.२ (३) पूकृ० (सं० सज्जितुम>प्रा० सज्जिउं>अ० सज्जण) । सजाने, बनाने-संवारने । 'लगे सुमंगल सजन सब ।' मा० २.८
सजनी : संस्त्री० (स्वजनी) । आत्मीया सहचरी, अन्तरङ्ग सखी। 'रानी कहहि बिलोकहु सजनी ।' मा० १.३५८.३
सजल : वि० (सं०)। (१) जल-युक्त । (२) (नेत्रों के प्रसंग में) अश्रुपूर्ण । 'सजल नयन राजीव ।' मा० ७.१८
सजहिं : आ०प्रब० (सं० सज्जन्ते>प्रा० सज्जति>अ. सज्जहिं) । सजाते हैं। . मा० २.२३
सजहि : आ० -- आज्ञा, प्रार्थना-मए० (सं० सज्जस्व>प्रा० सज्जहि)। तू सुसज्जित कर । 'भूषन सजहि मनोहर गाता।' मा० २.२६.७
सजहु : आ०मब० (अ० सज्जहु) । सजाओ । 'सजहु तुरग रथ नाग।' मा० २.६
सजाइ : (१) सं०स्त्री० (फा० सजा) । दण्ड । 'दीन्ही मोहि सरूप सजाइ ।' गी० ७.३०.१ (२) पूकृ० । सुसज्जित करवा कर ।
सजाई : सजाइ । (१) दण्ड । अपराध-निष्कृति । 'तो बिधि देइहि हमहि सजाई।' मा० २.१६.५ (२) सुसज्जित करवा कर । 'सब साजु सजाई। देउँ भरत कहुं राजु ।' मा० २.३१.८
सजाए : भूकृ००ब० । सुसज्जित कराये, बनवाये । 'सब साज सजाए।' गी० १.६.८
सजाय : सजाइ । सजा, दण्ड । 'पहहि सजाय नत कहत बजाय ।' हनु० २६
सजायउ : भूक.पु०कए० । सुसज्जित कराया। 'भ-धर भोरु बिदा कर साज सजाय उ ।' पा०म० १४०
सजि : पूक० (सं० सज्जित्वा>प्रा० सज्जिअ>अ० सज्जि)। (१) सुसज्जित कर। 'सजि सारंग एक सर हते सकल दस सीस ।' मा० ६.६६ (२) उत्पन्न कर, जमा कर । 'सजि प्रतीति बहु बिधि गढ़ि छोली ।' मा० २.१७.४
_______________________________________________
1007
सजीव : वि० (सं०) । जीवधारी, प्राणवान् । मा० ६.७१.३
सजीवन : वि० (सं० संजीवन) । जीवनदायी, नीरोगकारी । 'संसृति रोग सजीवन ___मूरी।' मा० ७.१२६.२
सजीवनि : सं०+वि०स्त्री० (सं० संजीवनी)। जीवित करने वाली, जीवन दायिनी । मा० २.५६ 'प्रीति सजीवनि बेलि ।' कृ० २६
सजीवनु : सजीवन+कए। एकमात्र जीवनप्रद । 'अमिअ सजीवन ।' मा०
सजें : क्रि०वि० । शृङ्गार सज्जा किये हुए । 'जुबतीं सजें करहिं कल गाना।' मा० ७.६.६
सजे : भूक पुब० (सं० सज्जित>प्रा० सज्जिय)। सुसज्जित-शृङ्गारित किये। 'अंग अंग सजे बनाइ ।' मा० ७.११
सजेउ : भूक.पु०कए । सजाया । 'भूप सजेउ अभिषेक समाजू ।' मा० २.१०.२
सजे : सजइ । विन० १३५.३ ।।
सज्जन : सं०+वि० (सं०) । उत्तम जन, साधु पुरुष । मा० ७.२६.१
सज्जननि, सज्जनन्हि : सज्जन+संब० । सज्जनों (को, के लिए)। दो० १६४
सज्या : सं०स्त्री० (सं० शय्या) सेज । 'तृन सज्या दुम प्रीति ।' दो० १६२
सठ : शठ । दुष्ट, हठी। सदोष होकर भी अपने को निर्दोष ही मानने वाला तथा दूसरे को ही दोषी ठहराने वाला दुराग्रही । तर्क संगत बात भी न मानने वाला नीच । मा० १.३.६
सठई : सं०स्त्री० (सं० शठता) । दुराग्रहपूर्ण कर्म । 'नंदनंदन हो निपट करी सठई।' कृ० ३६
सठताई : सठई । मा० ७.४६.८
सठन्ह, सठन्हि : सठ+संब० । शठों (को, के)। मा० ५.२१.७, २.३२६ छं०
सठही : शठ को । 'यह न कहिअ सठही हठसीलहि ।' मा० ७.१२८.३
सठहु : सठ+सम्बोधन । ऐ दुष्टो । 'सठहु तुम्हार दरिद्र न जाई ।' मा० ६.८८.३
सठु : सठ+कए० । एक ही शठ । 'मैं सठु सब अनरथ कर हेतू ।' मा० २.१७६.५
सड़सिन्ह : सड़सी+संब० । सड़सियों (से) । मा० ६.२३ ।
सड़सी : सं०स्त्री० (सं० संदंशिका>प्रा० संडंसिआ)। बड़ी चिमटी जिससे तार ___आदि पकड़ कर खींचा जाता है ।
सत : (१) संख्या (सं० शत) । सौ, सैकड़ा । 'कहेसि कथा सत सवति के 1' मा० . २.१८ (२) संख्या (सं० सप्त>प्रा० सत्त)। सात । 'सत पंच चौपाई मनोहर ।' मा० ७.१३० छं० २ (३) वि०० (सं० सत्)। उत्तम, साधु । जैसे, सतसंगति, सतगुरु आदि । (४) ब्रह्म का स्वरूप (दे० सच्चिदानंद)। 'सत चेतन घन आनंद रासी।' मा० १.२३.६ (५) वि० (सं० सत्, सत्य) । सच्चा, यथार्थ । 'सत हरि भजन जगत सब सपना ।' मा० ३.३६.५ (६) सं०पू० (सं० सत्त्व>प्रा० सत्त) । साहस, उत्साह, सार, स्वरस ।
सतकर्मा : शुभ कर्म, पुण्यकार्य । मा० ३.२१.८
सतगुन : (दे० सत) । (१) सत्त्वगुण =प्रकृति का सुखात्मक गुण । (२) (सं० सद्गुण) । उत्तम गुण, उपकार आदि धर्म । 'बिपति काल कर सतगुन नेहा ।' मा० ४.७.६
सतगुरु : सं०० (सं० सद्गुरु)। उत्तम गुरु, सत् (परमार्थ तत्त्व) का उपदेशक आचार्य (वैष्णव मत में आचार्योपदेश ज्ञान तथा भक्ति का आधार है) । 'जहाँ सांति सतगुरु की दई ।' वैरा० ५१
सतड़ित : वि० (सं० सतडित्) । बिजली सहित । गी० ३.१.१
सतत : संतत । निरन्तर । मा० ४ श्लो०२
सतभाय, सतभाव : (दे० सत) सत्यभाव, सात्त्विक भाव, सद्भाव = यथार्थ विनीत अभिप्राय । 'सूधी सतभाव कहें मिटति मलीनता ।' विन० २६२.४
सतर : वि० (सं० सत्त्वर>प्रा० सत्तर)। भावावेश आदि से वक्र-चञ्चल । 'कान्हहू पर सतर भौंहैं महरि मनहिं बिचारु ।' कृ० १४
सतरंज : सं०स्त्री० (फा० शतरंज) । गोटों का खेलविशेष । विन० २४६.४
सतराइ : पू० (दे० सतर)। चिढ़ा हुआ त्वरित प्रतिकूल गति लेकर । इतरा कर । 'सोई सतराइ जाइ जाहि जाहि रोकए।' कवि० ५.१७ (रोकने पर और भी सत्त्वर चाल से चलता है) ।
सतरूपहि : शतरूपा को । 'सतरूपहि बिलोकि कर जोरें।' मा० १.१५०.३
सतरूपा : संस्त्री० (स० शतरूपा) । स्वायंभुवमनु की पत्नी । मा० १.१४२.१
सतसंग, सतसंगा : सं०० (सं० सत्संग) । सज्जनों का सम्पर्क, साधुजन संसर्ग । मा० १.३.६; ७.३३.८
सतसंगत : (दे० सत) (सं० संगत=मंत्री)। सज्जनों का मैत्री सम्बन्ध । 'सत संगत मुद मंगल मूला।' मा० १.३.८
सतसंगति : सं०स्त्री० (सं० सत्संगति)=सतसंग। मा० ७.४५.६
सतसमाज : (दे० सत) श्रेष्ठ, उत्तम समाज ; सज्जनों का समाज । मा० १.११३
सतां : (सं०) सज्जनों का-की-के । मा० ३.४.११; ६ श्लो० ३
सताइहै : आ०भ०ए० (सं० सन्तापयिष्यति>प्रा० संताविहिइ) । सन्तप्त करेगा, क्लेश देगा। 'सुरतरु तरे तोहि दारिद सताइहै ।' विन० ६८.२
सतानंद : सं०० (सं० शतानन्द)। अहल्या-गौतम के पुत्र-जनकराज के पुरोहित। मा० १.२३६
_______________________________________________
1009
सतानंदु : सतानंद+कए। मा० १.२३६.६
सतायो : भूक००कए० (सं० सन्तापित:>प्रा० संतावियओ>अ० संतावियउ) ।  संतप्त किया। 'ता पर दुसह दरिद्र सतायो ।' विन० २४४.४ '
सताव, सतावइ, ई : आ.प्रए० (संतापयति>प्रा० संतावइ)। सताता है। सन्ताप (क्लेश) देता है । 'ब्याधि सूल सतावई ।' विन० १३६.८
सतावन : वि.पु. (सं० सन्तापयित् >अ० संतावण)। सन्तापकारी, क्लेशदायी। 'खल मायाबी देव सतावन ।' मा० ६.७५.४
सतावहिं : आप्रब० (सं० संतापयन्ति>प्रा. संतावंति>अ० संतावहिं) । सन्ताप देते हैं, पीड़ित करते हैं, सताते हैं । 'असुर समूह सतावहिं मोही।' मा० १.२०७.६
सतावै : सतावइ । 'दारुन बिपति सतावै ।' विन० ११६.२
सतासी : संख्या (सं० सप्ताशीति>प्रा० सत्तासी) । मा० १.६०.२
सति : वि० (सं० सत्य) । सच्चा। 'लखि नहिं सकहिं कपट सति भाऊ।' कृ० १२
सतिभाउ, सतिभाऊ : सतभाय+कए । (१) सद्भाव । 'बझि भरत सतिभाउ कुमाऊ।' मा० २.२७१.८ (२) सत्य भाव । 'प्रभु पद सपथ कहउँ सतिभाऊ ।' मा० २.२६६.८ (३) सात्विक आशय। मा० २.३०४.२ (४) यथार्थ । 'है सपना बिधि कधौं सतिभाउ।' गी० ३.७.४
सतिभाएँ : सात्त्विक-सत्य-सद्-भाव से। 'बहुरि दि खलगन सतिभाएँ ।' मा० १.४.१
सतिमायँ : सतिभाएँ । 'अति सनेहँ सतिभाय पायें परि पुनि पुनि ।' पा०म० १३
सतिभाय : सतभाय । कह सनेह सतिभाय ।' मा० २.२८४
सतिभाव : सतभाव । निश्छल आशय । 'मैं तुम सों सतिभाव कही है।' गी० २.६.१
सतिहि : सती (को, से) । 'सतिहि बिलोकि जरे सब गाता।' मा० १.६३.३
सतीं : सती ने । 'सती हृदयें अनुमान किय ।' मा० १.५७
सती : सं०+वि.स्त्री० (सं.)। (२) महादेव की पूर्व पत्नी =दक्षपूत्री। मा० १.५६.८ (२) सच्चरित्रा स्त्री। मा० ७.१०१.३ (३) मृतक पति के साथ जल मरने वाली पतिव्रता । निकसि चिता ते अधजरति मानहं सती परानि।' दो० २५३
सतु : सत+कए० । सत्त्व, साहस, उत्साह, सार । 'निघटि गए सुभट, सतु सब को छुट्यो।' कवि० ४.४६
सतुआ : सं०० (सं० सक्तुक>प्रा० सत्तुअ)। भूने जो आदि का चूर्णविशेष । कवि० ६.५०
सतोगुन : सत्त्वगुण । विन० ४७.४
1010
_______________________________________________
सत्तर : संख्या (सं० सप्तति>प्रा० सत्तरि)। सत्तर । मा० १.१५६.८
सत्य : वि०+सं०पू० (सं०) । परमार्थ, यथार्थ, सत् । मा० १.६.११
सत्यकृत : वि०० (सं० सत्यकृत्) । सत्य का कर्ता। वैष्णवमत में जगत्प्रपञ्च सत्य ___ है, उसका कर्ता= परमेश्वर । विन० ५३.५
सत्यकेतु : सं०पू० (सं०) । एक राजा प्रतापभानु का पिता । मा० १.१५३.२
सत्यता : संस्त्री० (सं०) । यथार्थता, वस्तु-सत्ता, वास्तविकता । 'जासु सत्यता तें जड़ माया। भास सत्य इव ।' मा० १.११७.८
सत्यधाम : वि० (सं० सत्यधामन्) । (१) सत्य प्रकाश (धाम) वाला। (२) सत्य का अधिष्ठान=सत्य कामता, सत्य-संकल्प आदि कल्याण गुणों का आधार । (३) परमार्थ तत्त्वरूप । “सत्यधाम सर्वग्य तुम्ह ।' मा० १.४६
सत्यव्रत : वि० (सं० सत्यव्रत) । सत्य संकल्प, दृढप्रतिज्ञ । मा० २.२०७.४
सत्यमूल : वि.पु. (सं.)। ऐसे, जिनका मूल कारण सत्य है; सत्य से ही जनित । 'सत्यमूल सब सुकृत सुहाए।' मा० २.२८.६
सत्यरत : वि० (सं०) । सत्य में रमण करने वाला सत्य संकल्प । विन० ५३.५
सत्यलोक : सात ऊर्ध्व लोकों में सर्वोपरि लोक =ब्रह्मलोक । मा० १.१३८
सत्यसंकल्प : वि० सं० सत्य: संकल्पो यस्य स सत्यसंकल्पः) । अमोध संकल्प वाला (वैष्णव मत में ब्रह्म का यह-सत्यसंकल्पता-कल्याण गुण है) । 'राम सत्य संकल्प प्रभु ।' मा० ५.४१
सत्यसंध : वि०० (सं0- सत्या सन्धा यस्य स सत्यसंध:) । (१) दृढप्रतिज्ञ (सन्धा= प्रतिज्ञा)। सत्यसंध तुम्ह रघुकुल माहीं ।' मा० २.३०.४ (२) अमोघ बाण संधान करने वाला (सन्धा-सन्धान)। 'सत्यसंध छाँड़े सर लच्छा।' मा० ६.६८.३
सत्यसंधान : सत्यसंध (सं.)। विन० ५५.३
सत्यसार : वि० (सं०) । सत्य ही जिनका तथा जिनके लिए सार तत्त्व है सत्यधन (सत्यवती) । मा० ३.४५.८
सत्रु : सं० (सं० शत्रु) । शातनकर्ता=मारक । रिपु, वरी । मा० ४.७.१८
सत्रुघुन : सत्रुहन (सं० शत्रुधन) । मा० २.१६३.१
सत्रुसमन : सत्रुहन (सं० शत्रुशमन --शमन = अन्तक) । दो० १२१
सत्रुसाल : वि०+सं०० (सं० शत्रुशल्य) । (१) रिपुओं को शल्यवत् चुभने वाला । (२) शत्रुघ्न । गी० १.४२.१
सत्रुसूदन : (सं० शत्रुसूदन)। (१) शत्रुसंहारक । (२) शत्रुघ्न नामक दशरथ पुत्र । मा० १.३११.७
सत्रुहन : सं०पू० (सं० शत्रुघ्न) । सुमित्रा के छोटे पुत्र का नाम । मा० २.१७३
_______________________________________________
1011
सत्त्व : सं० (सं०)। (१) त्रिगुण प्रकृति का प्रथम गुण जो सुखात्मक तथा ज्ञान-प्रकाशरूप होता है । मा० ७.१०४.२-४ (२) सार, निष्कर्ष । (३) जन्तु । (४) सत्ता, होना, विद्यमानता । मा० १ श्लोक ६
सत्त्वगुण : प्रकृति का प्रथम गुण (दे० सत्त्व)।
सत्त्वगुणप्रमुख : सत्त्वगुण आदि=त्रिगुण = सत्त्व, रजस् और तमस् तीनों प्रकृति गुण जो क्रमश: ज्ञान-सुख, क्रिया-दुःख तथा मोह के कारण हैं । विन० ५८.२
सत्संग : (दे० सतसंग) । विन० ५७.१
सदई : सदैव । सदा ही। 'गई बहोर बिरद सदई है।' विन० १३६.१२
सदगुन : सं. (सं० सदगुण)। (१) उत्तम मानवीय गुण = दया, क्षमा, सन्तोष, प्रेम आदि । मा० ७.२ छं० (२) ब्रह्म के कल्याणगुण =सत्यसंकल्पता, सत्य. कामता, सर्वज्ञता, सर्वकर्त ता, अजरामरता, क्षुधा-पिपासा-हीनता आदि । मा० ७.१३ छं०६
सदगुनाकर : (दे० सदगुन)। कल्याण गुणों का आधार । 'करुनायतन प्रभु सदगुनाकर ।' मा० ७.१३ छं०६
सदगुर, सदगुरु : सतगुरु । ब्रह्मोपदेशक आचार्य । मा० ७.४४.८
सदग्रंथ : सं०० (सं० सद्ग्रन्थ) । बेद, शास्त्र आदि प्रामाणिक उत्तम ग्रन्थ । मा०
सदन : सं०० (सं०) । भवन, घर। मा० २.६.५
सदननि : सदन+संब० । घरों । गी० २.५१.२
सदनि : सदन+स्त्री० । आवास, आधार, आवास देने वाली । विन० १६.१
सदनु : सदन+कए० । घर । 'सुरपति सदनु न पटतर पावा ।' मा० २.६०.७
सदय : (१) वि० (सं०) । दयालु । सदय हृदय दुखु भयउ बिसेषी।' मा० २.८५.१ (२) क्रि०वि० । दयापूर्वक । 'हहरि हिय में सदय बुझ्यो।' विन० २१६.३
सदल : वि० (सं०) । सेनासहित । मा० ६.११६.६
सदसि : (सं० सदसि सभा में-सदस सभा) । 'पांडु सुवन की सदसि ते नीको ___ रिपु हित जानि ।' दो० ४१६ (सदसि ते=सभा में रहने की अपेक्षा ।)
सदा : अव्यय (सं.)। सर्वदा, सभी समयों में । मा० १.४.११
सदाई : सदई, सदेव । सभी दशाओं में, सभी अवसरों पर । 'जथा-लाभ संतोष सदाई।' मा० ७.४६.३
सदाचार : सं०० (सं.)। उत्तम आचरण, विहित कर्म करने की प्रवृत्ति । मा० १.८४.८
सदासिव : सं०० (सं० सदाशिव) । (१) शङकर, शिव । 'चाहिअ सदसिवहि भरतारा ।' मा० १.७८.७ (२) परम शिव (ब्रह्म) के तीन रूप हैं-सदाशिव, ७.७ ईश्वर और शुद्ध विद्या । इनमें सदाशिव ज्ञान शक्ति प्रधान है और प्रायः 'शिव' अर्थ में चलता है। बिनती सुनहु सदासिव मोरी।' मा० २.४४.७
सदासीन : (सदा+आसीन) । सर्वदा विराजमान, सदा विद्यमान। सदा बैठे हुए । 'वद्रिकाश्रम सदासीन पद्मासनं ।' विन० ६०.५
सदृश : वि० (सं.)। समान । विन० ५१.२
सदेह : वि० (सं.)। सशरीर, भौतिक आकार युक्त, मतं । विन० २१४.५
सदैव : (सदा+एव) । सदा ही; सभी समयों में । मा० १.२६६.५
सदोष : वि० (सं०) । दोषयुक्त, दूषित, विकारयुक्त । मा० २.१८३
सद् धर्म : सं०० (सं.)। (१) कल्याणगुण (सदगुन)। मा० ४ श्लोक १ (२) उत्तम धर्माचार । जिमि कपूत के उपजे कुल सद्धर्म नसाहिं।' मा० ४.१५
सद्म : सं०० (सं० सद्मन्) । सदन; घर । विन० ५१.६
सद्य : (१) क्रि०वि० (सं० सद्यस्) । शीघ्र ही, तत्काल । 'करउँ सद्य तेहि साधु समाना।' मा० ५.४५.३ (२) वि० (सं० सद्यस्क) । प्रत्यग्र, ताजा । 'करि सब सोनित पान ।' मा० ६.१०१.२ ।।
सद्युक्ति  : सं०स्त्री० (सं०) । श्रेष्ठ उपाय, कौशल (दे० जुगुति) । विन० ५७.७
सधन : वि० (सं.)। धन-सहित । दो० २०७
सधरम : (सं० सधर्म) । धर्मयुक्त । दो० ५३०
सन : (१) अव्यय (परसर्ग) । से। 'नृप सन अस बर दूसर लेहू ।' मा० २.५०.४ (२) ओर । 'बहुरि बिलोकि विदेह सन ।' मा० १.२६६ (३) सं० (सं.. शण)। पटसन (सनई या जूट के समान एक सुप जिसकी त्वचा से रस्सी बनती है)। 'सन इव खल पर बंधन करई ।' मा० ७.१२२.१७
सनक : (दे० सनकादि) । विन० ५०.९
सनकादि : (सं.)। ब्रह्मा के चार मानस पुत्र=सनक, सनन्दन, सनातन और सनत्कुमार । मा० ७.३५
सनकादिक : सनकादि । मा० ७.३१.३
सनकादी : सनकादि । मा० ३.६.५
सनकार : सं०स्त्री० । इङ्गित, कायिक संकेत (अङ्गलिनिर्देश आदि) । 'समय सुकरना सराहि सनकार दी।' कवि०७.६३
सनकारे : भूक००० । संकेतों से बुलाये । 'सनकारे सेवक सकल ।' मा० २.१९६
सनमान : सं.पुं० (सं० सम्मान सम्मान) । सत्कार, आदर । 'सब कर करि सनमान बहूता।' मा० ४.१९.६
सनमानत : वकृ. । सत्कार करता-करते । गी० १.४२.३
_______________________________________________
1013
सनमानहिं : सनमान+प्रब० । (१) सम्मान देते हैं। 'सुनि सनमानहिं सबहि सुबानी।' मा० १.२८.६ (२) सम्मान दें। जो सनमानहिं सेवकु जानी।' मा० २.२३४.१
सनमाना : (१) सनमान । 'कीन्ह सनमाना।' मा० १.१२५.३ (२) भूकृ००। सम्मानित किया । 'सहित बरात राउ सनमाना ।' मा० १.३०६.६
सनमानि : सनमान+पूकृ० । आदर देकर । मा० २.२८७
सनमानअत : सनमान+वकृ०कवा०पू० । आदर पाता-पाते; सम्मानित किया जाता-जाते । 'राम ही के द्वारे बोलाइ सनमानित ।' कवि० ७.२३
सनममानिये, सनममानिए : आ०कवा०प्रए । सम्मानित कीजिए-किया जाय-किया जाता है।  'सब सों सनेह सबही को सनमानिये ।' कवि० ७.१६८
सनमानींंं : भूकृ०स्त्री०ब० । सम्मानित की। 'गंग गोरि सम सब सनमानी ।' मा० २.२४५.२
सनमानी : (१) सनमानि । 'सेवहिं सनमानी।' मा० २.१२६.८ (२) भूक०स्त्री० । सम्मानित की। 'काई न सनमानी ।' मा० १.६३.१ (३) सम्मान पायी हुई । 'नंदसुवन सम्मानी ।' कृ० ४८
सनमानु, सनमानू : सनमान+कए । 'करि सनमानु आश्रमहिं आने ।' मा० २.१२५.२; मा० १.७.७
सनमाने : भूक००ब० । सम्मानित किये । मा० २.१०
सनमानेउ : भूकृ०पू०कए । सम्मानित किया। पा०म० ६५
सनमान्यो : सनमानेउ । गी० १.१७.६
सनमुख : (१) सन्मुख । सामने । मा० ६.७.१ (२) अनुकूल । 'बिधि सब विधि मोहि सनमुख आजू ।' मा० २.४२.१
सनाए : भूकृ.पुब० । श्रोतप्रोत कराये, मिश्रित कराये। 'भरि भरि सरवर बापिका अरगजा सनाए ।' गी० १.६.७
सनाथ : (१) वि० (सं.)। (अनाथ का विलोम) । कृतार्थ, सफल, पूर्णकाम । 'पुर नर नारि सनाथ करि भवन चले भगवान ।' मा० ७.६ (२) सहित, युक्त ।
सनाथा : सनाथ । मा० ४.२२.२
सनाधकुम : पक्षियों में अधम, नीच पक्षी। मा० ७.१२३.८
सानाला : वि० (सं० सनाल)। नाल-दण्ड सहित । 'सोहत जनु जुग जलज सनाला ।' मा० १.२६४.७
सनाह : (१) सं०० (सं० सन्नाह) । कवच । 'उठि उठि पहिरि सनाह अभागे।' मा० २.२६६.२ (२) सनाथ (प्रा० सणाह) । दे० सना ।
सनाहु : सनाह+कए । कवच । मा० २.१६०
1014
_______________________________________________
सनाहै : सनाह+ब० । सनाथ संयुक्त । 'गावत जिन्ह के जस अमर नाग नर सुमखि-सनाहैं।' गी० ७.१३.७
सनि : सं०० (सं० शनि) । (१) शनैश्चर ग्रह। (२) शनिवार। 'सनि बासर बिश्राम। रा०प्र० ७.२.२
सनीचरी : सं०स्त्री० । शनैश्चर (प्रा० सणिच्चर) की स्थिति । 'सनीचरी है मीता  की।' कवि० ७.१७७
सनीरा : (सं० सनीर) । सजल । मा० २.७०.२
सनेम, सनेमा : (दे० नेम) । नियमों से युक्त (शौच, सन्तोष, तप, स्वाध्याय तथा ईश्वर प्रणिधान-नियमों से संयुक्त) । मा० २.३१०.८; ३२३.७
सनेह : (१) स्नेह ने । 'गवनु निठुरता निकट किय जन धरि देह सनेहँ ।' मा० २.२४ (२) स्नेह से, में । 'मैं सिसु प्रभु सनेह प्रतिपाला ।' मा० २.७२.३
सनेहँ : सं०पू० (सं० स्नेह>प्रा० सणेह)। (१) प्रेम । 'आवत हृदयें सनेह बिसेषे ।' मा० १.२१.६ (२) चिकनाई-घी, तेल आदि । 'सुख सनेह सब दिये दसरथहि, खरि खलेल थिर-थानी।' गी० १.४.१३ (३) प्रेम+ चिकनाई।' 'रीझत राम सनेह निसोते।' मा० १.२८.१० (४) वि. (सं०. सस्नेह>प्रा० स-जेह-दे० नेह) । सप्रेम, नेह सहित ।
सनेहता : संस्त्री० (सं० सस्नेहता-दे० सनेह+नेह) । स्नेहशीलता । 'एक अंग जो सनेहता।' दो० ३१२
सनेहविषैनी : वि०स्त्री० (सं० स्नेहविषयिनी)। प्रेम के विषय की, स्नेह के बारे में होने वाली । गी० १.८१.३
सनेहमय : स्नेहप्रचुर, स्नेहपूर्ण, स्नेहस्वरूप (दे० मय)। मा० २.११७.२
सनेहा : सनेह । सप्रेम । मा० १.८२.३
सनेही : वि० (सं० स्नेहिन्) स्नेहयुक्त । (१) प्रेमी, प्रिय । मा० २.६४.३ (२) तेल (चिकनाई से युक्त) । 'तिली सनेही जानि ।' दो० ४०३ (प्रायः श्लिष्ट प्रयोग देखे जाते हैं ।)
सनेहु, सनेहू : सनेह+कए । अनन्य प्रेम । “सील सनेहु जानत रावरो।' मा० १.२३६ छं०; २.३.८
सन्तापनास : (सं० सन्तापनाश) दुःख-नाशक । मा० ७.१०८.१४ ।
सन्मुख : (१) वि० (सं० सम्मुख) । अनुकूल । (२) क्रि०वि० । सामने । मा० ७.३
सन्यपात : संनिपात । असाध्य त्रिदोषज रोगविशेष । 'गुनकृत सन्यपात नहिं के ही।' मा० ७.७१.१ (मूल अर्थ समूह है अतः अनेक भाषादि का मिश्रण अर्थ भी (अभिप्रेत है)।
_______________________________________________
1015

सपच्छ, सपच्छा : वि० (सं० सपक्ष) पंखों वाला-वाले। 'जनु सपच्छ धावहिं बहु नागा।' मा० ६.५०.५; ६७.६
सपथ : सं० (सं० शपथ)। सौंह, कसम । मा० १.२५३ इसके प्रयोग प्रायः स्त्री में होते हैं। तोहि स्याम की सपथ जसोदा।' कृ० ३
सपदि : अव्यय (सं.)। शीघ्र, तत्काल, तुरन्त । मा० ७.११२.१५
सपन, सपना : सं०० (सं० स्वप्न)। निद्रावस्था में दिखाई पड़ने वाली मानसी सष्टि । मा० १.७२ 'सबन्ही बोलि सुनाएसि सपना।' मा० ५.११.२
सपनें, सपने : स्वप्न में । 'सपने बानर लंका जारी ।' मा० ५.११.३
सपनेहुं : स्वप्न में भी। बिसरे गह सपनेहुँ सुधि नाहीं।' मा० ७.१६.१
सपनो : सपना+कए । 'अपनो न कछु सपनो दिन द्वै ।' कवि० ७.४१
सपरन : वि० (सं० सपर्ण) । पत्र सहित । मा० १.२८८.२
सपरब : वि० (सं० सपर्वन) । पोरों (गांठों) से युक्त । 'सरल सपरब परहिं नहिं चीन्हे ।' मा० १.२८८.१
सपरिजन : (दे० परिजन) परिजन (परिवारादि) सहित । मा० २.६६.३
सपल्लव : (सं०) पल्लव-सहित । जा०म० १८४
सपुर : वि० (सं०) । नगर समेत । जा०म० ८६
सपूत : सुपूत (सं० सत्पुत्र>प्रा० सप्पुत्त) । हनु०८
सपेम, सपेमा : सप्रेम । मा० २.२२२.१, ३२२.७
सपेला : सं०० (सं० सर्पक = ह्रस्वसर्प>प्रा. सप्पिल्ल=सप्पल्ल)। छोटा सांप, तुच्छ सर्प । मा० ६.५१.८
सप्त : संख्या (सं.)। सात । मा० ७.२२.१
सप्तधातु : (सं०) । शरीर रचना के सात तत्त्व= रस, रक्त, मांस, मेदा, अस्थि, मज्जा और शुक्र । विन० २०३.८
सप्तरिषि : (दे० रिषि) । सप्तर्षि=मरीचि, अङ्गिरा, अत्रि, ऋतु, पुलह, पुलस्त्य और वसिष्ठ । मा० १.७७.८
सप्तरिषिन्ह : सप्तरिषि+संब० । सप्तर्षियों (को, से) । मा० १.६१.५
सप्तावरन : (सं० सप्त+आवरण) । (१) भूः, भुवः, स्वः, महः, जनः तप: और सत्यम् -~-इन लोकों के सात वातावरण । (२) अन्नमय, प्राणमय, मनोमय, विज्ञानमय, आनन्दमय, मायमय और तुरीय-इन सात कोषों के अवरण (जिनके आधार पर ब्रह्म को सप्तात्मा कहा गया है) । (३) योग की सात भूमियाँ सवितर्क, निर्वितर्क, सविचार, निविचार, सानन्द, सस्मित और असंप्रज्ञात समाधियों के आवरण । मा० ७.७९
1016
_______________________________________________
सप्रकासू : (१) सं००कए० (सं० सत्प्रकाशः)। उत्तम प्रकाश (ज्ञान रूपी श्रेष्ठ ज्योति)। 'दलन मोह तम सो सप्रकासू ।' मा० १.१.६ (२) वि.पु.कए० (सं० सप्रकाशः) प्रकाश-सहित ।
सप्रिय : वि०० (सं०) । प्रियासहित । गी० २.२५.३
सप्रिया : वि.स्त्री० (सं०) । प्रिय-सहित स्त्री । गी० २.२५.३
सप्रीति : क्रि०वि०+वि० (सं.)। प्रेमपूर्वक प्रेम-सहित । 'बिनती करइ सप्रीति ।' मा० १.४
सप्रीती : सप्रीति । मा० २.६.६
सप्रेम : वि० (सं०) । प्रेमसहित, सस्नेह । मा० १.२.४
सप्रेमा : सप्रेम । मा० २.१६५.३
सप्रेमु : सप्रेम+कए० (क्रि०वि०) । 'मिलि सप्रेम पुनि आसिष दीन्ही ।' मा० १.३४२.८
सफरी : सं-स्त्री. (सं० सफरी= शफरी) । छोटी मछली । विन० १६७.२
सफल : वि० (सं.)। (१) फल युक्त । 'सफल रसाल पूगफल केरा।' मा० २.६.६ (२) पूर्ण काम, कृतार्थ । 'मोर मनोरथु सफल न कीन्हा।' मा० २.६६.४ (३) धर्मादि पुरुषार्थों को प्राप्त । 'तब निज जन्म सफल करि लेखों। मा० ७.११०.१४
सफूला : वि० । पुष्प-सम्पन्न, पुष्पित । मा० २.२३६.८
सब : वि० (सं० सर्व>प्रा० सव्व) । सकल, समस्त । मा० ७.२ ख
सबइ : सभी, सब कुछ, सभी बातें । 'प्रभु प्रसाद सिव सबइ निबाहीं।' मा० २.४.४
सबद : सब्द । मा० १.३१६.३
सबदरसी : (दे० दरसी) वि.पुं० (सं० सर्वदर्शिन् >प्रा० सम्वदरिसी)। सम्पूर्ण का द्रष्टा, सर्वज्ञ, अन्तर्यामीरूप से सब पर दृष्टि रखने वाला । मा० ७.७२.५
सबदी : संस्त्री० (सं० शब्द) । सन्तों आदि के पद जो सबदी' या 'सबद' नाम से जाने जाते हैं; विशेषतः हठयोगियों के पदों के लिए गोस्वामी जी ने प्रयुक्त किया है । 'साखी सबदी दोहरा ।' दो० ५५४ ।
सबनि, न्ह, न्हि : सब-+संब० । (१) सबों । ‘पर हित हेतु सबन्ह के करनी।' मा० ७.१२५.६ (२) सबों ने । 'सबन्हि बनाए।' मा० ७.६.२ (३) सबों में। 'सबन्हि परसपर प्रीति बढ़ाई।' मा० ७.२३.२ (४) सबों को। 'सेवइ सबन्हि मान मद नाहीं।' मा० ७.२४.८ 'सासुन्ह सबनि मिली बैदेही ।' मा० ७.७.१
सबन्हौं : सभी को । 'सबन्हौं आइ सुनाएसि सपना ।' मा० ५.११.२
सबर : सं०० (सं० शबर) । वन्य मानव जातिविशेष । मा० २.१९४
सबरिका : सबरी (सं० शबरिका) । गी० ३.१७.३
_______________________________________________
1017
सबरिहि : शबरी को। मा० ७.६६.७
सबरी : सं०स्त्री० (सं० शबरी)। (१) शबर जाति की स्त्री। जंगली शिकारी स्त्री। 'सबरी गान मगी जन मोही।' मा० २.१७.१ (२) शबर जाति की एक तापसी जिसे अरण्यकाण्ड में राम मिले थे । मा० ३.३४.५
सबरूप : वि०पू० (सं० सर्वरूप)। सभी रूपों में स्वयं ही आकार लेने वाला, सब का उपादानकारण । 'सब-रूप सदा सब होइन गो।' मा० ६.१११.१५
सबल : वि० (सं०) । बलयुक्त । मा० ६.७६ छं०
सबहिं, सबही : (१) सभी ने। 'सजे सबहिं हाटक घट नाना ।' मा० १.६६.३ (२) सभी से । 'सबहीं बिधि हीना ।' मा० ५.७.७
सबहि, सबही : सबको, सबके लिए। मा० १.१० क 'बरषि दिए मनि अंबर सबही ।' मा० ६.११७.६
सबाल : शिशु-सहित, बच्चा लिये हुए । मा० १.३०३.४
सबिकारा : वि० (सं० सविकार)। विकारयुक्त, सदोष (कामादि मनोविकारों ___वाले) । 'अब लगि संभु रहे सबिकारा ।' मा० १.६०.२
सबिता : सं०० (सं० सवित्) । सूर्य । गी० ७.१३.२
सबिधि : क्रि०वि० (सं० सविधि)। विधिपूर्वक, शास्त्रविहित रीति से । मा० २.२०४.४
सबिनय : वि० (सं० सविनय) । विनीत, शिष्टाचारयुक्त । मा० २.३१.४
सबिबेका : वि०+क्रि०वि० (सं० सविवेक)। विवेक सहित, विवेकपूर्वक । उचित विचार सहित । मा० १.४१.२
सबिष : वि० (सं. सविष) । विषयुक्त, विषदिग्ध । मा० ६.६६.६
सबिषाद, सबिषारा : वि.+क्रि०वि० (सं० सविषाद)। विषादयुक्त, विषाद के साथ । मा० २.१८६.२ 'सुनि सबिषाद सकल पछिताहीं ।' मा० २.११०.६
सबीज : वि० (सं.)। बीज मन्त्र (ओंकार आदि) से युक्त । 'मंत्र सबीज सुनत  जन जागे।' मा० २.१८४.२
सबील : सं०स्त्री (अरबी-सबील-मार्ग, मार्ग पर शर्बत आदि का मुफ्ती प्रबन्ध) । उपाय, प्रबन्ध, सहाय-व्यवस्था । 'मैं बिभीषन की कछू न सबील की।' कवि० ६.५२
सबु : सब+कए । सब-का-सब, एकीभूत समष्टि । 'भिन्न भिन्न मैं दीख सब ।' मा० ७.८१
सबुइ : सभी, (एकीभूत) सब कुछ । 'साजिअ सबुइ समाजु ।' मा० २.४
सबेग : वि० (सं० सवेग) । वेगयुक्त, तीब्रगामी । मा० २.२४३.२
सबेरें, सबेरे : (१)क्रि०वि० (सं० सवेल =वेलानुसार, समयानुसार)। समय पर, शीघ्र । 'चितइए सबेरे ।' विन० २७३.३ (२) (सं० श्वोबेल-प्रभातवेला में) प्रातः काल (में)। 'कहौं ते बातें जे कहि भजे सबेरे ।' कृ०३
1018
_______________________________________________
सबेरो : सबेरे। शीघ्र । सनेह सों राम को होहि सबेरो।' कवि० ७३५
सबै : सबइ। (१) सभी। 'सो तो सबै मन की चतुराई ।' कृ० २५ (२) सब कुछ। 'सुलभ सबै जग माह।' दो०८० (३) सब में । 'हानि लाभ दुख सुख सबै समचित ।' विन० २६८.३
सब्द : सं०० (सं० शब्द) । (१) ध्वनि । (२) वर्ण, अक्षर, पद, वाक्य । (३) आकाश-गुण नो श्रवणेन्द्रिय का विषय है- शब्द तन्मात्र । विन० २०३.६
सभ : सब, सभी, सब कुछ (सब+ही) । 'अंतरजामी प्रभु सभ जाना।' मा० ७.३६.४
सभयँ : सभय होने से । 'सभयं सकोच जात कहि नाहीं।' मा० २.३०८.१
सभय : वि० (सं०) । भययुक्त, भयभीत । मा० १.८४.८
सभहि : सभा को । 'तब अहस्य भए पावक सकल सहि समुझाइ ।' मा० १.१८६
सभां : सभा में । 'बैठहिं सभी संग द्विज सज्जन ।' मा० ७.२६.१
सभा : सं०स्त्री० (सं०) । एक के नेतृत्व में एकत्र जन समुदाय । संसद्, परिषद् । मा० २.२९६
सभाग : (१) वि० (सं० सभाग्य) । भाग्यशाली। (२) (सं० सभाग) । सुविभवत +भाग (अंश) को प्राप्त । 'भूरुह भरि भरे जनु छबि अनुराग सभाग ।' गी० २.४७.५
सभासद : सं०+वि० (सं० सभासद्) । सदस्यगण, पारिषद, सभा में उपस्थित सभ्य जन । मा० ६.१६.८
सभीत, सभीता : वि० । भययुक्त । मा० १.५३, ५५.५
सभै : सभय । विन० । २४६.३
सम : (क) सं०० (सं० शम>प्रा० सम)। (१) शान्ति । (२) शान्तरस का स्थायी भाव । (३) वासना-शमन की चित्तदशा (जो वेदान्त की छह सम्पत्तियों में अन्यतम है) । 'सम दम राम भजन अधिकाई ।' वैरा०९ मा० ७६५.५ (ख) वि० (सं०)। (१) समान, तुल्य। मा० १.३.१० (२) बराबर । 'सम सुगंध कर दो।' मा० १.३ क (३) चौरस (विषम का विलोम) । (४) सुव्यवस्थित, ठीक । 'बदनु बिलोकि मुकुटु सम कीन्हा ।' मा० २.२.६ (५) सर्वत्र सम भाव रखने वाला, समदर्शी । 'सम अभूतरिपु बिमद बिरागी।' मा० ७.३८.२ (६) अनकूल, अनुसार, उचित । 'भयउ समय सम सबहि सुपासू ।' मा० २.२२१.१
समउ : (१) समय+कए । 'समउ फिरें रिपु होहिं पिरीते ।' मा० २.१७.६ (२)(समय:) शब्द की अर्थ बोधक शक्ति संकेत । 'समउ सनेह सुमिरि सकुचानी।' मा० २.३१५.३
_______________________________________________
1019
समचर : वि० (सं.)। सबके प्रति समान आचरण करने वाला। विन० १६१.३
समचित : वि० (सं० समचित्त) । चित्त में समता रखने वाला, सभी स्थितियों में भव्याकुल; स्थितप्रज्ञ, समत्वबुद्धियुक्त । विन० २६८.३
समता : सं०स्त्री० (सं०) । (१) धरातल आदि की समतलता (विषमता का विलोम) । (२) समानता, तुल्यता, उपमा। 'सिय मुख समता पाव किमि ।' मा० १.२३७ (३) मानसिक समरसता, समत्वबुद्धि । (४) अभेद, भेदराहित्य, एकरूपता (अद्वैत) । दीनबन्धु समता बिस्तारय ।' मा० ७.३५.४ ।
समतूल, समतूला : वि० (सं० सम-तुल्य>प्रा० समतुल्ल)। बराबर तुला के योग्य - उचित उपमान । 'सीय समतूल ।' मा० १.२४७ 'ते सिर कटु तुंबिर समतूला।' मा० १.११३.४
समत्थ : समरथ (प्रा.) । 'साहसी समत्थ तुलसी को नाह।' हन०६
समदरसी : वि०पू० (सं० समशिन >प्रा० समदरिसी) । (१) सब (सम) देखने वाला । (२) सबको समान रूप से देखने वाला। द्वन्द्वातीत, रागद्वेषरहित, निर्द्वन्द्व । 'समदरसी मुनि बिगत बिभेदा।' मा० ७.३२.५
समदि : पूकृ० (सं० सम्मदय्य) । प्रसन्न करके । मा० १.३५४.१
समहक : वि० (सं समहक) । समदरसी। विन० ५७.४
समधीं : समधी+ब० । दोनों समधी । 'ऐसे सम समधी समाज न बिराजमान ।' कवि० १.१५
समधी : सं०० (सं० सम्बन्धिन) । वर-वधू के पिता परस्पर 'समधी' कहे जाते हैं । मा० १.३०४.२
समन : (१) सं०० (सं० शमन)। यमराज, मृत्युदेव । 'समन कोटि सत सरिस कराला ।' मा० ७.६२.१ (२) वि०पू० । शान्त करने वाला । 'समन सकल भवत्रास । मा० ७ ६२
समनि, समनी : वि.स्त्री० । शान्त करने वाली । 'कलिमल समनि मनोमल हरनी ।' मा० ७.१२६.१ 'जो कलिमल समनी ।' गी० ७.२०.४
समबल : वि० (सं०) । समान बल वाला । मा० १.२८४.१
समय : समय पर, से, अनुसार । 'सेवकु समय न ढीठ ढिठाई।' मा० २.२२७.७
समय : सं०० (सं०) । (१) काल, अवसर । मा० ७.५८.१ (२) अनुकूल समय। 'समय प्रताप-भानु कर जानी । आपन अति असमय अनुमानी ।' मा० १.१५८.३ (३) प्रत्येक समय पर । 'समय सुहावनि पावनि भूरी।' मा० १.४२.१ (४) शपथ, प्रतिज्ञा । 'समय संभारि सुधारिबी तुलसी मलीन की।' विन ० २७८.३ (५) आचार, विहित पद्धति ।' भए कामबस समय बिसारी।' मा० १.८५.४
1020
_______________________________________________
समयन : समय+संब० । समयों, अवसरों (में, पर)। 'तिन्ह समयन लंका दई। दो० १६२
समयहिं : समय पर । 'समयहिं साधे काज सब ।' दो० ४४८
समर : सं०० (सं.)। युद्ध । मा० १.४०.२
समरत्थ : समर्थ । हनु०३
समरथ : समर्थ । मा० २.१२१.८
समरथु : समरथ+कए । एक भी समर्थ व्यक्ति । 'तुलसी न समरथु कोउ ।' मा० २.२७६ छं०
समरपित : भूकृ.वि० (सं० समर्पित)। प्रदत्त । 'विद्या बिस्वामित्र सब सुथल समरपित कीन्हि ।' रा०प्र० ४.६.३
समरपीं : भूकृ०स्त्री०ब० । सौंपी, समर्पित की। मा० १.१०१.२
सभरपी : समी। दान करके सौंपी। 'जनक रामहि सिय समरपी।' मा० १.३२४ छं० ४
समरपेउ : भूक०पु०कए । समर्पित किया, सौंपा। 'मनसहि समरपेउ आपु ।' पा०म०७० ५
समरप्यौ : समरपेउ । 'सीस समरप्यो आनि ।' दो०३१३
समरभूमि : रणक्षेत्र । मा० १.१३१.३
समरामहे : आ० उब० (सं० स्मरामः) । हम स्मरण करते हैं। मा०७.१३ छं०३
समरारूढा : (सं० समरारूढ =समर+आरूढ़) । युद्ध मे दृढता से संलग्न, चढ़ाई करके युद्धरत । मा० ६.२३.४
समरु : समर+कए । 'प्रभुहि सेवकहि समरु कस।' मा० १.२८१ 'छलु तजि करहि समरु ।' मा० १.२८१.३
समरूप : (१) वि० (सं०) । एकरूप, अपरिवर्तित, निर्विकार । 'तुम्ह समरूप ब्रह्म अबिनासी।' मा० ६.११०.५ (२) सर्वरूप (सम= सर्व) सबरूप ।
समर्थ : वि० (सं०) । शक्ति-सम्पन्न, योग्य । मा० ७.११६।।
समर्प, समर्पइ, समर्पई : आ.प्रए० (सं० समर्पयति>प्रा० समप्पइ>अ० सर्वप्पइ) । सौंपता-ती है। देता-देती है। 'सेएँ सोक समर्पई बिमुख भएँ अभिराम ।' दो० २५८
समर्पि : प्रकृ० । सौंप कर,अपित करके, अपनापन छोड़कर। 'प्रभुहि समर्पि कर्म भव तरहीं।' मा० ७.१०३.२
समर्पी : भूक स्त्री० । सौंपी, दी, स्वता छोड़कर अपित की। 'रामहि समी आनि सो।' मा० ६.१०६ छं० २
समर्पे : भूक०० । समर्पित किये हुए, स्वकीयता छोड़कर अर्पण किये हुए । 'हरिहि समर्प बिनु सतकर्मा ।' मा० ३.२१.८
