12
_______________________________________________
अग्याँ : आज्ञा से। 'पितु अग्यां अद्य अजसु न भयऊ ।' मा० २.१७४.८
अग्या : सं० स्त्री० (सं० आज्ञा) आदेश ।' मा० १.७७.४
अग्याता : वि०+क्रि० वि० (सं० अज्ञात) अनजान, अनजाने । 'अनुचित बहुत कहेउँ अग्याता।' मा० १.२८५.६ ।
अग्यान, ना : (१) सं० पु० (सं० अज्ञान) अविद्या । वैष्णव दर्शन में सात्विक माया विद्या है जबकि तमोगुणी माया आवरण है जो ज्ञान को आच्छादित करती है; रजोगुणी माया विक्षेप शक्ति है जिससे देहादि में आत्मा का अभिमान होता है। बाद वाली दोनों अविद्या अथवा अज्ञान हैं। (२) वि० । ज्ञानरहित, अज्ञ, मूढ़ । मा० ४.२ ।
अग्यानी : वि० पु. (सं० अज्ञानिन्) अज्ञ, ज्ञानहीन । मा० १.११७.१
अग्यान, नू : 'अज्ञान'+कए। अद्वितीय अज्ञान । 'निज अग्यानु राम पर आना।' मा० १.५४.१
अग्र : वि०+क्रि० वि० (सं०) अग्रगामी, आगे, अगुआ। 'चली अन करि प्रिय सखि सोई।' मा० १.२२६.८
अग्रगण्य : वि० (सं०) प्रथम गणना के योग्य । मा० ५ श्लो०३
अग्रणी : वि० (सं.) आगे चलने तथा ले चलने वाला, नायक, मुखिया। विन० २७.३
अघ : सं० पुं० (सं०) पाप । मा० १.४.५
अघट : वि० (सं०) । जो घटित न हो सके, अपूर्व, अनुत । विन० २५.८
अघटित : वि० (१) (सं.) जो घटित न हो सके, असंभव । (२) (सं० अघट्टित) ___अविचल, अटल । 'काल करम गति अघटित जानी।' मा० २.१६५.६
अघरूप : साक्षात् पाप, मूतं पातक, अति पातकी। मा० १.१७६
अघहारी : वि० (सं०) पापों को हरने वाला, पापनाशक । मा० २।२६८।३
अघाइ, ई : पूर्व० कृ० (सं० आघ्राय>प्रा० अग्घाइअ>अ० अग्घाइ) तृप्त होकर, पूर्णतया, पूरम्पार, सर्वात्मना । 'सो पछिताइ अघाइ उर ।' मा० २.६३ 'जनम लाभ कई अवधि अघाई।' मा० २.५२.८।
अघाउं,ऊ : आ० उए (सं० आजिघ्रामि >प्रा० अग्यामि >अ. अग्घाउँ) तृप्त होऊँ, तृप्त हो सकता हूं। 'नहिं अघाउँ थोरें जल ।' मा० ६.५७.७
अघाउंगो : आ० भवि० पु उए । तप्त होऊँगा । गी० ५.३०.३
अघात, ता : (१) वकृ० पु । तृप्त होता-ते। 'नहिं अघात अवनामृत जानी।' मा० ५.४६.३ (२) सं० पु. (सं० आघात) । प्रहार, चोट । 'बुद अधात सहहिं गिरि कैसें।' मा० ४.१४.४
अघाति, ती : वक स्त्री० । तृप्त होती। 'जासु कृपां नहिं कृपा अघाती।' मा० १.२८.३
_______________________________________________
13
अघानी : भूक० स्त्री० । तृप्त हुई। 'प्रजा प्रमोद अधानी।' गी० १.४.६
अघाने : भूक पु० (बहु०) । तृप्त हुए। ‘भाव भगति आनन्द अधाने ।'  मा० २.१०८.१
अघानो : भूक कए । तृप्त हुआ । 'लखइ अघानो भूख ज्यों ।' दो० ४४३
अघारी : वि (सं अघारि) पाप के शत्र, पापनाशक । मा० ३.१३.५ .
अघाहिं, हीं : आ० (१) प्रब। अघाते हैं। 'नहिं अघाहिं अनुराग भाग अरि भागिनि ।' जा० मं० १५० (२) उब । हम अघाते हैं । 'नहिं पेट अघाहीं।' मा० २.२५१.५
अघाहूं : आ०-आशीर्वाद-प्रब । तप्त हों । 'राम भगत अब अमि अधाहूं।' मा० २.२०६.६
अघी : वि० (सं०) पापी । कवि० ७.५
अघौध : सं० पु. (सं.) पाप-प्रवाह, पातक समूह । गी० ७.१६.५
अचंचल : वि० (सं०) अचल, स्थिर । मा० १.२३०.४
अचंभव : सं० ०+वि० (१) सं० असंभव (२) सं ० अत्यद्भुत>प्रा० अच्चभुम) विस्मयजनक । मा० ६.७१.८
अचइ : अंचइ । पान करके । विन० २४.४
अचगरि, री : सं० स्त्री० (सं० अत्यकरिः>अतिशय अकार्य>प्रा० अच्चगरी) अतिशय अनुचित आचरण, धष्टता, दुर्व्यवहार । 'जौं लरिका कछु अचगरि करहीं।' मा० १.२७७.३
अचर : वि० (सं.) स्थावर, अचल-वृक्ष, पर्वत आदि । 'चर अरु अचर नाग नर देवा ।' मा० १.१०७.८
अचरज : सं० पु. (सं० आश्चर्य>प्रा० अच्छरिज्ज) विस्मय, विस्मयजनक अद्भुत कार्य । 'कीन्ह जो अचरज राम ।' मा० १.११०
अचरजु : कए। अद्वितीय विस्मय । 'सुनि सबके मन अचरज आवा।' मा० १.१२७.४
अचल : (१) सं० पु० (सं.)। पर्वत। 'बटु बिस्वासु अचल निज धरमा ।' मा० १.२.११       (२) वि० । अविचल । पद, निष्ठा, संकल्प आदि से विचलित न होने वाला। 'बिस्व भार भर अचल छमा सी।' मा० १.३१.१० (३) नित्य, शाश्वत वैष्णव तथा शवमत में जग (प्रपञ्च भी नित्य है) । 'बिधि प्रपंचु अस अचल अनादी।' मा० २.२८२.६
अचलु : कए। पर्वत । 'अचलु ल्यायो चलि के।' कवि० ६.५५
अचवें : अचवंह-(सं. आचामति>प्रा० आचमइ>अ० आचवेइ-पीना, मुखादि का प्रक्षालन करना)।
14
_______________________________________________
अचँवत : वकृ पु । आचमन करता-करते; पीता-पीते । 'जो अचवत नप मातहिं तेई ।' मा० २.२३१.७
अचवाँइ : पूकृ० । आचमन कराकर, मुघ आदि धुलाकर । 'अचवाइ दीन्हे पान ।' मा० १.६६.छं०
अचानक : क्रि० वि० । सहसा, अकस्मात् । कवि० २.२५
अचार, रा : सं० पु० (सं० आचार) (१) आचरण (२) शास्त्रानुसार कर्म
(आचार: परमोधर्मः) । मा० १.१८३. छं।
अचारु, रू : कए । 'दुई कुलगुरु सब कीन्ह अचारू ।' मा० १.३२३.८
अचिरिजु : अचरजु । अद्भुत्। 'नहिं अचिरिचु जुग जुग चलि आई।' मा० २.१६५.१
अचेत, ता : वि० (सं० अचेतस्) । (१) अविकसित चेतना वाला। 'तब अति रहेउ ँ   अचेत ।' मा० १.३० (२) मूढ । 'डाटेहिं नहिं अचेत ।' रा० प्र० ५.५.६ (३) सं० पु । जड़ता, चैतन्यहीनता। 'असुभ अरिष्ट अचेत।' - रा०प्र० ३.३.४
अचेतु : कए । कवि० ७.८२
अच्छ : सं० पुं० (सं० अक्ष) रावण का एक पुत्र । मा० ६.३६.५
अच्छत : सं० पुं० (सं० अक्षत)। अखण्डित चावल जो पूजा के लिए हाथ से बूसी निकालकर बनाए जाते हैं । मा० १.२६६.८ ..
अच्छम : वि० (सं० अक्षम) असमर्थ, अशक्त, निर्बल । दो०७४
अच्छय : अखय। क्षयरहित, पूर्ण। 'अच्छय अकलंक सरद चंद चंदिनी।' गी० २.४३.४
अच्छर : सं० पु० (सं० अक्षर) । स्वर अथवा स्वर सहित व्यञ्जन । मा० १.१४३
अच्छु : 'अच्छ,+क ए। अक्षकुमार-रावण पुत्र । कवि ६.२२
अच्युत : वि० सं० पु० (सं.)। पद, पथ आदि आदि से विचलित न होने वाला, निर्विकार=परमेश्वर । विन० १०.६
अछत : वकृ पु० (सं० सत्>प्रा० अच्छंत) रहता हुआ, रहते हुए। 'अस प्रभु हृदयें अछत अविकारी।' मा० १.२३.७
अछधारि : सं० स्त्री० (सं० अक्षधारि) । अक्ष कुमार की सेना । कवि० ५.२८
अछोमा : वि० पू० (सं० अक्षोम्य) । क्षोभ में आने वाला, भावावेश में न डाला जा सकने वाला, गम्भीर । 'बीरबती तुम्ह धीर अछोभा।' मा० १.२७४.८
अज: (१) सं० पु. (सं०) । बकरा । मा० ५.३ छं३ (२) ब्रह्मा । मा० १.६१.७ (३) वि० । अजन्मा। अज सच्चिदानन्द परधामा।' मा० १.१३.३
_______________________________________________
15
अजगर : सं० ० (सं० अजं गिलतीति अजगरः) बकरा या उसके बराबर जन्तु को निगल जाने वाला सर्पजातीय जन्तुविशेष । मा० ७.१०७.७
अजय : वि० पु. (सं० अजय्यः जेतु न शक्यः) जो जीता न जा सके। मा० १.१७०.५
अजर : वि० (सं०) जराहीन (प्रायः देव वाचक) । जिसे क्षय या बुढ़ापा न ___आता हो-'अजर अमर सो जीति न जाई।' मा० १.८२.७
अजस : सं० पुं० (सं० अयशस्) । अकीति । कुख्याति । मा० २.१२
अजसी : वि० (सं० अयशस्विन्) कुख्यात । मा० ६.३१.२
अजसु : 'अजस'+कए । एक मात्र अकीर्ति । 'अजसु होउ जग सुजसु नसाऊ ।' मा० २.४५.१
अजहुँ, हूँ : आज भी, अब भी। मा० १.५०.८
अजा : (१) सं० स्त्री० (सं.)। बकरी। 'होत अजा-सुर बारिधि बाढ़े।' कवि० २.५ (२) वि० स्त्री० । अजन्मा। 'अजा अनादि सक्ति अबिनासिनि मा० १.६८.३
अजायक : वि० । जो याचक न हों-पूर्ण तुप्त । मा० ७.१२.१
अजाति : वि० (सं०) (१) जातिहीन अकुलीन (२) जन्महीन (जाति जन्म)। अजन्मा । पा० मं० ५५ ।।
अजादि : ब्रह्मा इत्यादि देव वर्ग । मा० १.५४
अजान : वि० ० (सं० अज्ञ>प्रा० अजाण) जिसे उस विषय की जानकारी न हो। 'पूछत जानि अजान जिमि ।' मा० ११२६६
अजानि : पूक० । न जानकर विना जाने। 'जानि नाम अजानि लीन्हें नरक जमपुर मने ।' विन० १६०.३
अजामिल : एक पौराणिक ब्राह्मण पात्र जो दासी-संसर्ग से पतित हो गया था और पुत्र 'नारायण' को मरते समय पुकारने से तर गया था। कवि० २.५
अजामिलु : कए । 'अपतु अजामिलु गजु गनिकाऊ ।' मा० १.२६.७
अजित : वि० (सं०) जिसे कोई जीत न सका हो, अपराजित, सर्वोपरि । 'निर्गुन ब्रह्म अजित अज जानहु ।' मा० ४.२६.१२
अजिन : सं० पुं० (सं०) चर्म, मृग चर्म । मा० २.२११
अजिर : सं० ० (सं.) आँगन । मा० १.१०५.६ (२) क्षेत्र, मैदान-जैसे, 'रन-अजिर' मा० १.२२१.४ ।
अजीता : अजित । "सबदरसी अनबध अजीता।' मा० ७.७२.५
अजीरन : वि.+सं० पु० (सं० अजीर्ण) पेट में न पचा हुआ अन्न; अपच । असन अजीरन को समुझि तिलक तज्यो।' गी० २.३३.२
16
_______________________________________________
अजे : वि० पु० (सं० अजेय) जो जीता न जा सके । 'रघुबीर महारनधीर अजे।' मा० ७.१४.१७
अजै : अजय । 'अतिस प्रबल अर्ज।' विन० ८६.४
अजोध्या : अवध । मा० ७.२७.२ इक्ष्वाकु के पुत्र विकुक्षि का उपनाम 'अयोध्या' था, उन्होंने पुरी बसाई थी । अत: 'अयोध्या' नाम पड़ा-दे० हरिवंशपर्व ।
अटक : सं० सभी० । गतिरोध, रोकटोक, बाधा । को कर अटक कपि कटक अमरषा ।' कवि० ६.७
अटक, अटकइ : <सं० आटकते-टकि बन्धने । बंधना, संलग्न होना। आo प्रए । अटकता है, लगता है, लग जाय । 'जब मति यहि सरूप अटक' विन.. ६३.६
अटत : कृपु० (सं० अटत्-अटगतो) चलता, चलते। खोज में भ्रमण करते। 'अटत गहन बम अहन अखेटकी ।' कवि० ७.६६ विशेषतः पैदल तथा खोज या साक्ष्य पाने) हेत यात्रा का अर्थ आता है-भिक्षारन, तीर्थाटन आदि। 'सुतीरथ अटत ।' विन० १२६.३
अटन : सं० पुं० (सं.) पर्यटन, भ्रमण । 'अटन पयादे । मा० २.३११.३
अटनि : अट्टों-अटालों पर । गी० १.५:१
अटनु : 'अटन'+कए। पैदल भ्रमण । 'अटनु रामगिरि बन तापस चल ।' मा० २.२८०.७ अटन्ह =अटनि । अटालों । 'प्रगटहिं दुरहिं अटन्ह पर भामिनि ।' मा० १.३४७.४
अटपटि : वि० समी० । दुर्बोध, विसंगत, विचित्र । 'अटपटि बानी।' मा० १.१३४.६
अटपटे : वि० पु (बहु०) । विचित्र, व्यङ्गययुक्ता। 'प्रेम लपेटे अटपटे ।' मा० २.१००
अटल : वि० (सं0-टल वैलव्ये) अविकल, अविचल । कवि० ६.४७
अटयो : सं० समी० (सं०) वन । विन० ५२.७
अटारिन्ह : अटारियों (पर)। मा० १.३०१.४
अटारीं  : (१) सं० स्त्री० बहु० (सं० अट्टालिकाः) अटारियां, छतें, छतों पर बनी शालायें । 'जातरूप मनि रचित अटारी ।' मा० ७.२७.३ (२) अटाली पर । 'निबुफि चढ़ेउ कपि कनक अटारीं।' मा० ५.२५.६
अट्टहास : सं० पु. (सं.) ठहाका लगाकर हंसने की क्रिया । मा० ६.४०.४ .
अठकठ: वि० सं० अष्ट-काष्ट>प्रा० अट्ठ-कट्ठ) आठ काठों से बना, अनमेल, अस्थायी । 'बांस पुनि साम' सब मछकठ। बिन० १८६२ जिस प्रकार कई प्रकार की लकड़ियों से जोड़ गाँठ कर बनाया खटोला टिकाऊ नहीं होता, उसी प्रकार पाँच महाभूतों और तीन अन्तःकरणों से रचा हुआ शरीर अस्थायी है।
अठारह : संख्या (सं० अष्ठादश < प्रा० अट्ठारह) । मा० ५.५५.३ ।।
अढ़ाई : (सं० अर्ध तृतीय>प्रा० अड्ढाइज्ज) वह संख्या जिस में दो पूरे और तीसरे का आधा हो । मा० २.२७८.६
अढु़क : सं०० । ठोकर । 'फोरहिं सिल लोढ़ा सदन लागें अढ़ क पहार।' दो० ५६०
अढु़ कि : पूकृ० । लड़खड़ाकर, ठोकर खाकर । 'अढ़ कि परहिं फिरि हेरहिं पीछे।' मा० २.१४३.६
अतनु : वि० (सं०) शरीर-रहित=अनङ्ग । रति अति दुखित अतन पति जानी।' मा० १.२४७.५
अतर्क्य : वि० (सं.) तर्कशक्ति से अज्ञेय; बुद्धि की युक्तियों से परे; अतीन्द्रिय । _ 'राम अतयं बुद्धि मन बानी।' १.१२१.४
अति : अव्यय (सं०) अतिशय, अधिक, अत्यन्त । रति अति दुखित अतनु पति जानी।' मा० १.२४७.५ ऐसे स्थलों में प्रायः अर्थ की अतिक्रान्त दशा का आशय रहता है।
अति उकुति : सं० स्त्री० (सं० अत्युक्ति) । एक काव्यालंकार जिसमें शौर्य तथा उदारता आदि का अद्भुत रूप से वर्णन किया जाता है। मा० ६.२.१-४
अतिकल्प : वि० (सं.) (१) कल्पनातीत, अप्रमेय (2) कल्पातीति=युग, कल्प आदि कालसीमाओं से परे-कालातीत । विन० ५४.६
अतिकाय : वि०+सं०० (सं)। (1) बड़े डील डोल वाला (2) एक राक्षस-यूथप का नाम । मा० १.१८० .
अतिकाया : अतिकाय । मा० ६.४६.१०
अतिकाल : वि. (सं०-अतिक्रान्त: कालम् ) कालातीत, कालजयी, काल से परे । विन० ११.७
अतिथि : सं (सं.) वह अभ्यागत जिसके आने की तिथि पूर्व निश्चित न हो। मा० १.३२.८
अतिबल : वि० (सं०) अतिशय बली । मा० १.१८०.३
अतिबलो: कए । गी० ५.४२.१
अतिरोषी : अत्यन्त क्रोधी । मा० १.१७१.६
अतिसय अतिसै : क्रि०पि० (सं० अतिशय) अत्यन्त । मा० १.१८.७, विन० ८६.४
अतीत : वि० (सं०) अतिक्रान्त, परे । 'गिराज्ञान गोऽतीतम् ।' मा० ७.१०८.३
अतीति : वि० स्त्री० (सं० अतीता)। बीती। 'बड़ि बय बथहि अतीति।' विन० २३४.२
18
_______________________________________________
अतीवा : कि०वि० (सं० अतीव) सादृश्यातीत, अतिशय, सर्वथा। 'भरतगति _ अकथ अतीवा।' मा० २.२३८.५
अतुल : वि० (सं० अतुल, अतुल्य) अपरिमित, अनुपम । मा० १.१५३.६
अतुलबल : अपरिमित तथा असदृश बल वाला। मा० १.१७८ ख
अतुलित : वि० (सं०) बिना तौल का, अमित; तुलना रहित, अद्वितीय । मा० १.१८८.३
अतुलित बल : अतुल बल । मा० ६.११२.६०
अत्यंत : वि०+क्रि०वि० (सं०) अन्त का अतिक्रमण किए हुए, अन्तहीन, असीम,  अतिशय, नितान्त । 'बाक्य-ग्यान अत्यन्त निपुन ।' बिन० १२३.२
अत्रि : सं०० (सं०) एक ऋषि का नाम । मा० ३.३.४ ।।
अथरबनी : सं० पु. (सं० अथर्वणि) (१) अथर्व-वेद का पारंगत=मन्त्रकुशल (२) पुरोहित । 'आपु बसिष्ठ अथरबनी। गी० १.६.१०
अथर्वन : सं.पुं० (सं० अथर्वन्) चतुर्थ वेद । विन० १५५.२
अथवँ अथवँइ : (सं० असामेति>प्रा० अत्थमइ>अ० अत्थर्वइ-अस्त होना) आ० प्रए । अस्त होता है, अस्त हो जाय । 'जौं बिनु अवसर अथर्व दिनेसू ।' मा० २.३०५.७
अथवत : वक पु० । मस्त होता । दो० ३१६
अथवा : अव्यय (सं०) । या (विकल्प) । मा० ७.१२८
अथाई  : 'अथाई+बहु० । अथाइयाँ, सभाशालाएँ । 'हाट बाट घर गली' अथाई।' मा० २.११.३
अथाई : सं० स्त्री० (सं० आस्थायिका>प्रा० अत्थाइआ>अ० अत्थाई)। सभा भवन, दरबार । विन० ६२.७
अदन : वि० । खाने वाला। बिष अदन सिव ।' कवि० ७.१५२
अद्भुत : अद्भुत । मा० १.१४३.२
अदन : वि० (सं०) अविरल, अनल्प, व्यापक, महान् । 'अगुन अदम्र गिरा गोतीता।' मा० ७.७२.५
अदर्भ : वि० (सं.) बन्धनरहित, असीम= अदभ्र । विन० ५४.७
अदाग : वि० (फ्रा० दाग) कलंकरहित, निष्पाप । वैरा० ४४
अदाया : निर्दयता। मा० ६.१६.३
अदिति : सं० स्त्री० (सं०) देवमाता। मा० १.३१.१४
अदिनु : सं० पु० कए । संकट का दिन, विपत्ति काल, दुर्भाग्य । 'अदिन मोर नहिं दूषन काहूं।' मा० २.१८१.७
अदूषन : वि० (सं० अदूषण) दोषरहित । शुद्ध गी० ७.१६.७
अदृश्य : वि० (सं० अदृश्य) लुप्त, अन्तहित । मा० १.१८६
_______________________________________________
अदेय : वि० (सं.) जो दिया जा न सके, जो देने योग्य न हो। मा० १.१४६.८
अदोषा : वि० (सं० अदोष) दोषरहित । निष्कलुष । 'राम पेम बिधु अचल अदोषा।' मा० २.३२५.६
अद्भुत : सं० पु+वि० (सं० न भूतमिति अद्भुतम्) अभूतपूर्व, अपूर्व, आश्चर्यजनक (२) नो रसों में से एक रस जिसका स्थाई भाव विस्मय होता है । मा० १.१६२.छं०
अद्रि : सं० पु० (सं०)। पर्वत । विन० ४३.४
अद्वितीय : वि० (सं.) जिससे दूसरा कोई न हो= द्वितीय रहित; अद्वैत, अनुपम । विन० ५३.३
अद्वैत : वि०+सं० पु० (सं.) तरहित, अद्वितीय, अभेद, अखण्ड, अनेकत्व रहित, एकमात्र सत्ता=ब्रह्मा० । मा० ७.१३.छं०६
अध : अव्यय (सं० अधस्) नीचे । 'अध अर्ध बानरु ।' कवि० ५.१७१
अधगति : सं० स्त्री० (सं० अधोगति) तीन प्रकार की जीव-गतियाँ दर्शनों में बताई गई हैं--(१) अर्ध गति=सात्त्विक देवयोनियाँ (२) मध्यगति-राजस मनुष्य योनि (3) अधोगति= तमोगुणी पशु-पक्षी, कीट-पतङ्ग, वृक्षादि योनियो । 'रहु अधमाधम अधगति पाई।' मा० ७.१०७.८
अधगो : सं० पु (अध:-नीचे+गो-इन्द्रिय)। पायु, मलत्यागेन्द्रिय । मा० ६.१५.८
अघजरति : वि० स्त्री० (१) (सं० अर्धजरती) अर्धवद्धा। (२) (सं० अर्ध ज्वलंती) अधजली होती हुई। निकसि चिता ते अधजरति मानहं पती परानि । दो० २५३
अधन : वि० (सं०) निर्धन । मा० १.१६१.४
अधबिच : क्रि० वि० (सं० अर्ध-वर्म>अ० अद्धविच्च) आधे मार्ग में, बीचो-बीच __ में । गी० ७.३.५
अधम : वि० (सं0) नीच, निम्न कोटि का, अधोगत । मा० १.१८.२
अधमउ : अधम भी। अधमउ मुकुट होई श्रुति गावा । मा० ३.१३.६
अधमाई : सं० स्त्री० [सं० अधमता) नीचता । सहि सम अधिक न अध अधमाई।' मा० २.२११.२
अधमाधम : अधर्मों में भी अधम, अत्यन्त नीच जो नीचवर्ग में भी नीच माना जाता हो। मा० ७.१०७.८
अधमारे : वि० पू० (सं० अर्धमारित>प्रा० अद्धमारिय) जिन के मार डाले जाने में कमी रह गई हो। मा० ५.१८.६
अधर : (१) वि० (सं०) निम्न, नीच, अवर । 'तीय अधरबुद्धि शनि ।' २.१६ (२) सं० पु । ओठ। मा० १.१३६.२
20
_______________________________________________
अघराघर: (अधर+अधर) नीचे का ओठ । 'अधराधर पल्लव खोलन की। कवि० १.५
अधर्म : सं० पु० (सं०) धर्म विरुद्ध आचरण, पाप । मा० ७.६६ ख
अधार, रा: सं० पुं० (सं० आधार) आश्रय, सहारा । मा० १.२२.७
अधारु : कए । अद्वितीय आधार । 'एक नाम अधारु सदा जन को।' कवि ७.८७.
अधिक : वि० (सं.)। प्रचुर, अत्यन्त, अतिशय ।
अधिका : अधिक । मा० ३.४२.८
अधिका, अधिकाई : (सं० अधिकायते-अधिक होना) आ० प्रए अधिक होता है, बढ़ता है । 'नित नूतन अधिकाई ।' मा० १.६४
अधिकाई : अधिकता के कारण । ‘टाप न बूड़ बेग अधिकाई ।' मा० १.२६६.७
अधिकाई : (१) भू० कृ० स्त्री। बढ़ गई। 'पुरु खरभरु सोमा अधिकाई ।' मा० १.६५.१ (२) सं० स्त्री० । अधिकता, प्रचुरता । 'लहहिं सकल सोभा अधिकाई ।' मा० १.११.२ (३) अधिकता से । 'तपइ अवां इव उर अधिकाई ।' मा० १.५८.४ (४)-अधिकाई । बढ़ता है। जिमि प्रतिलाभ लोभ अधिकाई।" मा० १.१८०.२
अधिकाति : व० कृ० स्त्री० । बढ़ती, परिवृहित होती। मा० १.३५६
अधिकाति : भू० कृ.पु । बढ़ गया ।' उर अनन्दु अधिकान ।' मा० २.५१
अधिकानि, नी : स्त्री० । बढ़ी । गी० १.४.८
अधिकाने : भू० क० पू० बहु । बढ़ गए। 'चिर जीवन लोमस ते अधिकाने । कवि० ७.४३
अधिकार : सं० पुं० (सं०) । योग्यता, पात्रता, पद तथा पदानुकूल स्वामित्त्व । मा० १.६०.७
अधिकारी : वि० पुं० (सं.)। पात्र, विषय विशेष की योग्यता वाला। 'राम भगति अधिकारी' मा० १.३०.४ (२) पद का स्वामी। 'अगिनि काल जम सब अधिकारी ।' मा० १.१८२.१०
अधिक : क्रि० वि०+कए। अतिशय के साथ। 'अधिक अधिक गरुआइ ।" मा० १.२५०
अधिकोहैं : क्रि० वि० प्रचरता से, अधिक रूप में। गी० ७.४.४
अधिप : वि० पुं० (सं०) स्वामी । मा० २ श्लो०
अधिभूत : वि० (सं०) भूत प्राणियों से सम्बन्धित, पाङचभौतिक सृष्टि सम्बन्धी । सर्प, व्याघ्र आदि तथा मनुष्यादि से प्राप्त । दे० अधिभौतिक ! 'अधिभूत. बेदन बिषम होति भतनाथ ।' कवि० ७.१६६
_______________________________________________
21
अधिभौतिक : (दो आधिभूत) वि० (सं० आधिभौतिक)। प्राणियों तथा भूत प्रेत आदि से मिलने वाला। 'अधिभौतिक बाधा भई ते किंकर तोरे।' वि० ८.३ संख्या में तीन प्रकार के दुःख गिनाये गये हैं-(१) आध्यात्मिक (2) आधिदैविक तथा (३) आधिभौतिका दे० भिविधाति ।
अधिवास : सं० पु० (सं०)। अधिष्ठान, पूर्ण आधार। 'सर्वभूताधिवासं ।' मा० ७.१०८.१४
अधीन : वि० (सं०) आश्रित, वशीभूत । मा० २.२६३.५
अधीना : अधीन । मा० १.१५१.६
अधीर : वि० (सं०) धैर्यहीन । मा० २.१६१
अधीरा : अधीर । मा० २.७०.२
अधीश : वि० पू० (सं०) ईश्वर, स्वामी । मा० ५ श्लो० ३
अनंग : अनंग । मा० १.१०८.७
अन : (१) अव्यय (सं० न>प्रा० अण) । दे० अनइच्छित आदि । (२) वि० सं० अन्य>प्रा० अण्ण) अपर, इतर । 'चातक बतियां ना रुची अनजल सींचे रूख ।' दो० ३१०
अनंग : सं० पुं० (सं० अनङ्ग-अनङ्ग रहित) कामदेव । मा० ७.११.८
अनंगा : अनंग । मा० १.२८५.४
अनंगु : अनंग+कए । 'होइहि नामु अनंगु ।' मा० १.८७
अनंत, ता : (१) वि० (सं० अनन्त) अन्तहीन, असीम, अप्रमेय+असंख्य, अपरिमेय । 'राम अनन्त आनंत गन ।' मा० १.३३ (२) सं० पुं० । शेषनाग तथा शेषावतार-लक्ष्मण । 'क्रोधवंत तब भयउ अनंता।' मा० ६.५४.४ ।।
अनंद, दा : सं० पुं० (सं० आनन्द) आह्लाद । मा० १.४०.८
अनंदित : वि० (सं० आनन्दित) आह्लादित, सुखी । 'खगमृग बृद आनंदित रहहीं।' मा० ३.१४.३
अनंदु, दू : आनंद+कए । एकमात्र आनन्द, अद्वितीय आह्लाद । 'उर अनंदु  अधिकान ।' मा० २१५१
अनंदे : भू० कृ० वि० ० बहु० (सं० आनन्दित>प्रा० आणंदिय) सुखी हुए।  'तब मयना हिमवंतु अनंदे।' मा० १.६६ १
अन-अहिबातु : अहिवात के विपरीत विधवात्व । मा० २.२५.७
अनइच्छित : अनचाहा, अनचाहे, । मा० ७.११६.४
_______________________________________________
अनइस : वि० (१) (सं० आन्याहश>अ० अण्णाइस) अन्य जैसा= प्रतिकल (२) (सं० अनीहश>अणइस) विपरीता अशुभ, अनचाहा । 'करत नीक फलु अनइस पावा ।' मा० २.१६३.६
अनख : सं० (सं० अनक्ष ?) आंख न देना, उपेक्षा, अवज्ञा, अनादर, अवज्ञापूर्वक अमर्ष । 'कस सहि जात अनख तोहि पाहीं।' मा० ३.३०.१५ 'भाय कुमायें अनख आलस हूँ।' मा० १.२८.१
अनखानि : अनख करने की क्रिया। गी० १.२१.२ अनखे हैं : आ० प्र० । अनख मानेंगे, अमर्ष करेंगे । 'खल अनखे हैं तुम्हें सज्जन न गामिहैं।' कवि० ७.७१
अनखौंही : वि० स्त्री०- अनख भरी हुई। 'रोष माखे लखनु अकनि अनखौंहीं बातै ।' कवि १.१६
अनगनी : वि० स्त्री० (सं० अगणिता) असंख्य । 'नर-नारी रचना अनगनी।' गी० १.५.१
अनध : वि० (सं०) अधारहित, निष्कलुष, निर्विकार । मा० १.२२.६
अनचाह्यो : भू० कृ० वि० पु० कए० । अनचाहा, अनाहत । 'दूहाँ भलो अनचह्यो हौं ।' विन २६०.४
अनजानत : वकृ० वि०+त्रि०वि० (सं० अजानत्>प्रा० अणजाणंत) । (१) बिना जानते हुए- 'अनजानत हरि लायो।' गी० ६.२.३ (२) न जानते हुए 'छमिअ चूक अनजानत केरी।' मा० १.२८२.४
अनट : सं० पु० (१) (सं अनर्थ>प्रा० आणट्ट) प्रयोजन-हानि । कार्य-हानि, उलझन, अयोग्य स्थिति । 'मिटिहि अनट अवरेब ।' मा० २.२६.६ (२) सं० अनाट्य>प्रा० अणट्ट) नाट्य में संग्राम, मेला आदि अभिनेय (नाट्य) नहीं होते। रस भङ्ग की सभी बातें अनाट्य होती हैं जिनके आ जाने से सामाजिक को नीरसता ही मिलती है। अत: ऐसी दशा 'अनट' है जो कणेशकर हो । दो० ४६६
अनत : क्रि० वि० अव्यय (सं० अन्यतः>प्रा० अण्णत्तो) अन्य ओर । (२) (सं० अन्यत्र>प्रा० अण्णत्त) अन्य स्थान पर । 'सुनत बचन फिरि अनत निहारे।' मा० १.२७०.२
अनन्य : वि० (सं०) एक के अतिरिक्त किसी के प्रति निष्ठा-हीन+सबके प्रति एक की ही निष्ठा लेकर व्यवहार करने वाला । 'सो अनन्य जाके असि मति न टरइ हनुमंत । मैं सेवक सचराचर रूपरासि भगवंत ।।' मा० ४.३
अनन्यगति : वि० (सं0-नास्ति अन्यागतिर्यस्यसः) एक को छोड़ अन्य आश्रय न मानने वाला । 'सेवक प्रिय अनन्यगति सोऊ।' मा० ४.३.८
_______________________________________________
23
अनपायनी : वि० स्त्री० (सं० अनपायिनी)। अपाय=विकार+क्षय से रहित । अविचल, ६७, अपरिवर्तनीय । 'अनपायनी भगति प्रभु दीन्ही ।' मा० ४.२५.८
अनबध : अनवध । निर्दोष । 'अज अनबध अकाम अभोगी।' मा० १.९०.३
अनबन : वि० । अकृत्रिम, प्राकृतिक, विविध । 'कंद मूल जल थल रूह अगनित अनबन भांति ।' गी० २.४७.३
अनबिचारमनीय : वि० (सं० अविचार-रमणीय) असत् । आपातरमणीय जिसकी मनोरमता तभी तक है जब तक विवेक नहीं आता । 'अनबिचार-रमणीय सदा संसार भयंकर भारी।' विन० १२१.४
अनभएँ -क्रि० वि०-न होने की स्थिति में, बिना हुए । 'नृप जागेउ अनभएँ बिहाना।' मा० १.१७२.२
अनुभल : वि०+सं० । अशुभ, अयोग्य, अभद्र । 'अनभल देखि न जाइ तुम्हारा' मा० २.१६.७
अनभले : अनभल+बहु० । दो० ३४५
अनभलो : अनमल+कए । दो० ३६८ ।
अनभाई : वि० स्त्री० । अनचाही, अरुचिकर, भावहीन । विन० १६५.३
अनभाए : वि० पु. बहु० । भावहीन, अनचाहे, अरुचिकर । गी० २.८८.४
अनमनि : वि० स्त्री० (सं० अन्यमनस्का>प्रा० अण्णमणी) अनेकान, उद्विग्न । 'का अनमनि हंसि कह हंसि रानी।' मा० २.१३.५
अनमायो : भू० कृ० कए। जो अटा नहीं, भीतर समाया नहीं। 'क्यों कहों प्रेम ___अमित अनमायो।।' गी० ५.२१.६
अनमिल : वि० (सं० अमिल>प्रा० अणमिल)। बेमेल । 'अनमिल आखर' मा० १.१५.६
अनमोल : अमोल । कवि० २.१३
अनय : सं० पू० (सं.)। अनीति, अन्याय, सिद्धान्त या मर्यादा के विपरीत आचरण । दो० ५१५
अनयन : वि० (सं०) नेत्रहीन । मा० १.२२६.२
अनयासा : वि०+क्रि० वि० (सं० अनायास) बिना प्रयास के । मा० १.२५.२
अनरथ : सं० पुं० (सं० अनर्थ) प्रयोजन हानि, कार्य हानि, क्षति, संकट, बाधा । 'लखन लखेउ भा अनरथ आजू ।' मा० २.७३.७
अनरथु : अनरथ+क ए । मा० २.१५७.५
अनरस : सं० पुं० (सं० अन्य रस-+अन्न रस) अन्न के स्वाद तथा अन्य सभी रस । 'तो नवरस, षटरस, रस, अनरस ह जाते सब सीठे।' विन० १६६.१
24
_______________________________________________
अनरसत : वक । अरस= रसहीन होता-होते । विन्न होता-होते । खीझता ते। 'हंसे हंसत, अनरसे अनरसत ।' गी० १.१६.२
अनरसनि : नीरस होने की क्रिया। खीझना । गी० १.२१.२
अनरसे : भू० कृ० पु बहु० (१) अप्रसन्न, शिथिल, अस्वस्थ । 'आजु अनरसे - हैं मोर के, पय पियत न नीके ।' गी० १.१२.१ (२) अप्रसन्न होने पर । 'हंसे हंसत, अनरखे अनरसत ।' गी० १.१६.२
अनर्थ : (दे, अनरथ) । हनु० १२
अनल : सं० पुं० (सं.) अग्नि । मा० १.५.८
अनलु : अनल+कए। मा० १.३२३
अनवध : वि० (सं०-न+अवध-अनवध) अनिन्ध । अमन्द, उत्तम, निर्दोष निर्विकार । मा० ३.११.१२
अनवरत : वि०+क्रि० वि० (सं०) निरन्तर, अविच्छिन्न, अखण्ड, शाश्वत । विन० १०.७
अनवसर : सं० पु० (सं.) असमय, अवसर का अभाव, प्रतिकूल अवसर । गी० ५.३८.३
अनसमुझे : क्रि० वि०। बिना समझे-बूझे, बिना विचारे ही। 'अनसमझें अनुसोचनो।' दो० ४८६
अनहित : सं० पु+वि० (सं० अहित) (१) अनभला । 'अनहित तारे प्रिया के इं कीन्हा ।' मा० २.२६.१ (२) शत्रु, अनिष्टकारी । 'हित अनहित मध्यम भ्रम फन्दा।' मा० २.६२.५ (३) अहितकर 'हित अनहित नहिं कोई' मा० १.३
अनाज : सं० पुं० (सं० अन्नाद्य>प्रा० अन्नज्ज) खाद्य अन्न । दो० ४५३
अनाजू : अनाज+कए । मा० २.२७८.७
अनाथ, था : वि० (सं०) (१) प्रार्थनीय आश्रय से रहित, दीन हीन । मा० १.१४६.३ (२) जिसका कोई स्वामी न हो स्वयं प्रभु । बर० ३५
अनाथानि : अनाथ+सब। अनाथो (को)। 'नाथ अनाथनि पाहि हरे।' मा० ७.१४.८
अनाथा : अनाथ । मा० २.७१.३
अनादर : सं० पु० (सं.)। उपेक्षा, असम्मान, अपमान । विन० १७६.१
अनादि : वि० (सं.) आदिहीन, अज्ञातजन्मा या अजन्मा । 'अजा अनादि सक्ति अबिनासिनि ।' मा० १.६८.३
अनादी : अनादि । मा० १.१०८.५
अनाम, मा: वि० (सं० अनामन्) । नामरहित, शब्द शक्ति से परे। मा० १.१३.३
_______________________________________________
25
अनामय : वि० सं०) आभय =रोग, दोष, विकार से रहित । अजरामर, निष्पाप । मा० १.२२.२
अनायास : क्रि० वि० (सं०) बिना किसी प्रयास के ही। 'अनायास उधरी तेहिं काला ।' मा० २.२६७.४
अनारंभ : वि० (सं.) आदिहीन+उत्पत्तिहीन । अजन्मा । 'अनारंभ अनिकेत अमानी।' मा० ७.४६.६ न्यायदर्शन आरम्भवादी है जो ईश्वर को कर्ता मानकर, उसके द्वारा परमाणुओं से प्रपञ्च की सष्टि को मान्य करता है। इसके विपरीत वैष्णव दर्शन में ईश्वर को अविकृत परिणाम लेने वाला मानकर उपादान तथा निमित्त कारणों के रूप में मान्य किया गया है। वह बाहर से सामग्री लेकर आरम्भ नहीं करता ।
अनिंदिता : वि० स्त्री० (सं०) अनवधा, वाह्य तथा आभ्यन्तर कलुषों से रहित, सर्वथा निर्दोष । मा० ७.२४.६
अनिकेत : वि० (सं.) गृहरहित, आश्रयहीन, स्वाधिष्ठान, स्वाश्रति, निकेत= गृह+सूचक से रहित, अज्ञेय । 'अनारंभ अनिकेत अमानी ।' मा० ७.४६.६
अनिप : सं० पुं० (सं० अनीकप) सेनानायक । मा० ६.४६.१०
अनिमादिक : अणिमा इत्यादि आठ योगसिद्धियां--अणिमा महिमा चैव लघिमा गरिमा तथा । प्राप्तिः प्राकाम्यमीशिवत्वं वशित्वं चाष्ट सिद्धयः॥ (१) अणिमा =सूक्ष्म होने की शक्ति। (२) महिमा=महान हो जाने की शक्ति । (३) लघिमा-हलका होने की शक्ति । (४) गरिमा =भारी होने की शक्ति । (५) प्राप्ति-जहाँ चाहें, जाने की शक्ति । (६) प्राकाम्य-अभीष्ट वस्तु सुलभ करने की शक्ति। (७) ईशित्व =सब पर प्रभुता की शक्ति । (८) वशित्व सबको वशीभूत करने की शक्ति । 'होहिं सिद्ध अनिमादिक पाएं।' मा० १.२२.४
अनियत : आनियत । वक़ पुं० क वा। लाया जाता। 'महिमा समुचित डर अनियत ।' विन० १८३.३
अनिर्बाच्य : वि० (सं० अनिर्वाच्य= अनिर्वचनीय) वाणी द्वारा जिसका निर्वचन = विवेचन असम्भव हो, अकथ्य, अप्रमेय । 'पावा अनिर्वाच्य विश्रामा।' मा० ५.८.२
अनिल : सं० पुं० (सं.) वायु । मा० १.७.१२
अनिश : क्रि०वि० (सं०) निरन्तर सदैव, अविराम । मा० ५.२ श्लो० १
अनी : सं० स्त्री (सं० अनीक>प्रा० अणीअ) सेना । मा० २.१२६ छं.
अनीकाका : सं० पुं० (सं० अनीक)= अनी । 'कलुष अनीक दलन रनधीरा।' मा० २.१०५.६
26
_______________________________________________
अनीति : सं० स्त्री. (सं०) नीतिविरुद्ध आचरण, मर्यादा-रहित व्यवहार । मा० १.१८३
अनीती : अनीति । मिटइ भगति पथु होइ अनीती।' मा० १.५६.८
अनीस : सं० पु+वि० (सं अनीश) ईश्वर से भिन्न-जीव जो सर्व शक्तिमान नहीं है । 'ईस अनीसहि अंतरु तैसें ।' मा० १.७०.२
अनीह : वि० (सं०) ईह इच्छा से रहित, निष्काम, निरपेक्ष, उदासीन । मा० १.१३.३
अनु : अव्यय (१) संस्कृत का उपसर्ग-'अनुकूल' आदि में (२) 'अन्यथा' के अर्थ ___में अपभ्रंश का स्वतन्त्र प्रयोग । देहु उतरु अनु करहु कि नाहीं।' मा० २.३०.४
अनुकथन : सं० पु० (सं०) अनुकीर्तन, प्रश्नोत्तर में विचार विनिमय, शास्त्रीय निर्णय हेतु वाद-विवाद, निश्चय बोध हेतु तर्क-वितर्क । 'सुनि अनुकथन परसपर होई ।' मा० १.४१.३
अनुकूल (अनुकूला) : वि० (सं०) (१) अपने पक्ष में आने वाला । मा० १.१५.७ (२) ओर, प्रति (जनक) । 'चली बिपति बारियी अनुकूला।' मा० २.३४.४ (३) दर्शनों में ‘उत्पादक' अर्थ भी होता है जो उक्त उद्धारण में व्यङ्ग्य है ।
अनुकूले : भू० कृ. पु० (बहु०) । अनुकूल किए हुए । 'नित नूतन सुख लगि _ अनुकूले।' मा० १.३०४.८
अनुकूलो : अनुकूल+कए । 'गोसाईं सुसाई सदा अनुकूलो।' हनु० ३६
अनुग : वि. पु. (सं०) अनुगामी, अनुचर । 'राम अनुग जगु जान ।' मा० २.२२६
अनुगंता : अनुग। (सं.) । विन० ३८.३
अनुगनि : अनुग+सं० बं० । अनुगों, अनुचरों। 'उतरि अनुज अनुगनि समेत ।' गी० ६.२१.५
अनुगामी : वि० (सं० अनुगामिन्) । अनुग, अनुसरणकारी। मा० १.१७.६
अनुग्रहं : अनुग्रहपूर्वक । अनुग्रह से । 'राम अनुग्रहं सगुन सुभ ।' रा० १० ६.५.६
अनुग्रह : सं० पु० (सं.) । कृपा, अनुकम्पा । मा० २.३.७
अनुग्रहु : अनुग्रह+कए। 'कृपा अनुग्रह अंगु अधाई ।' मा० २.३००.५ 'कृपा' से प्रभु के सामथ्र्य की व्यञ्जना होती है जबकि 'अनुग्रह से भक्त का ग्रहण करने-अपना अङ्ग बना लेने का अर्थ आता है।
अनुचर : वि०पु० (सं०) पीछे चलने वाला, अनुगामी, परिचारक । मा० १.२७८.१
अनुचरन्ह : अनुचर+कए । अनुचरों (ने) । 'मम अनुचरन्ह कीन्ह मख भंगा।' मा० ७.५६.४
अनुचरीं : वि० स्त्री० बहु० । अनुचरियाँ, पीछे चलने वाली परिचारिकाएं, दासियां । 'तव अनुचरी करउं, पन मोरा।' मा० ५.६.५
_______________________________________________
27
अनुचित : वि० (सं०) उचित का विलोम, अनह अयोग्य । मा० १.६२.१
अनुचितु : अनुचित---कए । एकमात्र प्रथम अनुचित आचरण । 'अनुचितु छमब जानि लरिकाई।' मा० २.४५.६
अनुज : सं० पु० (सं०-अनु पश्चात् जमः) । छोटा भाई।
अनुजन्ह : अनुज+संबं० । अनुजों (के प्रति) । 'आपु कहहिं अनुजन्ह समुझाई।' मा० १.२०५.६
अनुजहि : अनुज को। मा० १.२२५.३
अनुजा : सं० स्त्री (सं.)। छोटी बहन । मा० ७.१०२ छं०
अनुदिन, अनुदिनु : क्रि० वि० (सं० अनुदिनम्) प्रतिदिन । मा० २.२०५.२ जा०मा०
अनुपम : वि० (सं०) । उपमा रहित, अप्रतिम, अद्वितीय । मा० १.३६
अनुबाद, दा : सं० पु० (सं० अनुवाद) अनुकथन, पुनर्वचन, व्याख्याओं द्वारा वस्तुनिरूपण, प्रमाणीकरण । 'सुनत फिरउ हरिगुन अनुबादा।' मा० ७.११०.१२ दर्शनों में चार प्रकार के 'अनुवाद' बताए गए हैं--(१) यथार्थ कीर्तन (२) स्तुतिपरक कथन (३) गुण विवेचन और (४) अर्थवाद= अतिशयोक्तिपरक कथन ।
अनुभयउ : भू० ० ० कए । अनुभव किया, भोगा। 'मोहिसम यहु अनुभयउ न दुजें ।' मा० २.३.६
अनुभूये-अनुभव किये, भोगे । 'नये-नये नेह अनुभये देह गेह बसि ।' विन० २६४.२
अनुभव : सं० पु० (सं०) बोध-प्रत्यक्ष अनु मिति तथा शाब्द प्रत्यय । 'उमा कहउँ मैं अनुभव अपना ।' मा० ३.३६.५ (२) आत्म साक्षात्कार, स्वसंवेदन, स्वानुभूति । 'अनुभव-गम्य भजाई जेहि संता। मा० ३.१३.१२
अनुभव, अनुभवइ : (स० अनुभवति>प्रा० अणुहवइ) आ० प्रए। अनुभव करता है, स्वसंवेदा बनाता है-'सोइ हरिपद अनुभवै परम सुख ।' विन० १६७.४
अनुभवगम्य : वि० (सं०) स्वसंवेदनमात्र से ज्ञातव्य, साक्षिमास्य-जिसे दूसरे को इन्द्रियगम्य नहीं बना सकते, स्वयं ही जान सकते हैं, स्वानुभति के अतिरिक्त अन्य प्रमाणों से प्रमेय न होने वाला, अप्रमेय, अनिर्वचनीय । मा० ७.१११.४१
अनुभवति : वक्तृ० स्त्री। स्वयम् अनुभूति में जाती स्वसंवेदा बनाती। 'उर अनुभवति न कहि सक सोऊ ।' मा० २.४२
अनुभवहि, ही : आ० प्रब० । अनुभव करते हैं, स्वानुभूति में जाते हैं, स्वसंवेदा बनाते हैं। 'बचन अगोचर सुख अनुभवहीं । मा० २.१०८.४
अनुभवहि : आ० मए । तू अनुभव कर, साक्षात् जान ले । 'तुलसी तू अनुभवहि अब राम बिमुख की रीति ।' दो० ७३
28
_______________________________________________
अनुभवे : अनुभये । मानसिक रूप से जाने । 'बंचक विषय बिविध तनु धरि अनुभवे सुने अरु दीठे ।' विन० १७६.२
अनुभव : अनुभवइ।
अनुभाऊ : सं० पु० (सं० अनुभाव)+कए। (१) प्रभाव (२) आंतरिक मनःस्थिति (भाव) के सूचक व्यापार जो चार प्रकार के हैं-कायिक, वाचिक, सात्त्विक और आहार्य । 'बरनि सप्रेम भरत अनुभाऊ ।' मा० २८६.३
अनुभौ : अनुभव । गी० १.६६.३
अनुमान : सं० पु० (सं०) ज्ञात वस्तु के आधार पर अज्ञात वस्तु का बोध । 'सती हृदयं अनुमान किय ।' मा० १.५७ (२) क्रि० वि० । मात्रा या प्रमाण के अनुसार । 'बल अनुमान सदा हित करई ।' मा० ४.१.५
अनुमाना : (१) अनुमान । (क) अनुरूप, अनुसार । 'कहहि स्वमति अनुमाना।' मा० १.२१.४ (ख) समान । 'मुख नासिका नयन अरु काना । गिरि कंदरा खोह अनमाना।' मा० ६.१६.६ (ग) तक। करत कोटि बिधि उर अनुमाना।' मा० २.२६६.६ (२) भू० क० पु. अनुमान किया । इहां संभु अस मन अनुमाना ।' मा० १.५२.५
अनुमानि : पूकृ० । अनुमान करके । मा० १.११८.१
अनुमानी : (१) अनुमानि । मा० १.१०७.५ (२) वि० पुं० (सं० अनुमानिन)। अनुमान करने वाला=नैयायिक । 'तरकि न सकहिं सकलु अनुमानो।' मा० १.३४१.७
अनुमाने : भू कृ० पु० (बहु०) । अनुमान से ज्ञात किये। मा० १.६६.३
अनुमोदन : सं० पु० (सं०) समर्थन, सहर्ष सहमति । 'कहहिं सुनहिं अनुमोदन करहीं।' मा० ७.१२६.६
अनुराग : (१) सं० पु. (सं०) स्नेह, मन को तन्मय करने वाला प्रेम । मा० १.११ (२) आ०-आज्ञा-मए । तू अनुराग कर । 'जागि त्यागि मूढ़ताऽनुराग श्रीहरे।' विन० ७४.१
अनुराग, अनुरागइ : (अनुरक्त होना) आ० प्रए० । अनुरक्त होता है । 'सो कि दोष गुन गनइ जो जोहि अनुरागइ।' पा० मं० ६७
अनुरागउँ, ऊँ : आ० कए। अनुराग करूं, अनुरक्त होता हूं। 'राम पद अनुरागऊँ ।' मा० ४.१० छं०
अनुरागहिं, हीं : आ० उब। अनुराग करते हैं। अनुरक्त हों। 'तव चरन हम अनुरागहीं।' मा० ७.१३ छ
अनुरागहु, हू : आ०म०ब० अनुराग करो। 'राम पद अनुरागहू ।' मा० ३.३६ ई०
_______________________________________________
29
अनुरागा (१) अनुराग । मा० ११.१ (२) भू० कृ० पु । अनुरक्त हुआ।  'सिय मनु राम चरन अनुराग।' मा० २.७८.५
अनुरागिहै : आ० प्रए+मए। अनुराग करेगा। 'मन राम नाम सों सुभाय अनुरागिहै।' विन० ७०.१
अनुरागी : भूक० स्त्री० बहु० । अनुरक्त हुई । मा० १.२४७.२
अनुरागी : (१) वि० पु. (सं० अनुरागिन्) अनुराग युक्त । 'तुम्ह रघुबीर चरन अनुरागी।' मा० १.११२.८ (२) भू० कृ० स्त्री० अनुरक्त हुई। मा० २.१६६.२
अनुरागु, गू : (१) अनुराग+कए । अनन्य प्रेम । मा० १.१७७ (२) आ० आज्ञा-मए। तू अनुराग कर । 'अब नाथहि अनुरागु जागु जड़।' विन० १६८.४
अनुरागें : अनुराग से स्नेहपूर्वक । “विनय कीन्हि तिन्ह अति अनुरागें ।' मा० १.३०६.२
अनुरागे : भू० कृ०० बहु० । अनुरक्त हुए । 'अस कहि अपर भूप अनुरागे।' मा० १.२४६.७.
अनुरागेउ : आ० भू० कृ० +उए । मैं अनुरक्त हुआ।' 'सुनि प्रभु बचन बहुत  अनरागेउँ ।' मा० ७.८४.३
अनुरागेउ : भू०० पु० कए अनुरक्त हुआ। 'देखि मनोहर मूरति मनु अनुरागेउ ।' जा० मं० ४६
अनुरागै : अनुरागइ। विन० १३६.११
अनुरागौं : अनुरागउँ । 'परिहरि पायं काहि अनुरागौं ।' विन० १७७.१
अनुराग्यो : अनुरागे। अनुराग युक्त । 'निरन्तर रहत विषय अनुराग्यो ।' विन० १७०.१
अनुरूप (पा) : वि०+क्रि०वि० (सं०) अनुसार, समान, प्रतिरूप । ‘मति अनुरूप राम गुन गावउँ।' मा० १.१२.६
अनुरोधू : सं० पु० (सं० अनुरोध)+कए. विनीत आग्रह । 'राखउँ सुतहि करउँ अनुरोधू ।' मा० २.५५.४ ।।
अनुलेपन : सं० पु० (सं०) चन्दन आदि का लेप । गी० ७.१६.४
अनुसंधाना : सं० पु० (सं० अनुसंधान) अपेक्षा, आशा । 'हृदयं न कछु फल अनुसंधाना ।' मा० १.१५६.१
अनुसर, अनुसरइ, ई : (सं० अनुसरति>प्रा० अणुसरइ-पीछे चलना, अनुसरण करना) आ० प्रए। अनुसरण करता है-करे । 'जिमि पुरुषहि अनुसार परिछाहीं।' मा० २.१४१.६ 'सोइ-सोइ तब आयसु अनुसरई ।' मा० १.१६८.६
30
_______________________________________________
अनुसरऊँ : आ० उए। अनुसरण करूं (करता था)।' तह-तहं राम भजन अनुसरऊँ।' मा० ७.११०.१
अनुसरहीं : आ० प्रब० । अनुसरण करते हैं, अनुसार आचरण करते हैं। 'फनि मनि सम निज गुन अनुसरहीं।' मा० १.३.१०
अनुसरहु, हू : आ० मब० । अनुसरण (पालन) करो। 'सिर धरि गुर आयसु अनुसरहू ।' मा० २.१७६.६
अनुसरहुगे : आ० भ० पुं० मब० । अनुसार आचरण करोगे । विन० २११.२
अनुसरिए, ये : आ० क० बा० । अनुसरण किया जाता है । 'जाते बिपति जाल निसदिन दुःख तेहि पथ अनुसरिए ।' बिन० १८६.२
अनुसरु : आo-आज्ञा-मए । तू अनुसरण कर । 'सिर प्रनाम सेवा कर अनुसरु।' विन० २०५.३
अनुसरे : भू० कृ० पु० बहु० । अनुसरण करके आये । 'अब प्रभु पाहि सरन __अनुसरे ।' मा० ६.११०.१२
अनुसरेहू : आ० भ०+प्रे० मब० । तुम अनुसरण (पालन) करना । 'धर्म अनुसरेहू।' मा० ७.२०.२
अनुसर : अनुसरहिं । गी० १.७१.२
अनुसार : सं०+क्रि० वि० (सं०) । अनुरूप, अनुकूल । 'निज विचार अनुसार ।' मा० १.२३
अनुसारा : अनुसार । ‘समुझि परी कुछ मति अनुसारा । मा० १.३१.१
अनुसारी : (१) वि० पुं० (सं० अनुसादिन्) अनुरूप। 'देसकाल अवसर अनुसारी-बोले बचन ।' मा० २.४५.५ (२) भूकस्त्रीण चलाई, छेड़ी। 'तातें कछुक बात अनुसारी।' मा० २.१६.८
अनुसासन : सं० पू० (सं० अनुसासन) (१) आदेश, संदेश । 'सिव अनुसासन सुनि सब आए।' मा० १.६३.५ (२) विधि-विधान, नियम । 'कोउ नहिं मान निगम अनुसासन ।' मा० ३.६७.२
अनुसुइया : (सं० अनसूया)। अत्रि की पत्नी (असूया ईर्ष्या से रहित)। मा० ३.५.१
अनुसत्य : पूक (सं०) । अनुसरण करके, मानकर । विन० ५०.५
अनुसोचनो : सं० पू० कए (सं० अशोचनम्) । अशोचनीय बात पर बार-बार शोक करना, व्यर्थ उधेड़ बुन करना । 'अनसमुझे अनुसोचनो।' दो० ४८६ अनुहर
अनुहरइ,ई : (सं० अनुहरति>प्रा० अणुहरइ-सदृश प्रतीत होना, अनुरूप होना) आ० प्रए । समान या अनुरूप लगता है । 'सहज टेढ़, अनुहरइ न तोही।' मा० १.२७७.८
_______________________________________________
31
अनुहरत : वकृ पुं० । अनुरूप शोभा देता, समान प्रतीत होता । 'चरित करत नर अनुहरत ।' मा० २.८७
अनुहरि : पूकृ० । अनुसार ग्रहण करके--- अनुसरण करके । 'अनुहरि ताल गतिहि नटु नाचा ।' मा० २.२४१.४
अनुहरिया : भू० कृ० पु । उपमति, अनुरूप पाया गया, अनुसार हुआ, उपमा में आया। 'मुख अनुहरिया केवल चंद समान ।' बर० ६
अनुहार : सं+पि० (सं.)। अनुरूप, योग्य, समान। 'सगुन समय अनुहार ।' स० प्र० ७.१.३
अनुहारि : (१) वि० स्त्री० । अनुरूप लगने वाली । 'बर अनुहारि बरात न भाई।' मा० १.६३.१ (२) पूक० । अनुसार करके, समान बनाकर । 'बोले बचन समय अनुहारि ।' मा० १.२३०
अनुहारी : अनुहारि अनुसार । 'सुभ अरु असुभ करम अनुहारी-ईसु देइ फल ।' मा० २.७७.७ (२) सं० स्त्री०। प्रतिकति, प्रतिभूति, समान आकृति । 'भरतु राम ही की अनुहारी।' मा० १.३११.६ ़
अनूप (पा) : वि० (सं० अनूप जलाशय के निकट की भूमि) पवित्र, शीतल - प्रभाव वाला, सुखद, उत्तम । 'ब्रह्मसुहिं अनुभवहिं अनूपा । मा० १.२२.२
अनूपम : अनूपम । अद्वितीय । मा० १.१६.२
अनूपान : सं० पुं० (सं० अनुपान) पेय या लेह्य पदार्थ जिसे दवा के साथ लिया जाता है (शहद, स्वरस आदि) । मा० ७.१२२.७
अनूत : सं० वि० (सं०) असत्य । मा० ६.१६.३
अनेक, का: एक से अधिक, दो या बहुत । मा० १.६.६
अनेरे : वि० पु। विचित्र, उत्पाती। 'छोटे निपट अनेरे ।' कृ. ३
अनेरो : वि०+क्रि० वि० पू० कष्ट । दूर-दूर, विचित्र, पराया जैसा। निसि दिन फिरते अनेरो।' विन० १४३.१
अनै : अनय । गी० ५.४०.३
अनैसी : 'अनइस'+स्त्री० । अयोग्य, अनुचित, प्रतिकूल । कबि०७.६
अनैसें : क्रि० वि० । अन्य प्रकार से अनुचित रीति से प्रतिकूल ढंग से। 'अजहुं बंधु तव चितव अनसें ।' मा० १.२७६.७
अन्तरात्मा : सं० पुं० (सं.)। जीव-चेतना के साथ अनुस्यूत परमात्मा = अन्तर्यामी ; प्रेरक । मा० ५ श्लो० २
अन्न : सं० पुं० (सं०) (१) अनाज। मा० १.१०१.८ (२) खाद्य सामग्री। 'अन्न सो जोइ-जोइ भोजन करई ।' मा० १.१६८.६
32
_______________________________________________
अन्नपूरना : सं० स्त्री० (सं० अन्नपूर्णा) । काशी में प्रसिद्ध एक देवी का नाम कवि० ७.१४८ अन्नप्रासन सं० ० (सं० अन्नप्राशन) । शिश को प्रथम वार अन्न खिलाना आरम्भ करने का कर्म विशेष । गी० ७.३५.२
अन्ने : वि० पू० व० सं० अन्येग अन्य लोग । 'ये चापि अन्ने ।' विन० ५७.२
अन्य : वि० (सं०) अपर, इतर, भिन्न
अन्यतः : क्रि० वि० (सं.)। अन्य (स्रोतों) से । मा० १ श्लो० ७
अन्यथा : अव्यय (सं.)। प्रतिकूल, अन्य प्रकार से, विपरीत । मा० १.७१.८
अन्याई : वि० (सं० अन्यायी) अन्याय या उपद्रव करने वाला, उत्पाती, अनाचारी। हूँ - -
अन्याउ : 'अन्याय'+ कए । अनुचित, अयोग्य । 'अति अन्याउ. अली' । गी०२.१०.१
अन्याव : अन्याउ । दिन० २७२.३
अन्वेषण : संपु० (सं०) । खोज, गवेषण, अनुसन्धान । मा० ४.श्लो०१
अन्हवाइ, ई : पुकृ० । नहलाकर मा० १.४३
अन्हवाइय : अन्हवावा । नहलाया। 'जुबतिन्ह मंगल गाइ राम अन्हवाइय' । रान०३
अन्हवाएँ : नहलाने (से) । 'रामचरित सर बिनु अन्हवाएँ' मा० १.११.५
अन्हवाए : भू० कृ०० बहु० । नहलाये। 'एक बार जननी अन्हवाए।' मा० १.२०१.१
अन्हवावउँ : आ० उ०प्र० । नहलाता हूँ। 'संकर चरित सु-सरित मनहि अन्हवावउँ।' पा०म०३
अन्हवावहु : अ० मब० । नहलाओ। 'प्रथम सखन्ह अन्हवावहु जाई। मा०. ७.११.२
अन्हवावा : भूपु । नहलाया। 'नृप तनु बेद बिदित अन्हवावा'। मा० २.१७०.१
अन्हवैया : विकृ० । नहाने वाला-वाले । गी० १.६.६
अन्हवैहै : आ०प्रए० भ० । नहलायेगा । 'को भोरही उबरि अन्हव है' । गी० १.६६.२
अपकार : सं०पू० (सं०) । दुर्व्यवहार (उपकार का विलोम) । मा० १.१३७.७
अपकारा : अपकार । मा० ६.२४.६
अपकारी : वि०पु. (सं०) अपकार करने वाला । मा० २.१७३.३
अपकीरति : सं०स्त्री० (सं० अपकीर्ति) । अयश कुख्याति । मा० १.२७३.७
अपघरा : सं०स्त्री० (सं० अप्सरस्>प्रा० अच्छरा) देवाङ्गना, स्वर्ग की नर्तकी । मा० १.८५.७०
_______________________________________________
33
अपजस : सं० पुं० (सं० अपयशस्) । अयश, अपकीर्ति, कुख्याति । मा० १.७ ख
अपजसु : अपजस+कए। एकमात्र अयश। 'घरु जाउ अपजसु होउ ।' मा० १६६ छं०
अपडर : सं० पु. (सं० आत्म-दर>प्रा० अप्पडर) अकारण भय, अपने-आप में डरना । 'अपडर डरेउँ न सोच समूलें।' मा० २.२६७.३ (दे० अपभय) ।
अपडरनि : अपडर+संब०। अपने-आप ही भयों से । 'अब अपडरनि डरयो हौं।' विन० २६६.३
अपडरे : भू०० पु. बहु० । अपने भीतर भयाक्रान्त हुए । मा० ६.८६ छं०
अपत : वि. (सं० अपात्र>प्रा० अपत्त) अयोग्य, नीच, पातकी। कवि० ७६८
अपतु : अपत+कए। अद्वितीय पातकी। 'अपतु अजामिलु गजु गनिकाऊ ।' मा० १.२६.७
अपनपउ : सं० पुं० कए (सं० आत्मपदम्>प्रा० अप्पणपयं>अ. अत्पणपउ) । अपना पद, स्वरूप, स्वाधिकार। अपनाया। मा० २.१६०
अपनपौ : अपनपउ । 'सदा रहहिं अपनपी दुराएं।' मा० १.१६१.२
अपना : वि. पु. (सं० आत्मनः>प्रा० अप्पणो) निजका । 'उमा कहउँ मैं अनुभव अपना ।' मा० ३.३६.५
अपनाइ : पू०। अपना करके, अङ्गीकृत करके (अपना बनाकर)। मा० १.१६१.७
अपनाइन, अपनाइए : आ० क० बा० प्रए । अपना बनाइए, स्वीकार कीजिए। मा० ६.११६.७, विन० २६७.४
अपनाए : भू० कृ० पु बहु० । अपने बना लिए । 'सकृत प्रनाम किएँ अपनाए।' मा० २.२६६.३
अपनाय : अपनाइ। गी० ५.५१.४
अपनायति : सं० स्त्री०। आत्मीयता, अपनापन, घनिष्ठता। 'देखी सुनी न आजु लौं अपनायति ऐसी।' विन० १४७.४
अपनाया भू० कृ० पुं० । अपना बना लिया, स्वीकार किया। 'जब तें रघुनायक अपनाया ।' मा० ७.८६.३
अपनायो : अपनाया+कए। गी० ५.४४.३
अपनावा : अपनाया । 'निज जन जनि ताहि अपनावा।' मा० ५.५०.२
अपनियां : अपनी । 'प्रेम बिबस कछु सुधि न अपनियाँ ।' गी० १.३४.६
अपनी : अपनी में । 'अपनों समुझि साधु सुचि को भा ।' मा० २.२६१.२
अपनी : वि० स्त्री। निज की। मा० २.२८४.१
अपनी-अपना : एक सामूहिक होड़ जिसमें सब पहले कर लेना चाहते हैं । 'देव कहैं अपनी-अपना अवलोकन तीरथराज चलो रे।' कवि० ७.१४४
34
_______________________________________________
अपने : (१) अपने में । 'फिरत सनेहं मगन सुख अपर्ने ।' मा० १.२५.८ (२) अपने - आप (से) । 'समुझि सहम मोहि अपडर अपनें ।' मा० १.२६.२
अपने : 'अपना' का रूपान्तर । निज के । मा० १.१२.५
अपना : अपना+कए। गी० १.७०.४ ।।
अपबरग : सं० पू० (सं० अपवर्ग) परम लक्ष्य की प्राप्ति । मोक्ष-जिसके चार " प्रकार हैं (१) सायुज्य (२) सालोक्य (३) सारूप्य और (४) साष्टि। 'सुत चारी । जनु अपबरग सकल तनुधारी।' मा० १.३१५.६
अपबरगु : अपबरग-+-कए । मा० २.१३१.७
अपबर्ग, गा : अपबरग । मा० ५.४; ७.४६.७
अपबाद, दा : सं० ० (सं० अपवाद) निन्दा, कुख्याति । मा० १.६४.३
अपबादु, दू : अपबाद+कए। एक मात्र निन्दा । “जसु जग जाइ, होइ अपबादू ।' मा० २.७७.४
अपभयं : क्रि० वि० (सं० आत्मभयेन>प्रा० अप्पभएण>अ० अप्पभएँ) अपने-आप ही भय के कारण (अकारण भय से) । 'अपभय कुटिल महीप डेराने ।' मा० १.२८५.८
अपभय : सं० पृ० (सं० आत्मभय>प्रा० अप्पभय) अकारण अपनी ही त्रुटि से उत्पन्न भय (=अपडर)। 'बिनय करौं अपभयह तें, तुम परम हित हौं।' विन० २७०.३
अपमानहिं : अपमान से को। मा० ६.३०.८
अपमानता : सं० स्त्री० (सं० अपमान्यता) अपमानित होना । 'गुट अपमानता सहि नहिं सकेउ महेस ।' मा० ७.१०६ ख
अपमाना : अपमान । 'तै सीता मम कृत अपमाना।' मा० ५.१०.१
अपमान : अपमान+कए । तिरस्कार । 'सिव अपमान न जाइ सहि ।' मा० १६३
अपर : वि० (सं०) अन्य । मा० १.४६
अपरना : सं० स्त्री० (सं० अपर्णा) पार्वती (तपस्या में उन्होंने पत्ते (पर्ण) खाना भी छोड़ दिया था अतः यह नाम पड़ा) । मा० १.७४.७ .
अपराध : सं० पु० (सं०) दण्डनीय अनुचित कर्म । मा० २.६१.७
अपराधा : अपराध । मा० १.५८.२
अपराधी : वि० पुं० (सं०) । अपराध करने वाला । मा० १.२७५.६
अपराधु, धू : अपराध+कए। एकमात्र (बड़ा) दोष । 'को बड़ छोट कहत अपराधू ।' मा० १.२१.३।
अपलोक : सं० पु० (१) (सं० अपलोक)। नरक आदि कुत्सित लोक; (२) (सं० अपलोक) अपयश, कुख्याति । 'लहहिं सुजस अपलोक बिभूती।' मा० १.५.७
अपलोक : अपलोक+कए । अपयश, अद्वितीय अपकीर्ति । 'अब अपलोकु सोकु सुत तोरा।' मा० ६.६१.१३
