प्रसन्न : वि० (सं०) । (१) प्रसादयुक्त (निर्मल चित्त) । ‘भए प्रसन्न चंद्र अवतंसा।' मा० १.८८.६ (२) कृपापूर्ण । 'होहु प्रसन्न देहु बरदानू ।' मा० १.१४.७
प्रसन्नता : संस्त्री० (सं.) । प्रसाद, हर्ष । मा० २ श्लो० २
प्रसन्ने : (सं०) प्रसन्न होने पर । विन० ५७.२
प्रसव : सं०० (सं.)। सन्तानोत्पादन, प्रजनन । 'बोझ कि जान प्रसव के पीरा।' मा० १.९७.४ (२) कोमल दल, पल्लव । 'अरुन नील पाथोज प्रसव ।' विन० ६२.३ (३) दे० /प्रसव ।
प्रसव, प्रसवइ : (सं० प्रसूते>प्रा० पसवइ>अ० प्रसवइ) आ०प्रए । जन्म देती है। 'मुकता प्रसव कि संबुक काली।' मा० २.२६१.४
प्रसव-पवन : गर्भाशय का वायविशेष जिससे बच्चा गर्भ से बाहर आता है। विन० १३६.५
प्रसाद : सं०० (सं०) । (१) अनुग्रह, कृपा । 'संभु प्रसाद सुमति हियँ हुलसी।' मा० १.३६.१ (२) प्रसन्नता, हर्ष । 'समुझि परा प्रसाद अब तोरें।' मा० ६.१६.५ (३) प्रभाव । 'नाम प्रसाद सोच नहिं सपनें ।' मा० १.२५.८ (४) देव से प्राप्त वस्तु, देवोच्छिष्ट । प्रभु प्रसाद पट भूषन धरहीं । मा० २.१२६.२
प्रसादा : प्रसाद । 'दीन्हे भूषन बसन प्रसादा ।' मा० ७.२०.१
प्रसादु, दू: प्रसाद+कए । अनन्य कपा (आदि)। 'नाम जपत प्रभु कीन्ह प्रसादू ।' मा० १.२६.४; २.१०२.८
प्रसिद्ध : वि० (सं.)। (१) स्वयंसिद्ध (प्रमाण-निरपेक्ष) । 'पुरुष प्रसिद्ध प्रकास निधि ।' मा० १.११६ (२) प्रमाणित । 'आगम निगम प्रसिद्ध पुराना।' मा० २.२६३.७ (३) विख्यात । 'कथा प्रसिद्ध सकल जग माहीं।' मा० १.६८.६
प्रसीद : आ०-प्रार्थना-मए० (सं.)। तू प्रसन्न हो, अनुग्रह कर । 'प्रसीद प्रसीद प्रभो मन्मथारे ।' मा० ७.१०८.१२
प्रसूति : सं०स्त्री० (सं.)। प्रसवस्थान, जनक कारण, जननी । 'रघुबर प्रेम __प्रसूति ।' दो० १५२
प्रसूती : प्रसूति । 'मंजुल मंगल मोद प्रसूती ।' मा० १.१.३
प्रसून : संपु० (सं०) पुष्प । मा० १.३३०
प्रस्थिति : सं०स्त्री० (सं०) । प्रस्थान---यात्रा । मा० ५.३५ छं० २
प्रस्न : सं० (सं० प्रश्न) । (प्राकृत-परम्परा से स्त्रीलिङ्ग) । 'कीन्हि प्रस्न जेहिं भांति भवानी ।' मा० १.२३.१
प्रहरषे : भूकृ००ब० । प्रसन्न हुए। मा० ७.१२.३
प्रहलाद, दा : प्रह्लाद । मा० १.२७
_______________________________________________
647
प्रहलादू : प्रह्लाद+कए । 'भगत सिरोमनि भे प्रह्लादू ।' मा० १.२६.४
प्रहस्त : रावण का सेनापति राक्षस । मा० ६.८
प्रहार : सं०० (सं.)। मार । मा० ४.८.३
प्रहारा : प्रहार । मा० ५.४१.६
प्रहलाद : सं०पू० (सं०) । विष्णुभक्त दैत्यराज=हिरण्यकशिपु का पुत्र । विन०
प्रहलादपति : नृसिंह भगवान् । मा० ६.१ ।
प्राकृत : सं+वि० (सं.)। (१) सामान्य, पामर । 'प्राकृत नारि अंग अनुरागीं।' मा० १.२४७.२ (२) प्रकृति से उत्पन्न ; मायाधीन । 'कीन्हें प्राकृत जन गुन गाना ।' मा० १.११.७ (३) (आध्यात्मिक का विलोम) मायिक, भौतिक, प्रकृति में सीमित । 'प्राकृत प्रीति कहत बड़ि खोरी।' मा० २.३१८.१ (४) प्रकति (माया) को स्वेच्छा से ग्रहण कर अवतीर्ण । विन० ५३.३ (५) भाषा विशेष जिसका अध्ययन संस्कृत को प्रकृति (मल) मान कर किया जाता है। 'जे प्राकृत कबि परम सयाने ।' मा० १.१४.५
प्राची : सं०स्त्री० (सं.)। पूर्व दिशा । मा० १.१६.४
प्रात : अव्यय (सं० प्रातर) । सबेरा, सबेरे, प्रभात । मा० १.४४.८
प्रातकाल : (सं० प्रात:काल)। मा० १.२०५.७
प्रातकृत : (सं० प्रातःकत्य)। शौच-स्नान सन्ध्या आदि कर्म । मा० २.१०५.२
प्रातक्रिया : (सं० प्रातःक्रिया) =प्रातकत । मा० १.३३०.४
प्राता : प्रात । 'अवसि दूतु में पठइब प्राता।' मा० २.३१.७
प्रातु : प्रात+कए० । प्रथम प्रभात । 'होत प्रातु मुनि बेष धरि जौं न राम बन जाहिं ।' मा० २.३३
प्रान : सं०० (सं० प्राण) । शरीर स्थित वाय विशेष जो जीवन धारण का कारण है। इसके पांच भेद हैं- (१) हृदय में प्राणवायु; (२) गुद में अपान; (३) नाभि में समान (पाचक वाय); (४) कण्ठ में उदान और (५) सम्पूर्ण शरीर में व्याप्त रक्तादि-संचारकारी व्यान वायु । अतएव इसका बहुवचन प्रयोग पाया जाता है । 'करहिं न प्रान पयान अभागे।' मा० २.७६.६ जीवनार्थक प्रयोग भी चलते हैं - 'बिधि हरिहरमय बेद प्रान सो।' मा० १.१६.२
प्राननाथ : प्राणों का स्वामी ==प्रिय पति । मा० २.६४
प्राननाथु : प्राननाथ+कए० । प्राणों का अनन्य स्वामी। 'प्राननाथु रघुनाथ गोसाई ।' मा० २.१६६.८
प्राननि : प्रान+संब० । प्राणों (को)। 'पातकी पांवर प्राननि पोसों।' कवि० ७.१३७
प्रानपति : प्राननाथ । मा० १.७४.१
648
प्रानपिआरे : (दे० पिआरे)। प्राणों को प्रिय+प्राणों से अधिक प्रिय । मा० २.४८८
प्रानपियारी : प्राणों को (से) प्रिया । मा० १.७१.४
प्रानपियारे : प्रानपिआरे । गी० १.६८.१२
प्रानप्यारे: प्रानयिारे । गी० १.३७.१
प्रान-प्रिय : प्राणों को प्रिय+प्राणों से अधिक प्रिय । मा० १.२६०
प्रानप्रिया : प्रानपियारी । मा० २.२५.८
प्रानप्रियाउ : प्राणप्रिया भी। गी० ७.२५.६
प्रानबल्लभ : प्रानप्रिय । गी० ५.५१.५
प्रानबल्लभा : प्रानप्रिया । गी० ३.१०.२
प्रानहेतु : प्राणधारण का कारण । कवि० ५.३०
प्राना : प्रान । मा० २.५८.४
प्रानी : सं०० (सं० प्राणिन्) । प्राणधारी=जीव । मा० १.११३.५
प्रानौ : प्राण भी। 'प्रानौ चलिहैं परमिति पाई ।' क० २५
प्रापति : सं०स्त्री० (सं० प्राप्ति) । लाभ । 'रतिन के लालचिन प्रापति मनक की।' कवि० ७.२०
प्रापतिउ : प्राप्ति भी। दो० ३५३
प्राप्त्यै : (सं० पद) प्राप्ति के लिए, पाने हेत । मा० ७.१३० श्लोक १
प्राप्य : वि० (सं०) । प्राप्त होने योग्य, लभ्य । विन० ५७.२
प्राबिट : सं०स्त्री० (सं० प्रावट) । पावस । मा० ६.४६.६
प्रिय : वि० (सं.)। (१) प्रीतिकर, रुचिकर । 'प्रिय बानी ।' मा० ६.६.८ (२) अभीष्ट, जिस पर प्रीति हो। 'प्रिय तनु ।' मा० १.१६ (३) प्रेमपात्र, प्रेमालम्बन । 'अतिसय प्रिय करुनानिधान की ।' मा० १.१८.७ (४) पति ।
प्रियजन : प्रीतिकर लोग जो प्रिय हों और प्रेम करते हों । मा० २.१६४.५
प्रियतम : (१) वि.पु० (सं.)। सर्वाधिक प्रिय । 'अतिथि पूज्य प्रियतम पुरारि के ।' मा० १.३२.८ (२) पति, स्त्री का प्रेमी।
प्रिवबादिनि : वि.स्त्री० सम्बोधन (सं० प्रियवादिनि) । हे प्रीतिकर वचन बोलने वाली ! मा० २.१५.१
प्रियव्रत : (सं० प्रियव्रत) । स्वायंभुव मनु का ज्येष्ठ पुत्र । मा० १.१४२.४
प्रियसीला : वि० (सं० प्रियशील) । प्रीतिकर शील वाला, स्वभावतः प्रीतिकारी। मा० १.१६२ छं०
प्रिया : प्रिय+स्त्री प्रेमालम्बन स्त्री, पत्नी । मा० १.७१ प्रोतम । प्रियतम । मा० ३.२६ छं०
_______________________________________________
649
प्रीतमु : प्रीतम+कए० । अनन्य प्रियतम । 'हृदउ न बिदरेउ न पंक जिमि बिछुरत __पीतमु नीरु ।' मा० २.१४६ -
प्रीता : वि० (सं० प्रीत)। प्रिय । 'हित अनहित मानहु रिपु प्रीता।' मा० ५.४०.७
प्रीति, ती : सं०स्त्री० (सं० प्रीति)। (१) तृप्ति, तुष्टि । 'कहउँ प्रतीति प्रीती रुचि मन की।' मा० १.२३.३ (२) मंत्री। 'सीता देइ करहु पुनि प्रोति ।' मा० ६.६.१० (३) प्रेम । 'प्रभु पद प्रीति न सामुझि नीकी ।' मा० १.६.५ (४) वर्णमंत्री जो अर्थ में विशेषता लाती है (वर्ण वक्रोक्ति) । 'बरनत बरन प्रीति बिलगाती।' मा० १.२०.४ (यहाँ प्रेम अर्थ भी है।)
प्रीतीं : प्रीति से, प्रेमपूर्वक । 'मिले जनकु दसरथु अति प्रीतीं।' मा० १.३२०.१
प्रीते : पिरीते । प्रसन्न, सन्तुष्ट, प्रेमयुक्त । 'गुर पद कमल पलोटत प्रीते।' मा० १.२२६.५
प्रेत : सं०पू० (सं.)। मरने और पुनर्जन्म के मध्य का जीव जो सूक्ष्म शरीर में रहता है । मा० १.८५.६
प्रेतपावक : शीतकाल की रातों में गीली मिट्टी वाले स्थानों पर गाँव से कुछ दूर एक प्रकार का प्रकाश चलता-फिरता दिखता है । ऐसा लगता है कि किसी ने अलाव जलाया है। जाड़े का पथिक उसे पाना चाहता है तो वह या तो लप्त हो जाता है, या दूर भागता है। उसे आधुनिक अवधी में 'अगिया बैताल' कहते हैं । लोग उसे भूत समझकर डर जाते हैं । वह मिले तो कहा जाता है, भूत पटक देता है । 'उभय प्रकार प्रेमपावक ज्यों धन दुखप्रद । विन० १६६.५
प्रेम, मा : संपु० (सं.)। (१) लगाव, आसक्ति । 'पूछ सों प्रेम बिरोध सींग सों।' कृ० ४६ (२) स्नेह, प्रीति । 'प्रेम पीन पन छीजै।' कृ० ४५ (३) प्रेम और प्रेमा में भक्ति दर्शन के अनुसार अन्तर है-प्रेम में अपने को आलम्बन से तृप्ति मिलती है जबकि प्रेमा वह दशा है जब प्रेमालम्बन को तृप्ति देकर स्वयं तृप्ति पायी जाती है। प्रेमा=प्रियता=प्रियभावना-प्रेमा वह अनन्य भावना है जो प्रिय के साथ एकाकार कर देती है। दे० प्रेमा।
प्रेमपथ : सं०० (सं.) । प्रेम के एकाङ्गी रूप के पालन का सिद्धान्त । 'मौंगी रहि, समुझि प्रेमपथ न्यारो।' गी० २.६६ ५
प्रेममय : वि० (सं.)। (१) प्रेमरूपी । 'परम प्रेममय मदु मसि कीन्ही ।' मा० १.२३५.३ (२) प्रेमपूर्ण । 'पतिहि प्रेममय बिनय सुनाई ।' मा० २.६७.७
प्रेमरस : (१) प्रेम की वह परिणति जो सदैव आनन्दलीन रखे। वही काव्यरस भी बनता है तो-दास्य, वात्सल्य, सख्य, माधुर्य तथा शम भागों में विभक्त होकर भक्ति रस कहलाता है । बल्लभाचार्य ने इसे स्नेह रस नाम दिया है। (२) वात्सल्य सूचक स्तन्यस्राव-जिसे भक्ति रस में सत्त्विक भाव माना गया है। 'स्रवत प्रेमरस पयद सुहाए ।' मा० २.५२.४
प्रेमसुख : प्रेमरस । भक्तिरूप सुख । 'परमानंद प्रेमसुख फूले।' मा० १.१६६.५
प्रेमहि : प्रेम को । 'प्रेमहि न प्रबोधू ।' मा० २.२६३.८
प्रेमा : सं०० (सं०) दे० प्रेम । (१) प्रेमालम्बन की तृप्ति हेतु की हुई अनन्य भावना । स्वसुख-निरपेक्ष प्रेम । 'काय बचन मन पति पद प्रेमा।' मा० ३.५.१० (२) प्रेम । 'संत चरन पंकज अति प्रेमा ।' मा० ३.१६.६ (३) प्रेमा भक्ति जिसमें चित्तवृत्ति । आराध्य से एकाकार हो जाती है और प्रेम से पृथक कोई प्रयोजन नहीं रहता-प्रेम ही एकमात्र साध्य बन जाता है। 'सब कर फल रघुपति पद प्रेमा।' मा० ७.६५.६
प्रेमाकल : प्रेम में विभोर । मा० ५.३२
प्रेमातुर : प्रेमजनित संभ्रत (हड़बड़ी) से युक्त । मा० ७.६.४
प्रेमु : प्रेम+कए ० । अद्वैत अनन्य प्रेम । 'प्रेम प्रमोदु न थोर ।' मा० १.३२१
प्रेर प्रेरइ : (सं० प्रेरयति>प्रा. पेरइ>अ० प्रेरइ) आ०ए० । प्रवृत्त करता है, चलाता है, उकसाता है, प्रेरित करता है। रिद्धि सिद्धि प्रेरइ बहु भाई।' मा० ७.११८.७
प्रेरक : वि० (सं०) । (१) कार्यों में प्रवृत्त करने वाला। 'माया प्रेरक सीव ।' मा० ३.१५ (२) सबके हृदय में रहकर प्रेरणा देने वाला=अन्तर्यामी । 'उर प्रेरक रघुबंस बिभूषन ।' मा० ७.११३.१
प्रेरकानंत : (प्रेरक+अनन्त) अन्तर्यामी तथा असीम । विन० ५३.३
प्रेरत : वकृ.पु ! चलाते । 'रूप निहारत पलक न प्रेरत ।' गी० २.१४.२
प्रेरा : भकृ०० । प्रेरित किया, उकसाया। 'जाइ सुपनखा रावन प्रेरा ।' मा ३.२१.५
प्रेरि : पूकृ० । प्रेरित कर । गिरिहि प्रेरि पठएह भवन ।' मा० १.७७
प्रेरित : प्रेरा (सं०) । 'प्रेरित मोह समीर ।' मा० ७.८१ ख
प्रेरें : प्रेरित होने पर, प्रेरणा से । 'तस कहिहउँ उर हरि के प्रेरें।' मा० १.३१.३
प्रेरे : भूकृ०० ब० । प्रेरित किये (हुए) । 'आवत बालितनय के प्रेरे।' मा० ६.३२.१०
प्रेरेउ : भूकृ.पु०कए० । प्रवृत्त किया। 'राम जबहिं प्रेरेउ निज माया। मा०. ३.४३.२
प्रेर् यो : प्रेरेउ। विन० १३६.५
प्रोक्त : भूक० (सं०)। कहा हुआ, प्रवचन किया हुआ । मा० ७.१०८ छं०६

_______________________________________________
651
प्रौढ : वि० (सं.)। (१) प्रगल्भ, परिपक्व, वयस्क । 'प्रौढ भएँ मोहि पिता पढ़ावा ।' मा० ७.११०.५ (२) पुष्ट, दृढ ; बद्धमूल । 'प्रौढ अभिमान चित वृत्ति छीज ।' विन० ४७.२ ।
प्रोढि : सं०स्त्री० (सं.)। प्रौढोक्ति, अतिरञ्जना, अतिवाद, अर्थवाद, प्रशंसापरक अत्युक्ति। 'प्रोढि सुजन जनि जानहिं जनकी ।' मा० १.२३.३
प्लव : संपु० (सं.)। नौका । यत्पदो प्लव एक एव हि भवाम्भोधेस्तितीर्षावताम् ।' मा० १ श्लोक ६
## फ
फँग : संपुं० । फंदा, जाल, जकड़, बन्धन । 'मातु पितु भाग बस गए परि फेंग हैं।' गी० २.२७.२
फँसावत : वकृ०पू० (सं० पाशयत् >प्रा० पासावंत) । पाश में जकड़ता, जाल में डालता । 'काम फंद जन चंदहि बनज फँसावत।' जा०म० १०६
फैँसोरि : सं०स्त्री० (सं० पाशावलि)। फंदा, बन्धन । गी० ७.१८.१
फँव, दा : सं०० (सं० स्पन्द>प्रा० फंद) । पाश, जाल, बन्धन । 'मनहुं मनोभव फंद संवारे ।' मा० १.२८६.१ बन्धन के अर्थ में 'स्पन्द' धातु का प्रयोग संस्कृत में भी द्रष्टव्य है--स्पन्दिता: पाश-जालेश्च निर्यत्नाश्च शरैः कृताः।' हरिवंश पर्व ४५.१०
फग : फंग । 'हाय हाय करत परीगो काल फग में ।' कवि० ७.७६
फगुप्रा : फागु । वसन्तोत्सव । 'लोचन आँहि फगुआ मनाइ ।' गी० ७.२२.७
फजीहत : सं० (अरबी-फजीअत, फजअत-मसीबत, दसख्त)। उत्पीडन, विपत्ति । (२) (विशेषणात्मक प्रयोग में) क्लेशयुक्त, पीडित, संकटग्रस्त । 'अंत फजीहत होहिंगे गनिका के से पूत ।' दो० ६५
फिट फटइ : (सं० स्फटति>प्रा० फट्टइ) आ०प्रए । विशीर्ण होता है (स्कट विशरणे); विदीर्ण हो जाता है, फटता है। 'संकट सोच......फट मकरी के से जाले ।' हनु० १७
फटत : वकृ.पुं० (सं० स्फटत् >प्रा० पटुंत)। विशीर्ण होता, फटता । 'दिनकर के उदय जैसे तिमिर तोम फटत ।' विन० १२६.२
652
_______________________________________________
फटिक : सं०० (सं० स्फटिक) । एक प्रकार का पारदर्शी श्वेत पत्थर । 'बैठे फटिक सिला पर सुंदर।' मा० ३.१.४
फटै : फटइ । फट जाय । 'सेवक को परदा फट, तू समरथ सी ले ।' विन० ३२.४
फट् यो : भूक००कए० । फटा हुआ । 'फट्यो गगन मगन सियत ।' विन० १३२.३
फणीन्द्र : सं०० (सं०) । सर्पराज शेषनाग । मा० ५ श्लोक १
फन : सं०० (सं० फण) । साँप का मुखभाग । गी० २.७१.३
फनि : सं. (सं० फणिन्) । सर्प । मा० १.३.१०
फनिक: फनि (सं० फणिक) । मा० २.४४.३
फोनिकन्ह : फनिक+संब० । सो (ने) । 'फनिकन्ह जन सिर मनि उर गोई :' मा० १.३५८.४
फनिक : फनिक+कए० । कोई सर्प । 'मनि बिन फनिकु जिऐ दुख दीना।' मा० २.३३.१
फनिहि : फणी को, सर्प को। दो० ३१५
फनी : फनि । सर्प । गी. ७.५.३
फनीस : सं०० (सं० फणीश) सर्पराज-शेषनाग । मा० ६.१०२
फब, फबई : (१) सं० पर्बति-पर्बगतौ>प्रा० पब्बई (२) (सं० पर्वति-पर्व पूरणे>प्रा० पव्वइ) आ०प्रए । चलता है+पूरा पड़ता है-भरा-पुरा लगता है= अच्छा जान पड़ता है, सोहता है। 'कटि पीत दुकूल नबीन फबै।' कवि० १.७
फबि : पू० । फब कर, शोभित होकर, शोभापूर्ण होकर । 'कहि न जाइ जो निधि फबि आई।' कृ० २५
फबै : आ०प्रब० (सं० पर्वन्ति>प्रा० पव्वंति>अ० पहि) । पूरे पड़ते हैं, अच्छे लगते हैं । 'तुलसी तीनि उ तब फबै जब चातक मत लेहु ।' दो० २८५
फबै : फबइ । फबता है, फब सकता है । 'तुलसी चातक ही फबै मान राखिबो प्रेम ।' दो० २८६
फर : (१) सं०० (सं० फर) । वाण आदि का अग्रभाग, फलक । 'बिनु फर बान राम तेहि मारा।' मा० १.२१०.४ (२) (सं० फल) वृक्षादि का फल । 'असनु अमिअ सम कंद मूल फर ।' मा० २.१४०.६ (३) परिणाम । निदरेसिहरु, पायसि फर तेउ ।' पा०म० २६
फर, फरइ : फलह । (१) फलयुक्त होता है-होती है; फलों से लदता-ती है। 'काटेहिं पै कदरी फरइ ।' मा० ५.५८ (२) सिद्ध होती है । 'फरइ सकल मन कामना ।' दो० ४५४
फरक : सं० स्त्री. (सं० स्फर)। स्फुरण, स्पन्दन, फड़कन । 'फरक अधर, डर निरखि लकुट कर ।' कृ० १५
_______________________________________________
653
फरक, फरकइ : (सं० स्फरति - स्फुरति>प्रा० फरक्कइ) आ०प्रए । फरकता ती है; स्पन्दित होता-ती है। 'दहिनि आँखि नित फरकइ मोरी।' मा० २.२०.५
फरकत : वकृ०० । फरकता-ते। 'फरकत अधर कोप मन माहीं ।' मा० १.१३६.२
फरकन : भकृ० अध्यय । फरकने, स्पन्दन करने । 'बाम अंग फरकन लगे।' मा०
फरकहिं : आoप्रब० । फरकते हैं, स्पन्दन करते हैं। 'फरहिं सुभद अंग सुनु भ्राता ।' मा० १.२३१.४
फरकि : पू० । स्पन्दित हो (कर)। 'फरकि उठी दो भुजा बिसाला।' मा० ४.६.१४
फरके : भूकृ.पुं०व० । स्पन्दित हुए, फरक उठे । 'फरके बाम बाहु लोचन बिसाल।' गी० ३.६.१
फरकेउ : भूकृ००कए । स्पन्दित हुआ । 'फरकेउ बाम नयन अरु बाहू।' मा० ६.१००.५
फरत : (१) फ्लत । 'सरस सुख फूलत फरत ।' विन० २५१.१ (२) फलतो।  'अभिमत फरनि फरत को।' गी० ६.१२.३
फरन : भक० अव्यय । फलने, फल सम्पन्न होने । 'उकठे बिटप लागे फूलन फरन।' विन० २५७.२
फरनि : फलनि । फलों (को, से, में) । सोउ बिष फरनि फर।' विन० १३७.५
फरसा : सं०० (सं० परश्वध परशु>प्रा० परस्सह परसु) । कुल्हाड़ा। मा० २.१६१.५
फरहार : सं०० (सं० फलाहार) फल भोजन । मा० २.२७९
फरहि, ही : फलहिं । 'फूलहिं फरहिं सदा तरु कानन ।' मा० ७.२३.१
फराक : वि०+क्रि०वि० (अरबी-फराक =जुदाई)। अलग । 'दूरि फराक रुचिर सो घाटा।' मा० ७.२६.१
फरि : फलि । 'बेलि ज्यों बौंड़ी.. "फैलि फुलि फरिक ।' गी० १.७२.३
फरित : फलित । विन० १६.१
फरी : फली । 'जनक मनोरथ कलप बेलि फरी है।' गी० १.६२.४
फर : फल । (१) फल (२) साध्य । 'को न लह्यो कौन फरु देव दामोदर तें।' कृ० १७ (३) भक्तिरूप परम पुरुषार्थ । 'नाम प्रेम चारि फलहू को फरु है।' विन० २५५.३
फरें : फलने पर । 'फरें पसारहिं हाथ ।' दो० ५२
फरे : फले । (१) फलों मे लद गये । 'सब तरु फरे राम हित लागी ।' मा० ६.५.५ (२) सिद्ध हुए । 'फरे चरु फल चारि ।' रा०प्र० ४.२.२
फरै : फरइ । 'सोउ बिष फरनि फरै ।' विन० १३७.५
654
_______________________________________________
फरंगो : आ०भ०पू०प्रए । फलेगा, फल देगा। 'कुटिल कटक फर फरैगो।' दो० ४५२
फरो: फलो। 'साधन तरु है स्रम फलनि फरो सो।' विन० १७३.१
फर् यो : फरो। 'तरु फर्यो है अदभुत फरनि ।' गी० १.२७.३
फलंग : सं०० (सं० प्रलङ्क>अ० पलंघ)। लाँघना, कूदना, उछाल, कूद । ___'फलँग फलाँगहूं तें घाटि नभ तल भो।' हनु० ५
फल : सं०० (सं०) । (१) वृक्षादि का फल । 'गलरि-फल ।' मा० ६.३४.३ 'गूलरि को सो फल ।' कृ० ४४ (२) परिणाम । 'मज्जन फल पेखिअ ततकाला।' मा० १.२.१३ (३) चतुर्वर्ग = धर्म, अर्थ, काम, मोक्ष । 'जो दायकु फल चारि ।' मा० २.०.१ (४) चार संख्या । दो० ४५६
फल, फलइ : (सं० फलति-फल निष्पत्तो>प्रा० फलइ) आ०प्रए । फलता है, निष्पन्न होता है, परिणत होता है, फलयुक्त होता है, फल देता है। 'जोग जुगुति तप मन्त्र प्रभाऊ । फलइ तबहिं जब करिम दुराऊ ।' मा० १.१६८.४
फलइ : फल ही, फल मात्र । 'एक फलइ केवल लागहीं।' मा० ६.९० छं०
फलत : वकृ०० । फल सम्पन्न होता-होते । मा० १.२१२ 'फूलत फलत पल्लवत पलुहत ।' गी० २.४६.३
फलतो : क्रियाति पुं०ए० । तो सफल होता । 'बैर तरु आज फैलि फूलि फलतो।' गी० ५.१३.३
फलनि : फल+संब० । फलों । जिमि गज अर्क फलनि को मार्यो।' मा० ६.६५.६
फलहिं : आ०प्रब० (अ.)। फलते हैं । 'फूलहिं फलहिं बिटप बिधि नाना ।' मा० २.१३७.६
फलाँग : सं०० (सं० प्रलङ्घ>प्रा० पलंघ) । लाँघने का एक क्रम । एक कुदान  का भू-भाग । 'फलँग फलाँगहूं तें घाटि नभतल भो।' हनु० ५
फलि : पूकृ० (अ०) । फलयुक्त होकर । मा० २.३११.७
फलित : भूक०वि० (सं०) । फलसम्पन्न, सफल । मा० २.१.७
फली : भूकृ०स्त्री० । फलित हुई, फलसंपन्न हुई। 'सुषमा बेलि नवल जनु रूप __फलनि फली ।' पा०म० १२५
फलु : फल+कए० । 'कालकूट फलु दीन्ह अमी को।' मा० १.१६.८
फले : भूकृ०० ब० । फल सम्पन्न हुए । 'द्रुम फले न फूले ।' गी० ३.१०.१
फलै : फलहिं । सफल होते हैं । 'फलै फूलै फैले खल ।' कवि० ७.१७१
फलो : भकृ०० कए० । फलित हुआ । 'प्रनाम कामतरु सघ बिभीषन को फलो।' गी० ५.४२.४
फहम : सं०० (अरबी-फहम = समझ, बोध) । स्मरण, ध्यान । 'पुलक सरीर सेना करत फहम ही ।' कवि ६.८ (२) विवेक । 'मोहि कछु फहम न तरनि तमी को।' विन० २६५.२ _______________________________________________
655
फहराहीं : आ० प्रब० । फरफराते हैं, आकाश में लहराते हैं। 'सख करहिं पाइक फहराहीं।' मा० १.३०२.७
फाँस : पास । बन्धन, जाल । 'माधव मोह फांस क्यों टूटै।' विन० ११५.१
फागु : सं०० (सं० फल्गु>प्रा० फग्गु) । वसन्तोत्सव । 'त्रिबिध सूल होलिय जर, खेलिय अब फागु ।' विन० २०३.१७
फागुन : सं०० (सं० फाल्गुन >प्रा० फग्गुण) । एक मास का नाम जिसकी पूर्णिमा को ‘फल्गुनी' नक्षत्र होता है। पा०म० ५
फाटत : फटत । 'समुझि नहिं फाटत हियो।' विन० १३६.७
फाटहुं : आo-कामना, संभावना-प्रब० । चाहे फट जायें, अच्छा हो फट जायें। ___हिय फाटहुं फूटहुं नयन ।' दो० ४१
फाटी : पूकृ० (सं० स्फटित्वा>प्रा० फट्टिअ>अ० फट्टि) । विदीर्ण हो (कर) ।  'जिमि रबि उएं जाहिं तम फाटी।' मा० ६.६७.१
फाडी : भक०स्त्री० (दे०/फब)। (१) फबी, ठीक बैठ गई । 'रहसी चेरि घात जनु फाबी।' मा० २.१७.२ (२) सुशोभित हुई, पुर गयी। कुमतिहि कसि कुबेषता फाबी ।' मा० २.२५.७
फारहिं : आ०प्रब० (सं० स्फाटयन्ति =पाटयन्ति>प्रा० फाउंति>अ० फाडहिं)। चीड़ डालते हैं । 'धरि गाल फारहिं उर बिदारहिं ।' मा० ६.८१ छं० २
फारि : पूक० (अ० फाडि) । चीड़कर । 'फेकरि फेकरि फेरु फारि फारि पेट खात।' कवि० ६.४६
फारै : फारहिं । 'दस आठ को पाठु कुकाठु ज्यों फारौं।' कवि० ७.१०४
फारो : भकृ००कए । फाड़ डाला, छिन्न कर दिया । 'परमत पनवारो फारो।' विन० १४.३
फिर : फिरि । पुनः । हनु०६
फिर, फिरइ : (सं० स्फिरति>प्रा० फिरइ) आ०प्रए । फिरता-ती है। (१) विचरण करता-ती है। 'देखत फिरइ महीप सब।' मा० १.१३४ (२) यात्रा करता घूमता है। 'रन मद मत्त फिरइ जग धावा।' मा० १.१८२.६ (३) पीछे को मुड़ता-ती है। 'देखन मिस मग बिहग तरु फिरइ बहोरि बहोरि ।' मा० १.२३४ (४) लौट आता-ती है । 'फिरइ त होइ पान अवलंबा।' मा० २.८२.६ (५) भ्रान्त-घूमता रहता है। 'तव माया बस जीव जड़ संतत फिरइ भुलान ।' मा० ७.१०८ ग
फिरउँ : आ० उए० (सं० स्फिरामि>प्रा० फिरामि>अ० फिरउँ)। फिरता हूं। (१) घूमता-भटकता हूं। 'तव माया बस फिरउँ भुलाना ।' मा० ४.२.६ (२) विचरण करता हूं । 'कौतुक देखत फिरउँ बेरागा।' मा० ७.५६.६
656
_______________________________________________
फिरत : वक० (सं० स्फिरत् >प्रा० फिरंत) । (१) घूमता-ते, विचरता-ते । 'फिरत सनेहैं मगन सुख अपनें।' मा० १.२५.८ (२) पलटता-ती-ते । 'काल पाय फिरत दसा दयालु सबही की।' विन० २५६.४
फिरति : वक स्त्री० । फिरती, घूमती, भ्रमण करती। 'गरजनि मिस मानो फिरति दोहाई ।' कृ. ३२
फिरती : फिरति (समयसूचक प्रयोगविशेष)। 'जिय संसय कछु फिरती बारा ।' मा० ४.३०.१
फिरते : क्रियाति०पू०० । यदि..'तो..'घूमते । 'तो कत द्वार द्वार कूकर ज्यों फिरते पेट खलाए ।' विन० १६४.३
फिरन : (१) भक० अव्यय । 'फिरि हैं किधौं फिरन कहिहैं प्रभु ।' गी० २.७०.२ (२) सं० । फिरना, लोटना । 'मिलि न फिरन की बात चलाई।' कृ० २५
फिरब : भकृ००। (१) लोटना। 'बिन सिय राम फिरब भल नाहीं।' मा० २.२८०.२ (२) लोटना (होगा, लौटुंगा) । बेगि फिरब सुन सुमुखि सयानी।' मा० २.६२.१
फिरहि, ही : आ० (१) स्फिरन्ति>प्रा० फिरंति>अ. फिरहि। (२) सं० स्फिरामः>प्रा० फिरामो>अ. फिरहुं-हिन्दी में>फिरहिं)। (१) लोटते हैं, लौटें । 'जौं नहिं फिरहिं धीर दोउ भाई ।' मा० २.८२.१ (२) घूमते-भटकते रहते हैं। 'खोजत आकु फिरहिं पय लागी।' मा० ७.११५.२ (३) हम विचरण कर रहे हैं । 'तुम्ह से खल मृग खोजत फिरहीं।' मा० ३.१६.६
फिरहु : आ०मब० (अ॰) । (१) घूमते-ती-हो। 'बिपिन अकेलि फिरहु केहि हेतू ।' मा० १.५३.८ (२) लोटो, लोट चलते हो। 'फिरहु त सब कर मिटै खभारू ।' मा० २.६७.३
फिरा : भूकृ०० (सं० स्फिरित>प्रा० फिरिअ)। (१) उलट गया। 'फिरा करम् ।' मा० २.२०.४ (२) भटकता-घूमा। 'फिरा श्रमित ब्याकुल भय सोका ।' मा० ३.२.४ (३) लोटा । 'सीतहि राखि गीध पुनि फिरा। मा० ३.२६.१६
फिराए : भूकृ००ब० (सं० स्फेरित>प्रा० फिराविय) । घुमाये । 'बाँधि कटक चहुं पास फिराए।' मा० ५.५२.४
फिरायो : भूक.पु.कए० (सं० स्फेरितः>प्रा. फिराविओ)। घुमाया। पुनि रिसान गहि चरन फिरायो ।' मा० ६.७४.८
फिराव, फिरावइ : (सं० स्फेरयति>प्रा० फिरावइ) आ.प्रए० । घुमाता है। _ 'बालधी फिरावे, बार बार झहरावै।' कवि० ५.१४
फिरावत : बकृ०० (सं० स्फेरयत्>प्रा०फिरावंत)। घुमाता-घुमाते । 'कंप कलाप बर बरहि फिरावत ।' गी० ३.१.२
_______________________________________________
657
फिरावै : आ.प्रब० (सं० स्फेरयन्ति>प्रा० फिरावंति>अ० फिरावहिं)। घुमाते __ हैं। 'बालधी फिरावें ।' कवि० ५.२६
फिरि : पूकृ० (अ.)। (१) घूम कर, मुड़कर । 'फिरि चितवा पाछे प्रभु देखा।'  मा० १.५४.५ (२) पुनः । 'फिरि सुकंठ सोइ कीन्हि कुचाली।' मा० १.२६.६
फिरिअ : आभावा० (सं० स्फिर्यते>प्रा० फिरीअइ)। लौटिए, लौट जाइए। 'फिरिअ महीस दूरि बड़ि आए ।' मा० १.३४०.५ (२) लोट चलिए । 'पुत्रि, फिरिअ, बन बहुत कलेसू ।' मा० २.८२.४ (३) लौट कर आना हो । 'जों एहि मारग फिरिअ बहोरी।' मा० २.११८.२
फिरियो : भक००कए० (सं० स्फेरितव्यम्>प्रा० फिरिअव्वं>अ० फिरिव्वउ)। लोटना, लोट चलना । 'जो फिरिबो न बन प्रभु ।' गी० २.७३.३
फिरिहहिं : आ०म०प्रब० (अ०) घूमेंगे, भटकेंगे। 'फिरिहहिं मृग जिमि जीव दुखारी।' मा० १.४३.८
फिरिहि : आ०भ०प्रए. (प्रा० फिरिहिइ)। पलटेगा-गी। 'फिरिहि दसा बिधि बहरि कि नाहीं।' मा० २.६८.७
फिरिहैं : फिरिहहिं । लौट चलेंगे। 'फिरिहैं किधौं फिरन कहिहैं प्रभु।' गी० २.७०.२
फिरीं : फिरी+ब० । लौटीं । दिन के अंत फिरी द्वरै अनी।' मा० ६.७२.१
फिरी : भूक.स्त्री० । (१) घमी, (व्याप्त होकर) मंडलाई । 'नगर फिरी रघुबीर दोहाई।' मा० ५.११.६ (२) लोटी। 'फिरी प्रानप्रिय प्रेम पुनीता।' मा० २.३२०.१ (३) उलट गयी । तसि मति फिरी अहइ जसि भाबी ।' मा० २.१७.२ (४) भटकती रही । 'बिचारि फिरी उपमा न पबै ।' कवि० १.७
फिरें: फिरने पर, पलट जाने से । 'समउ फिरें रिपु होहिं पिरीतें ।' मा० २.१७.६
फिरे : भूक००० (सं० स्फिरित>प्रा० फिरिय) । घूम पड़े, लौट चले । 'फिरे सकल रामहि उर राखी ।' मा० १.३४०.३
फिरेउँ : आ०-भू.पुं०+उए । (१) मैं लोटा । 'जिअत फिरत फिरेउँ लेइ राम संदेसू ।' मा० २.१५३.३ (२) मैं भटकता रहा । 'सकल भुअन मैं फिरेउँ बिहाला ।' मा० ४.६.१२ ।
फिरेउ : भूक००कए० (सं० स्फिरितः>प्रा० फिरिओ>अ० फिरियउ) । (१) भटका, घूमा। फिरेउ महाबन परेउ भुलाई।' मा० १.१५७.८ (२) लौटा। 'फिरेउ राउ मन सोच अपारा।' मा० १.१७४.७ (३) उलट गया। 'भयउ बाम बिधि फिरेउ सुभाऊ ।' मा० १.२८.२ (४) चक्करदार चला, घूमा। 'चहं दिसि फिरेउ धनुष जिमि नारा।' मा० २.१३३.२
फिरेहु : आ०-भ०+आज्ञादि-+मब० (सं० स्फिरेत>प्रा०फिरेह>अ० फिरेहु)। तुम लोट आना । 'किरहु गएँ दिन चारि ।' मा० २.८१
658
_______________________________________________
फिरै: फिरहिं । घूमते हैं। रहैं फिरै संग एक।' दो० ५३८
फिरै : (१) फिरइ । फिर सकता है। फिरै तिहारेहि फेरें ।' विन० १८७.२ (२) भक० अव्यय । फिरना। 'जनक प्रेमबस फिर न चहहीं।' मा० १.३४०.४
फिरो : फिरयो । मुड़ा हुआ, विमुख । 'जो तोसों होतो फिरो।' विन ० ३३.५
फिरौं : फिरउँ । घूमता हूं। 'बहु बिधि डहकत लोग फिरौं ।' विन० १४१.३
फिर् यो : फिरेउ । भटकता रहा । 'फिरयो ललात बिनु नाम उदर लगि ।' विन० २२७.३
फीक, का : वि०० (सं० फि-फिक >प्रा० फिक्क) । सारहीन, तुच्छ । (१) स्वादहीन । 'सरस होउ अथवा अति फीका।' मा० १.८.११ (२) रङ्गहीन । 'जो न पखारें फीक ।' दो० ४६९
फीकि, की : फीका+स्त्री०। (१) नीरस । 'तिन्हहि कथा सुनि लागिहि फीकी।' मा० १.६.५ (२) उदास, अल्परंग की। परलोक फीकी मति, लोक रंग रई।' विन० २५२.४
फीके : (१) वि.पुब० । नीरस, निस्सार । 'जोरे नये नाते नेह फोकट फीके।' विन० १७६.२ (२) क्रि०वि० । फीकी मनोदशा में । 'जानी है ग्वालि परी फिरि फीके ।' क १०
फीको : फीका+कए । व्यर्थ, तुच्छ, विवर्ण । 'परों जनि फीको ।' विन० २६५.४
फुकरत : वकृ०० (सं० फुकुर्वत्>प्रा० फुकरंत) । फुध्वनि करते, फुकारते । 'फुकरत जनु बहु व्याल ।' मा० ३.२० छं०
फुर : वि०० (सं० स्फुट, स्फुर>प्रा० फुड, फुर)। विकासशील, क्रियाशील = स्पष्ट तथा लोकप्रचारित =सत्य, यथार्थ । 'तो फुर होउ जो कहेउँ सब ।' मा० १.१५
फुर, फुरइ : (१) सं० स्फुरति-स्फुर संघलने>प्रा० फुरइ (२) (सं० स्फुरति -- स्फुर विकासे>प्रा० फुडइ) आ०प्रए । सत्य होता है, प्रकट होता है, चलता है। 'जा सों सब नातो फुरै ।' विन० १६०.५
फुरि : फुर+स्त्री० । सच्ची । 'बात फुरि तोरी।' मा० २.२०.५
फुरे : (१) फुर-ब० । सच्चे, यथार्थ । 'कपिन्ह रिपु माने फुरे ।' मा० ६.६६ छ। (२) भूक००ब० (सं० स्फुरित>प्रा० फुरिय)। फड़के, स्पन्दित हुए । 'भुज __ अरु अधर फुरे ।' गी० १.८६.७
फुर : फुरइ।
फुलवाईं : फुलवाड़ी में । 'करत प्रकासु फिरइ फुलवाई।' मा० १.२३१.२
फुलवाई : सं०स्त्री० (सं० पुष्पवाटी>प्रा० फुल्लवाडी) । पुष्पोद्यान । मा० १.२१५.४ _______________________________________________
659
फुलाई : पूक० । फुला कर । 'बचन कहहिं सब गाल फुलाई।' मा० ६.६.६
फुलाउब : भकृ.पुं० । फुलाना (स्थूल करना) । 'हंसब ठठाइ फुलाउब गाला ।' मा० २.३५.५
फुलाए : भूक००ब० । पुलक-पल्लवित किये । 'हरषित खगपति पंख फुलाए।' .. मा० ७.६३.१
फुलावौं : आ० उए । प्रफुल्लित करूं, हर्षोल्लसित करूं। 'तुलसी भनिति भली भामिनि उर सो पहिराइ फुलावौं।' गी० १.१८.३
फूँक : फंकार या फूत्कार ध्वनि+उससे निकलने वाली सांस । 'मसक फूंक बरु मेरु उड़ाई।' मा० २.२३२.३
फूंकि : पूक० । फूंक मार कर । 'चहत उड़ावन फँकि पहारू ।' मा० १.२७३.२
फूट : भूक०'० (सं० स्फुटित>प्रा० फुट्ट । विचलित हो गया, फूटा । "फूट कपारू ।' मा० २.१६३.५
फूट, फूटइ : (सं० स्फुटति>प्रा० फुट्टइ) आ०प्रए । फूटता है, फूट जाय । __'अंजन कहा आँखि जेहि फूट।' विन. १७४.३
फूटहिं : आ०प्रब० (अ० फुट्टहिं) । फूटते हैं । 'जनु फूटहिं दधि कुंड ।' मा० ६.४४
फूटहुं : आ०-कामना-प्रब० । फट जायँ । 'फूटहुं नयन ।' दो० ४१
फूटि : प्रकृ० (अ० फुट्टि) । फूटकर । 'महावृष्टि चलि फूटि किआरी ।' मा० ४.१५.७
फूटिहि : आ०म०प्रए० (सं० स्फुटिष्यति>प्रा० फुट्टिहिइ)। फूटेगा-गी। 'राज समाज नाक अस फूटिहि ।' जा०म० ६१
फूटीं : भूकृ०स्त्री०ब० । छिन्न-भिन्न हो गयीं। 'रहे न सरीर हड़ावरि फूटौं।' कवि० ६.५१
फूटी : भक०स्त्री० (सं० स्फुटिता>प्रा० फुट्टी)। (१) विदीर्ण, शीर्ण । 'लहइ न फूटी कौडिहू ।' दो० १०८ (२) फूटी आँख । 'लोक रीति फूटी सहहिं आँजी सहइ न कोइ ।' दो० ४२३ ।
फूटे : भूक००ब । मा० ६.२५.६
फटेह : फूटे हुए भी। 'फूटेहु बिलोचन पोर होत ।' विन० २७१.४
फूटै : फूटइ।
फूरति : वकृस्त्री० । स्फुरित होती, स्पन्दित होती। 'पावन-हृदय जेहि उर __फरति ।' कृ० २८
फूल : सं०० (सं० फुल्ल-पुष्प-प्राकृत में 'फुल्ल' ही अति प्रचलित) । मा० १.३७.१४
फूल, फूलइ : (सं० फुल्लति-फुल्ल विकासे>प्रा० फुल्लइ) आ०प्रए। पुष्प सम्पन्न होता है । 'फूलइ फरह न बेत ।' मा० ६.१६ ख
660
_______________________________________________
फूलत : वक०० । (१) पुरुप सम्पन्न होता-होते । 'फलत फलत सु पल्लवत ।' मा० १.२१२ (२) फूलते समय । 'फूलत फलत भयउ बिधि बामा ।' मा० २.५६.४ (३) सूजता, विकारवश स्थूल होता । पेट न फलत बिन कहें।' दो०. ४३७
फूलन : भकृ० अव्यय । पुष्प सम्पन्न होने । 'उकठे बिटप लागे फूलन फरन ।' विन० २५७.२
फूलनि : फूल+संब० । फूलों । 'उर फूलनि के हार हैं ।' कवि० २.१४
फूलहि : आ०प्रब० (सं० फुल्लन्ति>अ० फुल्लहिं) । पुष्प सम्पन्न होते हैं । 'फूलहि फलहिं बिटप बिधि नाना ।' मा० २.१३७.६
फला : (१) फूल । 'सोइ फल सिधि सब साधन फूला।' मा० १.३.५ (२) भूक०० (सं० फुल्ल)। विकसित, पुष्पित । 'मोर मनोरथ सुरतरु फूला।' मा० २.२६.८
फूलि : पूक० (अ० फुल्लि)। पुष्प सम्पन्न होकर । मा० २.३११.७
फूलीं : फूली+ब० । खिल उठी, उल्लसित हुई। निरखत मातु मुदित मन फूली ।' गी० १.३१.५
फूली : (१) भूक०स्त्री० । पुष्प सम्पन्न हुई, विकसित हुई । 'ज्यों कलप-बेलि सकेलि सुकृत सुफूल फूली सुख कली ।' गी० ३.१७.१ (२) फुलि । 'जेहिं दिसि बैठे नारद फूली।' मा० १.१३५.१
फूलें : फूले हुए." से । 'फूलें कास सकल महि छाई।' मा० ४.१६.२
फूले : भूक००ब० । (१) पुष्प सम्पन्न हुए । 'बिविध भाँति फूले तरु नाना।' मा० ३.३८.३ (२) हर्षोत्फुल्ल हुए । 'परमानंद प्रेम सुख फूले ।' मा० १.१६६.५
फूल : फूलहिं । विकास पाते हैं (उन्नत होते हैं) । 'फल फूल फैले खल...।' कवि. ७.१७१
फल : फूलइ । खिले, खिल सकता है । 'हृदय कमल फूल नहीं बिनु रबिकुल रबि राम ।' वैरा०२
फेट : सं०स्त्री० (सं० स्फेट आवरण) । कमरबंद, फेंटा । 'धनी गही ज्यों फेंट ।' दो० २०७
फेकरहिं : आ०प्रब० (सं० फेत्कुर्वन्ति>प्रा० फेक्करंति>अ० फेक्करहिं । फेकरते हैं=फे-फे ध्वनि करते हैं । “फेकरहिं स्वान सियार ।' रा०प्र० ५.६.३
फेरि : पूक० । फे-फे ध्वनि करके । 'फेकरि फेकरि फेरु फारि फारि पेट खात ।' कवि० ६.४६
फेन : सं०० (सं.)। मा० २.६१.१
661

फेनु, नु : फेन+कए । मा० २.२८१.८ 'जलधि अगाध मौलि बह फेनू ।' मा० १.१६७.८
फेर : सं०० (सं० स्फेर) । घुमाव (ओर) । चक्कर । 'नगर रम्य चहुं फेर ।'  मा० ७.२ ..
फेर, फेरइ : (सं० स्फेरयति>प्रा० फेरइ) ०प्रए० । फेरता है, मोड़ देता है । 'साँच सनेह साँच रुचि जो हठि फेरइ ।' पा०म० ५६
फेरत : वकृ०० (सं० स्फेरयत्>प्रा० फेरंत)। (१) घुमाता-ते । 'भुज जुगल फेरत सर ।' मा० ६.७१ छं० (२) घोड़े को चलाते। 'कुसल "हय फेरत ।' गी० १.४५.२-४ (३) लोटालते समय । 'फेरत राम दुहाई देहीं।' मा. २.२५०.४
फेरति : वक०स्त्री० । लोटालती, पीछे को मोड़ती । 'फेरति मनहुं मातु कृत खोरी!' मा० २.२३४.५
फेरन : भकृ० अव्यय । घमाने । 'चाप कर फेरन लगे।' मा० ६.८६ छं०
फेरफार : सं०पू० (सं. स्फेर+स्फारगति विस्तार)। चालबाजी, चालाकी, टालमटूल । 'अनुमानि सिसुकेलि कियो फेर-फार सो।' हनु० ४
फेरहि : आ.प्रब० (अ०) । (१) लोटालते हैं । 'कृपासिंधु फेरहिं तिन्हहि ।' मा २.११२ (२) फेरी दिलाते हैं, चक्कर में चलाते हैं। 'फेरहिं चतुर तुरग गति नाना।' मा० १.२६६.२ (घोड़ा फेरना मुहावरा है)।
फेरा : फेर । 'रोपहु बीथिन्ह पुर पहुं फेरा ।' मा० २.६.६
फेरि : पू० (अ०) । (१) फिराइ । मोड़ कर , लौटाल कर । 'फेरि सुभट लंकेस रिसाना ।' मा० ६.४२.६ (२) भ्रम में डाल कर, उलटकर । 'गई गिरा मति फेरि ।' मा० २.१२ (३) भ्रमण या विचरण करवा कर। 'नगर फेरि ।' पुनि पूंछ प्रजारी ।' मा० ५.२५.७ (४) चक्राकार घुमा कर । 'कूदि धरहिं कपि फेरि चलावहिं ।' मा० ६.४१.८ (५) लौटाल कर (वापस)। तिन्ह तो मन फेरि न पाए।' कवि० २.२४ (६) उलट-पलट कर परख्यो न फेरि खर खोट।' विन० १६१.८ (७) नेवछावर करके । 'सोम काम सत कोटि वारि फेरि डारहीं।' गी० १.६८.१० (८) फिरि=पुनः+लौटाल कर । 'बान संग प्रभु फेरि चलाई।' मा० ६.६१.४
फेरिअ : आकवा०प्रए । लौटाल कर भेज दीजिए। फेरिअ प्रभु मिथिलेस किसोरी।' मा० १.८२.२
फेरिअत, फेरियत : व.पु.कवा० । फेरा जाता-फेरे जाते । मन फेरियत कुतर्क कोटि करि ।' कृ० २७
662
_______________________________________________
फेरिअहिं : आ०प्रब०कवा० (सं० स्फेर्यन्ताम् >प्रा० फेरीअंतु>अ० फेरीअहिं) । लोटाले जायँ । 'फेरिअहिं लखन सीय रघुराई ।' मा० २.२५६.३
फेरिए, ये : फेरिअ । (१) घुमाइए । 'तुलसी की बांह पर लामी लूम फेरिये।' हनु ३४ (२) लोटा लिए । 'घर फेरिए लखन लरिका हैं ।' गी० २.७३.३
फेरीं : फेरी+ब० । धुमवायीं । 'प्रमुदित मुनिन्ह भावरी फेरी ।' मा० १.३२५.७
फेरी : (१) भूकृ०स्त्री० । घुमायी, भ्रान्त कर दी । 'सारद प्रेरि तासु मति फेरी।' मा० १.१७७.८ (२) फेरि । लौटाल कर । 'लखनु रामु सिय आनेहु फेरी।' मा० २.६४.८
फेरु, रू : (१) फेर+कए । चक्कर, जाल, छल । 'सोउ हिये हारि गयउ करि फेरू ।' मा० १.२६२.७ (२) आ०--आज्ञा--मए । तू लौटाल । 'हठि फेरु रामहि ।' मा० २.५० छं० (३) तू भ्रान्त कर। 'मो सन कहह, भरत मति फेरू ।' मा० २.२६५.४ (४) सं०० (सं०) । सियार । 'भजन हीन नर देह बृथा खर स्वान फेह की नाईं।' गी० २.७४.४
फेरें : फेरने से। (१) मोड़ने से। फिरै तिहारेहि फेरें ।' विन० १८७.२ (२) प्रतिकूल या विमुख करने से । 'राबरें बदनु फेरें. सकल निरपने ।' कवि० ७.७८
फेरे : (१) भक.पुब० । लोटा ले । 'नप करि बिनय महाजन फेरे।' मा.. १.३४०.१ (२) प्रतिकूल किये । 'फेरे लोचन राम अब ।' रा०प्र० ७.५.२ (३) फेर+ब० । चक्कर, पेच, लपेट । 'एक गाठि कइ फेरे ।' विन० २२७.४
फेरो: आ०-प्रार्थना--मब० (अ० फेरह) । (१) घुमाओ (सहलाओ)। 'तुलसी के माथे पर हाथ फेरो।' हनु० ३३ (२) प्रतिकूल करो। 'लोचन जनि फेरो।" विन० २७२.१ (३) फेरा+कए । चक्कर, आना-जाना । 'जह सतसंग कथा माधव की, सपनेहुँ करत न फेरो।' विन० १४३.२
फेर् यो : भूक.पु.कए । मोड़ लिया । ' फेर्यो बदन बिधाता।' गी०६.७.२
फैलि : पूक० । विस्तार लेकर । 'फैलि चली बर बीर-बहटीं। कवि० ६.५१
फैलै : आ०प्रब० । फैलते हैं, बढ़ते हैं। 'फैले खल ।' कवि० ७.१७१
फोकट : फोटक । 'सब फोकट साटक है तुलसी ।' कवि० ७.४१
फोटक : वि०+क्रि०वि० (सं० स्फोटक= सूजन)। व्यर्थ, कष्ट कर (उपक्रम) । 'करहिं ते फोटक पचि मरहिं ।' दो० २७४
फोर फोरइ : (सं० स्फोटयति>प्रा० फोडइ) आ०प्रए । फोड़ता है। जो पय फेन फोर पबि टाकी ।' मा० २.२८१.८
फोरहिं : आ०प्रब० (सं० स्फोटयन्ति>प्रा० फोडंति>१० फोडहिं) । फोड़ते हैं । 'फोरहि सिल लोढ़ा सदन ।' दो० ५६० _______________________________________________
663
फोरा : भूक०० (सं० स्फोटित>प्रा. फोडिअ)। फोड़ डाला। 'राखा जिअत  आंखि गहि फोरा ।' मा० ६.३६.१२
फोरि, फोरी : पू० । फोड़कर । 'पर्बत फोरि करहिं गहि बाटा ।' मा० ६.४१.५ ___ 'काचे घट जिमि डारों फोरी।' मा० १.२५३.५
फोरे : भूकृ.पुं० । फोड़ने पर। 'गूलरि को सो फल फोरे।' कृ० ४४
फोरै : भकृ० अव्यय । फोड़ने । 'फोर जोगु कपारु अभागा ।' मा० २.१६.२
फोरों : आउए० (सं० स्फोटयामि, स्फोटयेयम् >प्रा०. फोडमि, फोडम>अ० फोडउँ)। फोड़ता हूं, फोड़ सकता हूं। 'चपेट की चोट चटाक दै फोरौं ।' कवि० ६.१४
फौज : सं०स्त्री० (अरबी-फौज लस्कर, जंगली सिपाही, गिरोह) । सेना, बनचर-सेना, समूह । 'कुंभ-करन कपि फोड विदारी।' मा० ६.६७.७
फौजें : फौज+ब० । सेनाएँ । हनु० ३५
## ब
बँटाई : भूकृ०स्त्री. (सं० वण्टापिता>प्रा. बंटइआ)। विभक्त की (अपने पर ली) । जेहिं बन बिपति बटाई।' गी० ६.६.२
बँटावन : (१) भकृ० अव्यय । बंटाने । 'जिनके बिरह बँटावन खग मग जीव दुखारी।' गी० २.८५.२ (२) वि.पु. । बंटाने वाला। 'बिपति बँटावन बंधु बाहु ।' गी० ६.७.१
बँटैया : वि० । बंटाने वाला। बिपति बैटया ।' कवि० ७.५१
बँधत : व.पु । बँध जाता, जकड़ जाता । 'बँधत बिनहिं पास ।' विन० १६७.२
बँधब : भक०० (सं० बद्धव्य>प्रा० बंधिअव्व) । बांधना, बन्धन । 'कृपा कोपु ____ बधु बँधब गोसाई।' मा० १.२७६.५
बँधाइ : पूकृ० (सं० बन्धयित्त्वा>प्रा० बंधाविष>अ० बंधावि)। (१) बंधवाकर (बांधने देकर)। 'हठि तेल बसन बालधि बँधाइ।' गी० ५.१६.४ (२) बांध (सेतु) से बद्ध करवा कर । 'बारिधि बधाइ उतरे ।' गी० ५.२२.११
बँधाइअ : आ०कवा०प्रए । बँधाया जाय (सेतुबद्ध कराया जाय)। एहि बिधि नाथ पयोधि बंधाइ ।' मा० ५.६०.४
664
_______________________________________________
बँधाए : भूकृ.पु०० । बद्ध कराये (बनवाये)। 'सरितन्हि जनक बँधाए सेतू ।' मा० १.३०४.५
बँधान : बंधान । स्वरयोजना के बन्धन । 'हहिं न ताल बंधान ।' मा० १.३०२
बँधायउ : भक००कए । सेतबद्ध कराया। जेहिं बारीस बंधायउ हेला।' मा० ६.६.५
बँधाया : बंधायउ। जकड़न प्राप्त किया, फंसाया । 'लोभ पास जेहिं गर न बँधाया।' मा० ४.२१.५
बँधायो : बँधायउ। (१) बद्ध कराया, पाशित कराया। 'रन सोभा लखि प्रभुहिं बंधायो।' मा० ६.७३.१३ (२) सेतुबद्ध कराया । 'कौतुकहीं पायोधि बंधायो।' मा० ६.६.२
बँधावा : बंधाया। 'प्रभ कारज लगि कपिहि बंधावा ।' मा० ५.२०.४
बँधे : भूकृ००बहु० । बद्ध हुए, बन्धन में पड़े। 'जनु सनेह रज बंधे बराती।' मा० १.३३२.५
बँधेउ : भकृ००कए । बंध गया । 'बंधेउ सनेह बिदेह ।' जा०म० ४१
बँधैहैं : आ०म०प्रब० । बंधाएँगे (सेतुबद्ध करायेंगे। कोतक ही पाथोधि बंधे हैं।' ___गी० ५.५१.२
बँध्यो : बँधेउ । जकड़ गया । 'बध्यो कीट मरकट की नाई।' मा० ७.११७.३
बंक (बंका) : वि.पु. (सं० वक्र>प्रा० वंक) । (१) तिर्यक्+सुन्दर । 'रुचिर बंक भौंहैं।' गी० ७.४.३ (२) चक्करदार, व्यूढ । 'केहि बिधि दहेउ दुर्ग अति बंका ।' मा० ५.३३.५ (३) बांका, विषम । 'रन बांकुरा बालिसुत बंका।' मा० ६.१८.२
बंगा : वि० (सं० व्यङ्ग, वङ्ग>प्रा० वंग) । लंगड़ा, अङ्गविकल, दोषयुक्त, खोटा। ___'राम मनुज सुनुरे सठ बंगा।' मा० ६.२६.५
बंचक : वि० (सं० वञ्चक)। धूर्त, ठग । मा० १.७५
बंचित : वि० (सं० वञ्चित)। प्रतारित, छला हुआ, अभीष्ट वस्तु की उपलब्धि से रहित । मा० २.१६५
बंचेहु : आ०-भूक ००+मब० । तुमने ठगा, छला; अभीष्ट की प्राप्ति से - वञ्चित किया । 'बंचेह मोहि जवनि धरि देहा ।' मा० १.१३७.६
बंजुल : सं०० (सं० वजुल) । (१) बेत (२) पुष्प वृक्ष विशेष । (३) अशोक वृक्ष । 'बंजुल मंजु बकुल कुल सुरतरु ।' गी० २.४७.४
बंद, बंबई : (सं० वन्दते>प्रा. वंदइ) आ०ए० । प्रणाम करता है, नत होता है। 'टेढ़ जानि सब बंदइ काहू ।' मा० १.२८१.६
बंदउँ: आ. उए० (सं० वन्दे>प्रा. वंदामि>अ० वंदउँ)। प्रणाम करता हूं। 'बंदउँ गुरु पद ।' मा० १.१.१
665
बंवत : व.पु । प्रणाम करता-करते । जे बंदत अज ईस ।' मा० ४.२५
बंदन : (१) सं०० (सं० वन्दन) । प्रणाम । 'अनुज सहित प्रभु बंदन कीन्हा।' मा० ६.११२.२ (२) भक० अव्यय । प्रणाम करने । 'लगे जनक मुनि जन पद बंदन ।' मा० २.२७५.१ (३) वि० । वन्दनीय, प्रणम्य । “उठह रघुनन्दन जग बंदन ।' गी० १.८६.११ (४) सं०प० । सेंदुर, रोली। 'बंदन बंदि ग्रंथि बिधि करि ध्र व देखेउ ।' पा.मं० १३२
बंदनवार : सं०स्त्री० (सं० वन्दनमाला) । द्वार पर लगायी जाने वाली फूलों या पत्तों की लड़ी। मा० ७.६.२ (इसके पुलिङ्ग प्रयोग भी चलते हैं)।
बंदनिवारे : बंदनवार-+ब० । वन्दन मालाएँ । 'मंजुल मनिमय बंदनवारे ।' मा० १.३४७.३
बंदनीय : वि० (सं० वन्दनीय) । प्रणम्य । मा० १.२.६
बंदनु : बंदन+कए । प्रणाम । 'जाइ संभ पद बंदन कीन्हा ।' मा० १.६०.४
बंदर : बानर । मा० ५.५४.६
बंदि : (१) पू० (सं० वन्दित्वा>प्रा. वंदिअ>अ० वंदि)। प्रणाम करके। 'बंदि कहउँ कर जोरि ।' मा० १.१४ छं० (२) संस्त्री० (सं० वन्दि)। बन्धन । 'दसरत्य को नंदन बंदि कटैया ।' कवि० ७.५१ (३) (सं. वन्दिन्) बद्ध, बंधुआ, कैदी। 'सुत सुरपतिहि बंदि करि ल्यायो ।' गी० ६.३.२ (४) कारागृह । 'रावन की बंदि लागे अमर मरन ।' विन० २४८.३ (५) चारण । दे. बंदिगना ।
बंदिअ : आ०कवा०प्रए० (सं० वन्द्यते>प्रा. वंदीअइ)। प्रणाम किया जाता है। 'बंदिअ मलय प्रसंग ।' मा० १.१० क
बंदिगन : (सं० वन्दिगण) चारण लोग, स्तुति पाठक । 'मागध सूत बंदिगन गायक।' मा० १.१६४.६
बंदिगृह : कारागृह (दे० बंदि) । मा० १.१६
बंदिछोर : (दे० बंदि तथा छोर) बन्धन मक्त करने वाला, पाश काटने वाला (छुर छेदे)। विन० ३५.६
बंदित : बंदित । मा० १.१४६.१
बंदिता : बंदित+स्त्री० (सं० वन्दिता)। प्रणाम की हुई । 'उमा रमा ब्रह्मादि बंदिता।' मा० ७.२४.६
बंदिनी : वि०स्त्री० (सं० वन्दनीया)। प्रणम्या । 'बाम अंग बामा बर बिस्व बंदिनी।' गी० २.४३.१
बंदिन्ह : बंदी+संब० । बंदियों चारणों (ने)। 'बंदिन्ह बांकुरे बिरद बए।' गी० १.३.४
बंदिय : बंदिअ।
666
_______________________________________________

बंदी : (१) बंदि (कारावासी अर्थ में फारसी का भी शब्द है) । (२) (सं. वन्दिन्) । चारण, स्तुति-पाठक । 'बंदी बिरिदावलि उच्चरहीं।' मा० १.२६५.४
बंदीखाना : (दे० बंदि) (सं० वन्दिगृह= फा० बन्दीखानः) । कारागृह । मा० ६.६०.४
बंदीछोर : बंदिछोर । हनु० ६, १३, १५
बंदोजन : बंदिगन । मा० १.३०६.५
बंदे : बंदित (प्रा० बंदिय) । प्रणाम किये। 'पुनि पुनि पारबती पद बंदे।' मा० १.६६.१
बंदौं : बंदउँ । 'अंदी राम लखन बैदेही ।' विन० ३६.५
बंध : सं०० (सं.)। (१) बन्धन, पाश । 'सो कि बंध तर आवइ ।' मा० ६.७३ (२) मायापाश, संसारबन्धन या कर्मबन्धन । 'बंध मोच्छ प्रद ।' मा० ३.१५ (३) गूंथ । 'तेहि के रचि पचि बंध बनाए।' मा० १.२८८.३
बंधन : बंध (सं.)। (१) गंथ ! प्रथन । ‘सन इव खल पर बंधन करई।' मा० ७.१२१.१७ (२) संसार, कर्मभोग । 'कवन सकइ भव बंधन छोरी।' मा० १.२००.३ (३) जाल, पाश । 'बंधन काटि गयउ उरगादा।' मा० ७५८.५-६ (४) बँधने की क्रिया। कपि बंधन सुनि निसिचर धाए ।' मा० ५.२०.५ (५) स्नायुमण्डल । 'हांक सुनत दसकंध के भए बंधन ढीले ।' विन० ३२.३
बंधान : बंधन । स्वरयोजना । 'उघटहिं छंद प्रबंध गीत पद राग तान बंधान ।' गी० १.२.१५
बंधाना : बंधान । बांधने की क्रिया (सेतुबन्ध) । 'अवन सुनेउ बारिधि बंधाना।' मा० ६.५.१०
बंधु : सं०+वि० (सं०) । (१) भाई । मा० १.४० (२) अत्यन्त आत्मीय जन (दे० बंधो)।
बंधुक : संपु० (सं०) । रक्तवर्ण पुष्पविशेष जो मध्याह्न में खिलने से दोपहरिया' कहा जाता है-दोने जैसा छोटा पौधा होता है । 'बंधुक सुमन अरुन पद पंकज ।' गी० १.२६.२
बंधुजन : सगे सम्बन्धी, भाई चारे के लोग। विन० २४३.२
बंधो : बंधु+ सम्बोधन (सं.)। हे अत्यन्त स्वजन । 'दीन-दयाकर आरत-बंधो।' मा० ७.१८.१
बंध्या : वि०स्त्री० (सं०) । प्रसव-रहित स्त्री=बाँझ । मा० ७.१२२.१५
बंब : बम्-बम् ध्वनि । 'कूदत कबंध के कदंब बंब सी करत ।' कवि० ६.४८
बंस : सं०० (सं० वंश) । (१) कुल । 'बंस प्रसंसक बिरिद सुनावहिं ।' मा० १.३१६.६ (२) बाँस (वेणु)। 'उपजेहु बंस अनल कुल घालक ।' मा० ६.२१.५ _______________________________________________
667
बंसाटबी : (बंस+मटबी-सं० वंशाटवी) बांस का वन । विन० ५२.७
बंसी : (१) बनसी। मछली फंसने का काँटा । 'जन बंसी खेलहिं चित दये।' मा० ६.८८.५ (२) (समासान्त में) वि.पु.। वंश में उत्पन्न, वंश वाला । रघुबंसी आदि । (३) सं०स्त्री० (सं० वंशी) । बाँसुरी (सुषिर वाद्यविशेष) ।
बई : (१) भूकृ०स्त्री० । बोयो । 'बई बनाइ बारि बृदाबन ।' कृ० २६ (२) बोयी हुई (फसल) । 'लुनियत बई।' विन० २५२.३
बएँ : क्रि०वि० । बोने से । 'ऊसर बीज बएँ फल जथा।' मा० ५.५८.४
बए: भूकृ०प० (सं० उप्त>प्रा० बविय)। बोये, बोये हुए । 'बए न जामहिं धान ।' मा० ७.१००.७ (२) बिखराये, फैलाये, प्रचारित-प्रसारित किये । 'बंदिन्ह बांकुरे बिरद बए।' गी० १.३.४ ।
बक : सं०० (सं०) । बगुला पक्षी । मा० १.६.२ (२) कंस राजा का सहायक. बकासुर । 'बकी बक भगिनी काहू ते कहा डरेगी।' हनु० २५
बकउ : बगुला भी, बगुले भी । 'काक होहिं पिक, बकउ मराला ।' मा० १.३.१
बकता : वि०पू० (सं० वक्ता)। कहने वाला, प्रवचनकर्ता। 'श्रोता बकता ग्यान निधि ।' भा० १.३० ख
बकध्यान : मिथ्या ध्यान, दम्भ । 'इहाँ आइ बक ध्यान लगावा ।' मा० ६.८५.७
बकराजि : (सं०) =बगपांति । गी० ७.१६.२
बकसत : वक०० (फा० बख्शूदन् =क्षमा करना 1(२) बख्शीदन् -देना)। (१) क्षमा करता-ते । (२) दान करता-ते । 'प्रभु बकसत गज बाजि बसन मनि।' गी० १.४५.५
बकसीस : सं०स्त्री० (फा० बख्शाइश) । दान, कृपा, पुरस्कार । कृपापूर्वक दान या पुरस्कार । 'भ बकसीस जाचकन्हि दीन्हा ।' मा० १.३०६.३
बकहिं : आ०प्रब० (सं० वल्कयन्ति-वल्क शब्दे>प्रा० वक्कति>म० वहि) । बकते हैं, बकवास करते हैं । 'भृगुपति बकहिं कुठार उठाएँ ।' मा० १.२८१.४ बकती हैं, बकवास करती हैं। 'ठाली ग्वालि उरहने के मिस आइ बकहिं बेकाहिं ।' कृ० ५
बकहि : आ०मए० (सं० वल्कयस्व>प्रा० ववकहि) । तू बकवास कर । 'तुलसिदास जनि बकहि मधुप सठ।' कृ० ५१
बकिहि : बकी बगुली को । 'बकिहि सराहइ जानि मराली।' मा० २.२०.४
बकी : (१) सं०स्त्री० (सं.)। बगुली। (२) असुर स्त्रीविशेष, बकासुर की बहन पूतना राक्षसी । हनु० २५
बकुचौहीं : वि०स्त्री० । बकुचे के समान वस्त्रादि की बड़ी गठरी जैसवंवंी। 'राखी सचि कुबरी पीठ पर ये बातें बकुचौहीं।' कृ० ४१
668
_______________________________________________
बकुल : संपु० (सं.)। (१) मौलसिरी वृक्ष । मा० १.३४४.७ (२) पुष्पमञ्जरी -बीर।
बक्यो : भूकृपु०कए० (सं० बल्कितम>प्रा० वक्कि>१० वक्किय उ)। बकवास __ करता रहा। 'बक्यो आउ बाउ मैं ।' विन० २६१.२
बक्र : (१) वि० (सं० वक्र) । टेढ़ा, टेढ़ी। 'बक चंद्रमहि प्रसइ न राहू।' मा० १.२८१.६ चलइ जोंक जल बक्रगति ।' मा० २.४२ (२) कथन से विपरीत अर्थ का-की। 'बक्र उक्ति धन बचन सर।' मा० ६.२३ ङ (३) प्रतिकूल आचरण वाला । 'श्रीमद बक्र न कीन्ह केहि ।' मा० ७.७० ख
बक्रउक्ति : संस्त्री० (सं० वक्रोक्ति) । एक कथन शैली (अलंकार) जिसमें उल्टा अर्थ निकलता है-ऐसी उक्ति जिसमें काकु या श्लेष हो और अन्य अर्थ किया जा सके । मा० ६.२३ ङ
बखान : सं०० (सं० व्याख्यान>प्रा. वक्खाण) । गुणविवेचन, स्तुतिवर्णन । 'नर कर करसि बखान ।' मा० ६.२५ 'बखान
बखाइ, ई : बखान+प्रए । बखान करता है, व्याख्यापूर्वक समझाता कहता है; गुण वर्णन करता है। 'कोन बेद बखानई ।' विन० १३५२
बखानउँ : बखान-+उए । बखानता हूं, वर्णन करता हूं। 'अस तब रूप बखानउँ जानउँ ।' मा० ३.१३.३
बखानत : वक०० । वर्णन करता-करते। 'न बन बखानत ।' जा०म० १३
बखानहि, हीं : आ०प्रब० । बखानते हैं =विवृत करते हैं, व्याख्यापूर्वक समझाते हैं । 'बेद पुरान बसिष्ट बखानहिं ।' मा० ७.२६.२
बखानह : आ०मब० । बखानो, व्याख्या कर समझाओ। 'तिन्ह कर सहज सुभाव बखानहु ।' मा० ७.१२१.५
बखाना : (१) बखान । 'कतहुं राम गुन करहिं बखाना।' मा० १.७६.१ (२) बखानइ। 'तुम्ह त्रिभुवन गुर बेद बखाना।' मा० १.१११.५ (३) भूकृ.पु० । वर्णन किया, व्याख्या करके समझाया । 'राम जासु जस आपु बखाना।' मा० १.१७.१०
बखानि : (१) पूकृ० । वर्णन कर। 'दसा न जाइ बखानि ।' मा० २.११० (२) आo--आज्ञा-मए । तू बखान कर। 'नवल नंदकुमार के ब्रज सगुन सुजस बखानि ।' कृ० ५२
बखानिय : (१) बखानि । 'गोरी नैहर केहि बिधि कहह बखानिय ।' पा०म० ८८ (२) आ०कवा०प्र० । बखाना जाता है। 'देस सुहावन पावन बेद बखानिय ।' जा०म०४
बखानिये : बखानिय । बखाना जाता है । कवि० ७.१६८ _______________________________________________
669
बखानिहैं : आ०प्रब०भ० । बखानेंगे, वर्णन करेंगे। 'लोक पावन सुजसु सुर मुनि नारदादि बखानि हैं ।' मा० ४.३० छं०
बखानीं : बखानी+ब० । वणित की। 'अपर कथा सब भूप बखानी।' मा० १.२६५.२
बखानी : (१) बखानि । 'स्याम गौर किमि कहीं बखानी।' मा० १.२२६.२ (२) भूक०स्त्री० । वणित की। 'अति लोभी सन बिरति बखानी ।' मा० ५.५८.३
बखानें : बखान करने से । 'अघ कि रहहिं हरि चरित बखाने ।' मा० ७.११२.६
बखाने : भूक००ब० । व्याख्यापूर्वक स्पष्ट किये। 'तेहि में कछु गुन दोष बखाने।' मा० १.६.२
बखानै : बखानइ । बखान सकता है । 'मूक कि स्वाद बखान ।' आ०म० ८७
बखानो : बखानहु । 'तो सकोच परिहरि पा सागौं परमारथहि बखानो ।' कृ० ३५
बखान्यो : भूक ०पू०कए । वर्णन किया। 'बेद पुरान बखान्यो।' विन० ८८.३
बखार : संपु० (सं० उपस्कार >प्रा० वखार-संग्रह) । कोठा, जिसमें अन्न भरा जाता है । 'बिबिध बिधान धान बरत बखार हीं।' कवि० ५.२३
बग : बक । बगुला । मा० १.४१
बगध्यानी : वि०० (सं० वकध्यानिन्) । बगुले के समान छल-ध्यान करने वाला; (जिस प्रकार मछली पकड़ने हेतु बक-पक्षी ध्यान मुद्रा ग्रहण करता है, उसी प्रकार) पूजा, भक्ति, तप आदि का प्रदर्शन कर छलने वाला। 'तब बोला तापस बगध्यानी।' मा० १.१६२.६
बगपाँति : बगुलों की श्रेणी । गी० ७.१८.३
बगमेल : वि०+क्रि०वि० (सं० वर्ग मेल>प्रा० वग्ग मेल) । झण्ड के झुण्ड मेला बनाये हुए । 'कछुक चले बगमेल ।' मा० १.३०५
बगरि : पू० (सं० विकीर्य>प्रा० विगरिअ>अ० विगरि)। फैल कर, बिखर कर । 'जाको जस लोक बेद रह्यो है बगरि सो।' विन० २६४.४
बगरे : भक००० (सं० विकीर्ण>प्रा० विगरिय) । बिखरे, फैले । “परनिंदक जे जग मो बगरे ।' मा० ७.१०२.५
बघनहा : सं०० (सं० व्याघ्रनख>प्रा० वग्घनह) । बाघ का नाखून या उस आकार का आभूषण जो बच्चों को पहनाया जाता है। ‘कठुला कंठ बघनहा नीके ।' गी० १.३१.३
बघाजुड़ानी : संस्त्री० । (१) व्याघ्र या चीते को शीतल उपचारों से वश में करने की क्रिया । (२) बघा=एरण्ड वक्ष के नीचे शीतल होने (विश्राम) की क्रिया । 'जरी सुंघाइ कबरी कौतुक करि जोगी बघाजुड़ानी।' क० ४७ (अर्थात् कबरी योगिनी ने ऐसी जड़ी सुपाई कि कृष्ण जैसे पुरुषव्याघ्र को वश में कर योगी बना लिया। इससे कष्ण को कब्जा-रति रूपी एरण्ड की छाया में विश्राम जैसा सुख मिला।)
बघारिबे : भक०० (सं० व्याघारयितव्य>प्रा. वाघारिअव्वय)। (१) बघारना =छौंक लगाना ! (२) दीप्त करना । 'जगुति धूम बघारिबे की समझिहैं न गारि ।' कृ० ५३ (धम बधारना=बातों का बवंडर बनाकर युक्ति रूपी छौंक __ लगाते हुए जानकारी का प्रकाश देना ।)
बधूरें : बघूरे में, बवंडर में । 'चढ़े बघूरे चंग ज्यों।' दो० ५१३ ('वात-घूर्ण' से 'बघूरा' की व्युत्पत्ति है जो वात्या चक्र या चक्रवात का अर्थ देता है।)
बच : सं०० (सं० वचस्) । वचन, उक्ति । मा० ७.२२.८
बचउँ : आ० उए० (सं० विचामि>प्रा. वच्चामि>अ० वच्चउँ)। बहाने से ___टालता हूं, उपेक्षा करता हूं। 'बिप्र बिचारि बचउँ नृप द्रोही ।' मा० १.२७६.६
बचन : सं०० (सं० वचन)। उक्ति, कथन । मा० १.४.११
बचनन्हि : बचन+संब० । वचनों । गी० १.२२.६
बचनहि : वचन के । 'तजे राम जेहिं बचनहि लागी ।' मा० २.१७४.४
बचना : बचन । मा० १.७७.५ ।
बचनामत : वचन रूपी अमत, अमत-तल्य वचन, अमरत्व का संदेश देने वाला उक्ति । मा० ७.८८.२
बचनु : बचन+कए० । 'प्रभु बिधि बचनु कीन्ह चह साचा ।' मा० १.४६.१
बचा : सं०पू० (फा० बच्च:--सं० अपत्य>प्रा. अवच्च)। बालक, पुत्र । 'जग  में बलसालि है बालि-बचा।' कवि० ६.१५
बचाइ : पू० (सं० वाचयित्वा) । पढ़वा कर । 'यह पाती-नाथ बचाइ जुड़ावहु छाती।' मा० ५.५६.६
बचावन : भक० अव्यय (सं० वाचयितुम् । पढ़वाने । 'सचिव बोलि सठ लाग बचावन ।' मा० ५.५६.१०
बचावा : भूक०० (सं० व्याचित>प्रा० वच्चाविअ)। बचाया=रक्षित किया। ___'करि छल सुअर सरीर बचावा ।' मा० १.१५७.३
बचे : भूक०० (ब) (सं० व्यचित) । शेष रहे, रक्षित रह सके, छोड़े गये । नप बचे न काल बली ते ।' विन० १६८.२
बचें : आ०प्रब० (सं० विचन्ति>प्रा० वच्चंति>अ० वच्चहिं)। बच जाते हैं (रक्षित रह जाते हैं), अपने को बचा लेते हैं। 'भरदर बरसत कोस सत बचें जे बंद बराइ ।' दो० ४०२
बच्छ : सं०० (सं० वत्स>प्रा०वच्छ)। (१) गाय का बछड़ा । 'बाल बच्छ जिमि धेनु लवाई।' मा० १.३३७.८ (२) दुलारा बालक । 'बहुरि बच्छ कहि लालु कहि ।' मा० २.६८
