_______________________________________________
1071
सीपर : सं०० (सं० सीप) । ढाल (बचाव) । 'लागति सांगि बिभीषन ही पर सीपर आपु भए हैं।' गी० ६.५.४
सीपि, सीपी : सीप । सुत्ती । 'सरसी सीपि कि सिंध समाई।' मा० २.२५७.४
सीम, सीमा : सं०स्त्री० (सं० सीमन्, सीमा) । मर्यादा, अवधि, छोर । ‘जद्यपि रामु सीम समता की।' मा० २.२८६.६ ।
सीयँ : सीता ने । 'लखीं सीये सब प्रेम पिआसी।' मा० २.११८.३
सीय, सीया : (अ.)। सीता । मा० २.४६
सीया : सीता (प्रा० सीया) । मा० २.६६.७
सीरे : सियरे । शीतल । गी० १.८७.३
सील, सीला : (१) सं०० (सं० शील) । प्रकृति, सहज स्वभाव, आचरण, नैतिक भाव, संकोची स्वभाव (जिससे दूसरे के कष्ट में अपने को कष्ट अनुभव होता है । मा० १.७६.५ (२) संकोच, लिहाज, दूसरे के प्रति सम्मान का भाव । 'उतर देत छोड़उँ बिन मारें। केवल कोसिक सील तुम्हारें।' मा० १.२७५.७ (३) (समासान्त में) वि० । शील वाला, शीलयुक्त । 'जामवंत मारुति नयसीला ।' मा० ६.१०६.२ (४) सिला । प्रस्तर, चट्टान (अहल्या)। 'कोन कियो समाधान सनमान सीला को।' विन० १८०.४
सीलता : (समासान्त में) संस्त्री० (सं० शीलता) । शीलसम्पन्नता। रिषि मम  महत-सीलता देखी।' मा० ७.११३.४
सीलनिधान : शील की सानि; उत्तम-शील-सम्पन्न । मा० १.२६ क
सीलनिधि : (१) सील निधान । 'साहिब समरथ सीलनिधि ।' रा०प्र० २.४.४ (२) (सं० शील निधि)। एक राजा का नाम जो नारद-मोह-प्रसंग में आया है। मा० १.१३०.२
सीलु : सील+कए । अद्वितीय शील । 'राम रूपु गुन सीलु सुभाऊ ।' मा० २.१.८
सीवँ : सीम (अ०) । मा० १.२३३.१
सीव : सिव । परमेश्वर, परमशिव तत्त्व । 'माया प्रेरक सीव ।' मा० ३.१५
सीवां : सीमा (अ.)। मा० १.२४३.८
सीस : सं.पुं० (सं० शीर्ष>प्रा० सीस) । सिर, मस्तक । मा० १.६३.५
सीसताज : सं०स्त्री० [सं० शीर्ष+फा० ताज)। सिर की टोपी, शीर्षावरण । 'मानो खेलवार खोली सीसताज बाज की।' कवि० ६.३०
सीसदस : दससीस । रावण । विन० २०४.३
सीसनि, न, न्ह : सीस+संब० । सिरों (का, पर, से आदि)। 'ता ते सुर सीसन्ह चढ़त ।' मा० ७.३७ 'जटा मुकुट सीसनि सुभग ।' मा० २.११५
सीसा : सीस । मा० १.१८.६
1072
_______________________________________________
सीसावली : सं०स्त्री० (सं. शीर्षावली>प्रा. सीसावली)। सिरों की श्रेणी, शिरः समूह । विन० १८.४
सीसु, सीसू : सीस+कए । सिर । मा० १.३३१; २१७६
सुँघाइ : पूर्व० सं० शिवयित्वा>प्रा० सुघाविअ>अ. सुघावि) । सुधाकर, घ्राणग्राह्य बनाकर । 'जरी सुंघाइ कबरी कौतुक करि जोगी बधाजुड़ानी।" कृ०४७
सु : (१) अव्यय (सं.)। उत्तम । इसके बहुत से एसे प्रयोग मिलते हैं जिनमें कुछ भी अतिशय जुड़ता नहीं, या जुड़ता है तो यही कि वस्तु उत्तम है (ऐसे बहुत से शब्दों का पथक् अर्थ नहीं किया जा रहा है) । जैसे-सुआसन, सुआयसु । मा० २.२८५ सुआश्रम । मा० १.६५.८; सुअंजलि । मा० १.१६१.७, सुकोमल । मा० ११४ घ; सुजतन । मा० ७.१२०.१०, सुदानी। मा० २.२०४.८% सुदास । मा० १.१६; सुपल्लवत । मा० १.२१२; सुपुनीत । मा० ७.१२७; सुपुनीता। मा० ७.१२५.८; सुपुनीत । मा० ७.१२७; सुपुनीता । मा० ७.१२५.८; सुप्रेम । मा० १.२२; सुबास । मा० २.६०; सुबेलि । मा० २.२४४.६ ; सुबंधु । मा० २.७२; सुमनोहर । मा० ३.२७.३; सुमंगल । मा० ७.३; सुमंगलचार । मा० २.२३ ; सुसेवक । मा० २.१४३ आदि इनके (स' को निकालकर भी लगभग वही अर्थ आका है; केवल उत्तम और अतिशय जोड़ना ही महत्त्व का है। (२) सो वह । 'कहहु स प्रेम प्रगट को करई ।' मा० २२४१.३ 'दीपक काजर सिर धर्यो, धर्यो सु धर्यो धोइ।' दो० १०६
सुंदर : वि० (सं०-सु+उन्दोक्लेदने+अर)। अतिशय उत्तम द्रवीभाव लाने वाला, मन को पिघलाने वाला=मनोहर । मा० १.३४
सुंदरतर : अतिशय सुन्दर । गी० ७.७.३
सुंदरताँ : सुन्दरता से । निज सुंदरतां रति को मदु नाए।' कवि० ७.४५
सुंदरता : संस्त्री० (सं.)। मनोज्ञता, हृद्यता-हृदय को द्रव बनाने वाली छटा । मा० ७.३३.३
सुंदरताई : सुदरता । मा० १.१३२.१
सुंदरायतना : वि०पू० (सं० सुन्दरायतन)। उत्तम विस्तार वाला, उत्तम भवनों वाला (दीर्घता के अनुपात में चौड़ाई की मनोहरता से युक्त प्रासादों वाला) । मा० ५.३ छं० १
सुंदरि : (१) सुदरी : “गारी मधुर स्वर देहि सुदरि ।' मा० १.६६ छं० (२) सौंदरी+संबोधन (सं०) । हे सुन्दरी ! मा० २.६१.७ .
सुंदरीं : सुदरी+ब० । सुन्दरियाँ । मा० १.३२२ छं०
सुंदरी : (१) सं०स्त्री० (सं.)। प्रमदा, मनोज्ञ युवती। 'निसि सुदरी केर सिंगारा ।' मा० ६.१२.३ (२) वधू, स्त्री । 'सुर-सुदरी।' मा० १.६१.४
_______________________________________________
1073
सुअ : सुत (प्रा.) । 'कैकेई सम ।' मा० २.१७८
सुअंग : उत्तम अङ्ग (दे० सु) । मा० १.३१८ छं०
सुअंजन : उत्कृष्ट अजन, सिद्ध किया हुआ या अभिमन्त्रित अञ्जन । मा० १.१
सुअंसुक : (म० अंशुक = वस्त्र)। उत्तम परिधान । गी० ७.२१.२१
सुअन : सुवन । पुत्र । मा० २.४३.६
सुअर : सूकर (प्रा० सूअर) । मा० १.६३ छं०
सुअवसर : उत्तम अवसर, उपयुक्त समय । मा० ६.११४ क
सुअवसरु : सुअवसर+कए । 'दासी देखि सुअवसरु आई ।' मा० २.२८१.२
सुअसनु : (दे० असन) कए । उत्तम भोजन । मा० २.१११.६
सुआ : सुक (प्रा० सुअ) । तोता।
सुआउ : (दे० आउ) उत्तम आय, दीर्घायुष्य । विन० १८२.२
सुआर, सुआरा : सं०० (सं० सूपकार>प्रा० सूमार)। पाचक, भोजन बनाने का व्यवसायी । मा० १.३८८; ६६.८
सुआसन : उत्तम सुखद आसन। मा० १.३२१.४
सुआसनु : सुआसन+कए० । मा० २.२५७.६
सुआसिनि, सुआसिनी : सं०स्त्री० (सं० सुवासिनी)। (१) सौभाग्यवती स्त्री (सुहागिन = उत्तम परिधान-सम्पन्न सधवा सुन्दरी)। (२) पिता के घर में रहने वाली विवाहिता अथवा कुमारी कन्या । मा० १.३१३.४
सुआसिनिन्ह, सुआसिनिन्हि : सुआसिनी+संब० । सुवासिनियों (ने, को आदि)। मा० १.३२७ छं० २; गी० १.६६.२
सुक : (१) सं०० (सं० शुक) । तोता पक्षी। मा० ७.२८.७ (२) भागवत पुराण के वक्ता मुनिविशेष । मा० ७.१२३.५ (३) रावण का एक गुप्तचर । मा० ५.५७.३
सुकंठ : सं० । सुग्रीव (वानरराज)। मा० १.२५.७
सुकंठ : सुकंठ+कए । कवि० ७.१
सुकबि : उत्तम कवि, रससिद्ध कवि । मा० १.१०.३
सुकर : (१) वि० (सं०) । सरलता से करने योग्य । 'सुकर दुष्कर दुराराध्य दुर्व सनहर ।' विन० ५४.७ (२) सं०० (सं० स्वकर) । अपना हाथ । (३) उत्तम हाथ । 'बारिधार धीर धरि सुकर सुधारिहै ।' कवि० ७.१४२
सुकरमा : उत्तम शुभ कर्म, पुण्य कर्म (शुभ, अशुभ तथा मिश्र कर्मों में केवल शुभ कर्म) । मा० १.२.११
सुकर्कश : वि० (सं.)। अत्यन्त परुष । मा० ३.११.६
सुकर्म : (दे० सफरमा) । कवि० ७.११६
1074
_______________________________________________
सुकल : (१) वि० (सं० शुक्ल>प्रा० सुक्किल)। श्वेत । (२) मास का पखवारा-प्रतिपदा से पूर्णिमा तक । मा० १.१६१.१ ।।
सुकाज : (दे० काज) । अपना कार्य+उत्तम कार्य । दो० १८४
सुकालु : (दे० काल) । सुभिक्षकाल; अतिवृष्टि-अनावृष्टि आदि से रहित सम्पन्न समय । मा० २.२३५
सुकिय : सुकृत (सं० कृत>प्रा० किय) । पुण्य । 'गर्य निघटि फल सकल सुकिय के ।' गी० ४.१.३
सुकीरति : (१) सुकीर्ति । उत्तम कीर्ति; कीर्तनीय सद्गुण । (२) उत्तम कीर्ति वाला; सुयशसम्पन्न । 'राम सुकीरति भनिति भदेसा। मा० १.१४.१०
सुकीर्ति : संस्त्री० (सं०) । सुयश (यशस्वी) । कवि० ७.१०
सुकु : सुक+कए । रावण का गुप्तचर विशेष । कवि० ६.८
सुकुमार : वि.पुं० (सं.) । (१) अति कोमल, मृदुल । 'अति सुकुमार न तनु तप ___ जोगू ।' मा० १.७४.२ (२) तरुण, सुन्दर, किशोर ।
सुकुमारा : सुकुमार । मा० १.२०३.४
सुकुमारि : सूकुमारी। मा० २.८१
सुकुमारीं : सुकुमारी ने । 'मूदे नयन सहमि सुकुमारी।' मा० २.२४६.४
सुकुमारी : सुकुमार+स्त्री० (सं०) । मृदुल (किशोरी) । मा० २.२८.८
सुकुल : (१) सुकल । (२) उत्तम कुल । 'दियो सुकुल जनम ।' विन० १३५.१
सुकूप : उत्तम कूप । मा० २.३०६
सुकृत : (१) सं०० (सं०) । सत्कर्म, पुण्य, धर्म । 'तुम्ह सम सुअन सुकृत जेहिं दीन्हे ।' मा० २.४३.६ (२) वि० । उत्तम कृत्य (कृत) वाला। सुकृती, पुण्यात्मा। 'भए सुकृत सुख सालि ।' दो० १२ ।
सुकृतग्य : (सं० सुकृतज्ञ) (१) उत्तम कृतज्ञ । (२) सकत (धर्म) का ज्ञाता। 'सुकृतग्य जे सकुचत सकृत प्रनाम किए हूं।' विन० १७०.५
सुकृतसंकट : धर्म संकट (करने से धर्म हानि और न करने से अर्थ-हानि की दुबिधा)। गी० ५.२७.१
सुकृति : सुकृती । 'सुकृति संभु तन बिमल बिभूती।' मा० १.१.३
सकृती : सुकृती ने । 'केहि सुकती केहि घरी बसाए।' मा० २.११३.२
सुकृती : वि. (सं० सुकृतिन्) । पुण्यात्मा । 'केहि सुकती सन होइहि साथू।' मा० २.५८.३
सुकृतु : सुकृत+कए । धर्म, सुकर्म । 'सुकतु सृजस परलोकु नसाऊ ।' मा० २.७६.४
सुकृपाँ : श्रेष्ठ कृपा से । 'राम सकपां बिलोकहिं जेही ।' मा० १.३६.५
सुकृपा : श्रेष्ठ अतिशय कृपा । मा० ५.१४.६
1075
सुकेतुसुता : सुकेतु की पुत्री = ताड़का । मा० १.२४.४
सुकोमल : (१) अत्यन्त कोमल । (२) कोमल शब्दाथं योजना वाला (काव्य)। मा० १.१४ घ
सुक्र : सं०० (सं० शुक्र) । (१) दैत्याचार्य (का नाम) । 'नाम धरमरुचि सुक्र समाना ।' मा० १.१५४.१ (२) वीर्य । 'दच्छ सुक्र संभव यह देही ।' मा० १.६४.६
सुख : सं०० (सं०) । अनुकूल संवेद्य चतन्य गुण (दुःख का विलोम) । मा० १.९
सुखंजन : उत्तम खजन पक्षी। कवि० १.१
सुखकंद, सुखकंदा : सुख (आनन्द) के मूल कारण । मा० १.१०५; ३.१२.१३
सुखकारी : वि०० (सं० सुखकारिन्) । सुखप्रद, सुखजनक । मा० ७.२३.८
सुखद : वि० (सं०) । सुखदायक । मा० १.३५.१३
सुखदाई : वि.पु. (सं० सुखदायिन्) । सुखदाता, सुख देने के शील वाला । मा० ७.३७.१
सुखदातहि : सुखदाता को। मा०७.३०.६
सुखदाता : सुखद । मा० ७.३०.६
सुखदायक : सुखद । मा० १.१८.१०
सुखदायनी : वि० स्त्री० (सं० सुख-दायिनी) । सुखा देने के शील वाली, सुखादात्री। मा० ५.३४.१
सुखदारा : (दे० दारा) । सुखादाता । 'जाग जग मंगल सुखदारा।' मा० २.६४.२
सुखदैन : सुखदाई । 'निज भगतनि सुखदैन ।' गी० १.८६.११
सुखदैनी : सुखदायनी । 'मूरति सब सुखदैनी ।' गी० १.८१.२
सुखन, सुखनि : सुख+संब० । सुखों । 'सुखनि समेत ।' गी० ७.२१.२१
सुखप्रद : सुखद (सं०) । मा० १.७३.२
सुखमय : वि० (सं०) । सुखपूर्ण । मा० ७.४६.५
सुखमा : सुषमा । गी० १.६.१५
सुखमूल, सुखमूला : सुखा (आनन्द) का मूल कारण । मा० १.१६०; ३.१६.४
सुखरूप : आनन्दस्वरूप, सच्चिदानन्द रूप । मा० ७.५१.६
सुखसालि, सुखसाली : वि० (सं० सुख शालिन) । सुख सम्पन्न । दो० १२
सुखसील, सुखसीला : वि० (सं० सुखशील)। आनन्दरूप प्रकृति वाला; सुसाधार+ सुखपूर्ण । मा० १.११०.८
सुखस्वरूप : सुखारूप । मा० २.२००
सुखाई : पूकृ० । सूखा (कर); मुरझा (कर) । 'जेहिं बिलोक सोइ जाइ सुखाई।' मा० ६.१८.१०
सुखाकर : सुखों का आकर, आनन्दखानि । मा० ३.४.११
1076
सुखात : सूखत । सूखा जाते, मुझर्शाते; शुष्कमुख हो जाते । 'सहमि सुखात बातजात की सरति करि।' कवि०६.६
सुखाति : सुखात+ब० । सूखते । सालि सफल सुखाति ।' विन० २२१.४
सुखानी : भूक०स्त्री० । सूखा गयी, मुरझायी । 'कहि न सकइ कछु सहमि सुखानी।" मा० २.२०.१
सुखाने : सूख जाने पर । 'का बरषा सब कषी सखाने ।' मा० १.२६१.३
सुखनेउ : सूखे हुए भी । 'पुनि परिहरे सुखाने उ परना।' मा० १.७४.७
सुखानो : भक०कए० । सूखा हुआ (नीरस) । 'लखि गयंद ले चलत भजि स्वान सुखानो हाड़।' दो० ३८०
सुखाय : आ०प्रए० (सं० शुष्कायते>प्रा० सुक्खाइ) । सूखाता है । 'सुखाय अति  काय काय ।' कवि० ६.४३
सुखारीं : सुखारी+ब० । 'महतारी.. होहिं सुखारों ।' मा० २.१७५.६
सुखारी : (१) वि० (सं० सुख कारिन्>प्रा० सुक्खारी)।सुखजनक : 'कहिहउँ देिस सुखारी।' मा० २.१४६.२ (२)  सुख-भोगी, सुखी। मा० ७.११७.५ इसके स्त्री०पू० दोनों प्रयोग चलते हैं।
सुखारे : सु खारी (ब०) । सुखी । 'सब भए सुमारे।' मा० ६.४.७
सुखासन : (सं०) (१) सुखद आसन (२) सुखाद आसनयुक्त । 'कहेउ बनावन पाल की सजन सुखासन जान ।' मा० २.१८६
सुखाहिं, सुखाहीं : आ०प्रब० । (१) शुष्क हो रहे हैं । 'मुख सुखाहिं लोचन स्रवहिं ।'  मा० २.४६ (२) सूखा जाते हैं । मा० ५.२३.६
सुखी : वि० (सं० सुखिन्) । सुखायुक्त । मा० १.३५.८
सुखु : सुख+कए । 'सुख सोहागु तुम्ह कहुं दिन दूना । मा० २.२१.४
सुखेत : (दे० खोत)। उत्तम माङ्गलिक क्षेत्र (भू-भाग)। मा० १.३०३.३
सुखेतु : सुखेत+कए। उपजाक उत्तम खोत । 'जा को नाम लेत ही सुखोतु होत ऊसरो।' कवि० ७.१६
सुखेन : (सं०) सुखा से, सुखपूर्वक । 'जाहु सुखोन बनहि ।' मा० २.५७.४
सुखेलनिहारे : अच्छे खिलाड़ी। गी० १.४६.१
सुगंध : (१) सं०० (सं०) । उत्तम गन्ध, सौरभ । 'नव समन माल सगंध लोभे मंजु गुजत मधुकारा ।' गी० ७.१६.३ (२) इत्र, पुष्पादि का सुगन्धित स्नेह । 'संतत रहहिं सुगंध सिंचाई।' मा० १.२१३.४ (३) वि० (सं० सुगन्धि)। उत्तम गन्धयुक्त, सुगन्धित । 'सुमन सुगन्ध ।' रा०प्र० ४.६.४
सुगंधन : सुगंध+संब। सुगन्धों, इत्रों (से)। केसरि परम लगाइ सुगंधन बोरा. हो ।' रा०न०६
1077
सुगढ़ : सुधर (सं० सुघट>प्रा० सुघड़-सगढ़) । सुदेश, व्यवस्थित योजना से सम्पन्न-सन्दर । 'सगढ़ पुष्ट उन्नत कृकाटिका।' गी० ७.१७.१० ।
सुगति : सं०स्त्री. (सं.)। सद्गति, उत्तम फल की प्राप्ति, मोक्ष आदि पुरुषार्थ  की उपलब्धि । मा० २.७२.७
सुगम : वि. (सं.)। (१) पहुंचने या प्राप्त होने में सरल । मा० ७.७३ (२) सुबोध, सरलता से बाध्य । 'उभय अगम, जुग सुगम नाम तें।' मा० १.२३.५
सुगमु : सुगम+कए । मा० २.७८.५
सुगाइ : आ०प्रए । दोषी होने का सन्देह करता है या करे । 'तुम्हहि सुगाई मातु कुटिलाई।' मा० २.१८४.६
सगाढ़ि : वि०स्त्री०। अत्यन्त गाढ़ी=सदढ तथा मोटी । 'बाती कर सुगाढ़ि ।' मा० ७.११७ ग
सुगान : उत्तम गीत । पा०म०ई० १२
सुगुन : उत्तम गुण, सद्गुण । दो० २३१
सुगुरु : सतगुरु । वि० ७७.२
सुगेह : ऊत्तम अनुकूल सुखयुक्त आवास । दो० २४
सुग्रंथ : सदग्रंथ । दो० ५५६
सुग्रीवँ : सुग्रीव ने । 'तब सुग्रीवं बोलाए।' मा० ४.२२
सुग्रीव : सं०पु० (सं.) । वाली का अनुज जिसे राम ने वानर राज बनाया था। मा० ४.४.२
सुग्रीवहि : सुग्रीव को। 'तृन समान सुग्रीवहि जानी ।' मा० ४.८.१ .
सुग्रीवहुं : सुग्रीव ने भी । 'सुग्रीवहुं सुधि मोरि बिसारी।' मा० ४.१८.४
सुग्रीवा : सुग्रीव । मा० ४.१.२ ।।
सुघट : वि० (सं०) । सुकर, जो सरलता से किया जा सके। 'अघटित घटन, सुघट बिघटन ।' विन० ३०.२ (यहाँ 'सुघट' से 'सुपरित' का तात्पर्य विशेष है)।
सुघटित : वि० (सं.) । उत्तम रीति गढ़ा-बनाया हुआ, सुनिर्मित । 'धवल धाम मनि पुरट पट सुघटित नाना भाँति ।' मा० १.२१३
सुघर : (१) वि०पु० (सं० सुघट>प्रा• सुघड) । सुदेश, समञ्जस, यथायोग्य अङ्गरचना वाला । मा० १.३१४.६ (२) उत्तम घर । गी० ७.१६.४
सुघरनि : सुघर+संब । उत्तम घरों में । गी० ७.१६.४
सुघरि : सुघर+स्त्री० । सुन्दरी, सुव्यवस्थित अङ्गों वाली, कमनीय स्त्री । 'बतिया के सुघरि मलिनिया ।' रा०न
1078
_______________________________________________
सुघरी : (दे० घरी) । उत्तम घड़ी, शुभ मुहूर्त । 'सुदिन सुधरी तात कव होइहि ।' मा० २.६८.८
सुघाय : सं०० (सं० सुघाय>प्रा० सुघात)। सहनीय प्रहार । 'पलक पानि पर. ____ ओड़िअत समुझि कुघाय सुधाय ।' दो० ३२५
सुचंदन : उत्तम जाति का (सुगन्धित) चन्दन । मा० १.२१६.४
सुचारु : अति मनोहर तथा अतिशय पावन । मा० १.१६६.६
सुचाल : उत्तम चल, सदाचरण । विन० २६०.४
सुचालि, सुचाली : (१) सुचाल । (२) वि० । उत्तम चाल वाला-सदाचारी। 'मातु. ____मंदि मैं साधु सुचाली।' मा० २.२६१.३
सुचि : वि० (सं० शुचि) । उज्ज्वल, दीप्त, पवित्र । मा० १.१०४
सुचितित : वि० (सं०) । भली भाँति अभ्यस्त तथा सविवेचित । 'सास्त्र सुचितित पुनि पुनि देखिअ ।' मा० ३.३७.८
सुचित : उत्तम चित्त, निर्मल एकाग्र मन । 'सनि अवलोकि सुचित चख चाही।' मा० १.२६.३
सुचितई : सं०स्त्री० (सं० सुचित्तता)। निर्मलचित्तता, एकाग्रता । गी० १.६६.३
सुचिता : सं०स्त्री० (सं० शुचिता) । पावनता, स्वच्छता, चारुता। मा० १.३२४ छं० २
सुचिमंत : वि.पु. (सं० शुचिमत्) । पवित्रता से युक्त, शौचयुक्त, निष्कलुष । कवि० ७.३४
सुछंद : वि० (सं० स्वच्छन्द)। स्वतन्त्र, यथेच्छचारी । मा० २.१३४
सुजन : (१) सज्जन । मा० ७.२.४ (२) (सं० स्वजन) आत्मीय जन 'करि पितु मातु सुजन सेवकाई।' मा० २.१५२.५
सुजनन, सुजननि : सुजन+संब० । सज्जनों (ने, को)। गी० १.१०.४ 'राम पद सुजननि सुलभ करत को।' गी० ६.१२.३ ।।
सुजनी : (सं०) उत्तम स्त्री, सजनी, सखी । कृ० २५
सुजव : उत्तम जी (अंगूठे की सुन्दर यवाकार रेखा) । गी० ७.१७.८
सुजस : सं०० (सं० सुयशस् >प्रा० सुजस)। सत्कीर्ति । मा० ३.६ क
सुजसु : सुजस+कए । मा० ६.५.८
सुजाति, सुजाती : सं०-+-वि० (सं० सुजाति) । (१) उत्तम जाति । (२) उत्तम जाति वाला । 'विप्र बिबेकी बेदबिद संमत साधु सुजाति ।' मा० २.१४४ (३) कुलीन + सुन्दर । 'मनिगन पुर नर नारि सुजाती।' मा० २.१.४ (सं० 'सुजात' सुन्दर-पर्याय है)।
सुजान : वि० (सं० सुज्ञ, सुज्ञान>प्रा० सुजाण)। उत्तम, ज्ञानयुक्त, विवेकी, बुद्धिमान् । मा० ७.५६; १.११.८ पाo
_______________________________________________
1079
सुजानि : सुजान (सं० सुज्ञानिन् >प्रा० सुजाणि) । 'सर्वान सोहात है सेवा-सुजानि ___टाहली ।' कवि० ७.२३
सुजानु, सुजानू : सुजान+कए । मा० २.३१४.३, १७२.५
सुजीवन : (१) स्वजीवन (२) उत्तम जीवन । 'प्रानहु के प्रान से सुजीवन के जीवन से ।' गी० २.२६.४
सुजीवनु : सुजीवन+कए० उत्तम जीवन । मा० १.६.६ ।।
सुजोग : (दे० जोग) (१) उत्तम ग्रह-मेलापक । (२) औषधियों का उत्तम मिश्रण (३) उत्तम आधार (पात्र) आदि का सम्पर्क (४) उत्तम भूमि आदि का प्रभाव (५) सिलाई, रंग, काटछाँट आदि का उत्तम संबन्ध । “ग्रह भेषज जल पवन पट पाइ कुजोग सुजोग । होहि कुबस्तु सुबस्तु जग ।' मा० १.७ क
सुजोधन : सं०पु० (सं० सुयोधन) । महाभारत में धतराष्ट्र का ज्येष्ठ पुत्र दुर्योधन । कृ० ६१
सुजोर : वि० (सं० सुजोड) । (१) उत्तम जोड़ों (बन्धनों) वाला; (२) सुदृढ । 'बिद्रुम खंभ सुजोर ।' गी० ७.१६.३
सुझाउ : आ०-प्रार्थना-मए० । तू सुझा दे, दिखा दे। 'असुझ सुझाउ सो।' विन० १८२.५
सुझाए, सुझाये : भूकृ०० । दिखाये (से); शुद्ध किये (जाने पर)। 'तेरे ही सुझाये सूझ ।' विन० १८२.५
सुटुकि : पू० । सटक कर, चाबुक लगाकर । चपरि चलेउ हय सुटुकि नृप हाँकि न होइ निबाहु ।' मा० १.१५६
सुठान : सं० +वि० (सं० सुस्थान>प्रा० सुठाण)। (१) उत्तम स्थिति; (२) युद्ध में व्यूह-बद्ध (मोर्चे की) स्थिति; (३) उस स्थिति में ठहरा हुआ। 'भौंह कमान संधान सुठान जे नारि बिलोकनि बान ते बांचे ।' कवि० ७.११८ (यहाँ मोर्चे में लक्ष्य पर सुस्थिर से भी तात्पर्य है)।
सुठारी : वि०स्त्री० । उचित अङ्गव्यवस्था वाली; सुडौल । रान० १५
सुठि : क्रि०वि० अव्यय (सं० सुष्ठ>प्रा० सुदृ.) । भली प्रकार; और भी अधिक ; ____ अत्यन्त । 'सबहि सोहाइ मोहि सुठि नीका ।' मा० २.१८.७
सुठौरहि : (दे० ठौर) उत्तम स्थान पर; अपने स्थान पर (जहाँ के तहाँ हो)। ___ 'बिसोक ल हैं सुरलोक सुठौरहि ।' कवि० ७.२६
सुडीठि : (दे० डीठि) उत्तम अनुकूल दृष्टि । दो० ७५
सुढंग : क्रि०वि० । उत्तम ढंग से; श्रेष्ठ रीति में । 'नटत सुदेस सुढंग ।' गी० १.२.१४
सुढर : (१) सं०+वि.पु । अनुकूल ढलाव; अनुकुलता। (२) अनुकूल ढलने वाला=अपने अनुकूल । 'बिधि के सुढर सुदाय के ।' गी० १.६७.४ (नियति की अनुकूलता में दांव की अनुकूलता)।
सुढार : वि० । ऊँचे-नीचे क्रम से ढाला हुआ या ढाली हुआ; उत्तम रीति से ढाल कर बनाया हुआ-बनायी हुई । 'महि गच कांच सुढार ।' गी० ७.१६.३
सुत : सं०पू० (सं०) । पुत्र । मा० १.८२
सुतंत्र : वि० (सं० स्वतन्त्र)। (१) स्वाधीन । 'राखेसि कोउ न सुतंत्र ।' मा० १.१८२ क (२) स्वर, स्वच्छन्द, मनचाही गति लेने वाला-वाली; निर्मर्याद । 'जिमि सुतंत्र भएँ बिगरहिं नारी।' मा० ४.१५.७ (३) निरपेक्ष ; जिसे अपने से बाहर का कुछ भी लेना न हो; स्वयंसिद्ध+ स्वयंसाध्य ; फलस्वरूप । 'भक्ति सुतंत्र सकल सुख खानी।' मा० ७.४५.५
सुतघाती : (दे० घाती) । पुत्र का बध करने वाला । मा० ६.८३.२
सुतन : उत्तम तन ; स्वस्थ शरीर । दो० ५६८
सुतनि, सुतन्ह : सुत+संब० । पुत्रों। 'सुतनि सहित दसरथहि देखिहौं ।' गी० १.४८.२ ____ 'आवत सुतन्ह समेत ।' मा० १.३०७
सुतबधुन : सुतबधू+संब० । पुत्रवधुओं । 'सुत सुतबधुन समेत ।' रा०प्र० ४.७६
सतबधू : सं०स्त्री० (सं० सुतवधू) । पुत्रवधू, पतोहू । मा० २.२८३.१
सुतबहु : सुतबधू (सं० वधू>वहू) । 'गे जनवास राउ संग सुत सुतबहु ।' जा०म० १५८
सुतमाल : (दे० तमाल) उत्तम सदृढ़ तमाल वृक्ष । गी० १.६६.४
सुतरु : उत्तम- शुभ-माङ्गलिक वृक्ष । मा० १.३०३.७
सुतहार : सं०पु० (स० सूत्रधार>प्रा० सुत्तहार)। (१) नाट्य-निर्देशक । (२) बढ़ई (जो लकड़े नापने और चीरने के निमित्त सूत्र रखता है)। 'कनक रतनमय पालनो रच्यो मनहुं मार सुतहार ।' गी० १.२२.१
सुतहि : (१) पुत्र को । 'बरबस राज सुतहि तब दीन्हा ।' मा० १.१४३.१ (२) पुत्र का । 'अपर सुतहि अरिमर्दन नामा।' मा० १.१५३.६
सुता : सं० स्त्री० (सं०) । पुत्री। मा० १.६६
सुताति : वि०स्त्री० (सं० सु-तप्ता>प्रा० सु-तत्ती) । अतिशय उष्ण; अति दाहक । 'रघुबर कीरति सज्जननि सीतल, खलनि सुताति 'दो० १६४
सुतापस : उत्तम निश्छल तपस्वी। मा० ७.१२४.६
सुतिय : (दे० तिय) उत्तम स्त्री; सती सुन्दर स्त्री। मा० १.२०.६
सुतीछन : सं.पु. (सं० सुतीक्ष्ण) । मुनिविशेष । मा० ३.१०.१
सुतीछी : वि०स्त्री० (सं० सुतीक्ष्णा) । अत्यन्त तीखी, तीव्र प्रभाव वाली, हृदय द्रावक । 'नगर व्यापि गइ बात सुतीछी ।' मा० २.४६.६
सुतीय : सुतिय । मा० २.१६६
_______________________________________________
1081
सुतीरथ : उत्तम तीर्थ । मा० २.६.१
सुतु : सुत+कए । एकमात्र पुत्र । 'सोइ सुतु बड़भागी।' मा० २..४१.७
सुथर : सुथल ।
सुथरु : सुथर+कए । अद्वितीय अनन्य उत्तम स्थल । 'जिन्ह के हिये सुथरु राम प्रेम सुरतरु ।' विन० २५१.११
सुथल : (दे० थल) उत्तम स्थल । (१) योग्य स्थान (तीर्थ आदि)। 'कहउँ सुथल सतिभाउ ।' मा० २.२६१ (२) सुपात्र, योग्य एवम् अधिकारी पुरुष । 'बिद्या बिस्वामित्र सब सुथल समरपित कीन्हि ।' रा०प्र० ४.६.३ (३) उत्तम भूमि ।' 'भरेउ सुमानस सुथल थिराना ।' मा० १.३६.६
सुथिर : (दे० थिर) अत्यन्त स्थिर, अचञ्चल, एकाग्र, दृढनिश्चयो । 'नाम सों प्रतीति प्रोति हृदय सुथिर थपत ।' विन० १३०.५
सुदल : उत्तप पत्र (पत्ती) । गी० १.१६.३
सुदरसन : (दे० दरसन) । (१) शुभ दर्शन । (२) विष्णुचक्र। (३) सं०स्त्री० (सं० सुदर्शना) । उत्तम सुन्दर स्त्री। दो० ४६०
सुदरसनपानि : (सं० सुदर्शनपाणि) चक्रपाणि =विष्णु । गी० ६.६.५
सुदसा : संस्त्री० (सं० सुदशा)। (१) उत्तम अवस्था; (२) अनुकूल परिस्थिति; (३) शुभग्रह की दशा (ज्योतिष में) । 'तेहि अवसर तिहु लोक की सुदसा जनु जागी ।' गी० १.६.१३
सुदाउ : (दे० दाउ) । अपने पक्ष में (खेल का) दांव । 'बाल दसाहूं न खेल्यो खेलत सुदाउ मैं ।' विन० २६१.२
सुदाता : उत्तम दानी; अभीष्ट वस्तु देने वाला । विन० १७७.५
सुदान : उत्तम दान ; प्रार्थी को अभीष्ट देना । हनु० ११
सुदानि, सुदानी : उच्च कोटि का दानी, अत्यन्त उदार । दो० ३००; मा० २.२०४.८
सुदाम, सुदामा : सं०पू० (सं० श्रीदामन्) । कृष्ण के सखा एक ग्वाल । (२) (सं. सुदामन्) कृष्ण के सहपाठी सखा एक ब्राह्मण । विन० १६३.३
सुदामिनि : सं०स्त्री० (सं० सौदामिनी, सौदामनी)। विद्युत् । 'बसन सुदामिनि माल ।' रा०प्र० ५.७.३
सुदाय : (दे० दाय) । पाँसे आदि खोल का अनुकूल (अपने पक्ष में) दांव । 'बिधि के सढर होत सुढर सुदाय के।' गी० १.६७.४
सुदसि : अनन्य भक्त सेवक, दास भक्त । १.१६
सुदि : अव्यय (सं.)। शुक्ल पक्ष । 'जय संबत फागुन सुदि पांचे गुरु दिनु ।' पा०म०५
सुदिन : उत्तम दिन । (१) अनुकूल दिवस । 'सुदिन सुधरी तात कब होइहि ।'मा० २.६८.८ (२) शुभ मुहूर्त । 'सुदिन साधि नृप चलेउ बजाई ।' मा० १.१५४.५
सुदिनु : सुदिन+कए । मा० २.१५.२
सदोठि : सुडीठि । दो० ११०
सुदुर्लभ : अत्यन्त दुर्लभ । मा० ३.४ छं०
सुदुस्त्यज : वि० (सं०) । जो बड़ी कठिनता से त्यागा जा सके । विन० ५०.५
सुदृढ़ : अत्यन्त दृढ । मा० ६.४.१
सुदेस : सं०+वि० (सं० सुदेश)। (१) उत्तम देश, श्रेष्ठ भू-भाग । 'जाइ सुराज सुदेस सुखारी।' मा० २.२३५.४ (२) समञ्जस, सुघर । 'सोभा सकल सुदेस ।' मा० १.२१६ (३) उचित एवं यथास्थान स्थित । 'भूषन सकल सुदेस सुहाए।' मा० १.२४८.३
सुदेसे : सुदेस+ब० । संगत, उचित । 'कहि परमारथ बचन सदेसे ।' मा० २.१६६.८
सुदेह : उत्तम तथा उपयोगी शरीर । कवि० ७.८८
सुद्ध : बि० (सं० शद्ध) । (१) पवित्र, अमिश्रित, मल रहित, निष्कलुष । पद पंकज सेवत सुद्ध हिए।' मा० ७.१४.१५ (२) अशौच या सूतक से निवृत्त । मा० २.२४८.३-४
सुद्धता : सं०स्त्री० (सं० शुद्धता) । निर्मलता, पवित्रता, शुचिता। विन० १०६.४
सुद्धि : संस्त्री० (सं० शुद्धि) । शोधन, पवित्रीकरण, शुद्धता । विन० ८२.४
सुधन : पर्याप्त उत्तम धन । विन० १८२.२
सुधरत : वकृ०पू० । शुद्ध होता-होते, ठीक होते । बिगरी जनम अनेक की सुधरत पल लगै न आधु ।' विन० १९३.२
सुधरति : वकृ.स्त्री० । शुद्ध (ठीक हो जाती। बिगरीओ सुधरति बात ।' कवि० ७.७५
सुधरम : (१) सं०० (सं० सुधर्म) । सद्धर्म । मा० २.३१६.७ (२) वि०पू० (सं० सुधर्मन्) । धर्मात्मा । 'सुघर सुधरम सुसील सुजाना।' मा० १.३१४.६
सुधरमु : सुधरम+कए । मा० २.२८६
सुधरहिं : आ०प्रब० । शुद्ध (ठीक) हो जाते हैं, निष्कलुष (सीधे) हो जाते हैं ।  'सठ सुधरहिं सतसंगति पाई ।' मा० १.३.६
सुधरी : भूकृ०स्त्री० । शुद्ध (ठीक) हो गयी। 'बिगरी सुधरी कबि कोकिलहू की।' कवि० ७.८६
सुधरै : आ०प्रए० । शुद्ध हो (सँभल) सकता-ती है । 'सुधरै सुधारे भूतनाथ ही के ।' कवि ७.१६८ 'सुधरै सबै न सानी ।' कृ. ४६
1083
सुधरैगी : आ०भ०स्त्री०ए० । संभल जायगी। 'सुधरेगी बिगरियो।' विन० २५६.३
सुधर्म : सद्धर्म, परम पुरुषार्थ तक पहुंचाने वाला धर्म । रा०प्र० १.१.४
सुधाँ : सुधा से, में। ‘सील सनेह सुर्धा जनु सानी।' मा० २.६०.८
सुधा : सं०स्त्री० (सं०) । अमृत । मा० १.५.६
सुधाइहु : (दे० सुधाई) सीधेपन भी। 'कतहुं सुधाइह तें बड़ दोष ।' मा० १.२८१.५
सुधाइँ : सीधेपन से । कवि० ७.१३०
सुधाई : सं०स्त्री० (सं० शुद्धता)। निश्छलता, सरलता, भोलापन, सीधापन । मा० १.१६४.३
सुधाकर : संपु० (सं०) । अमृत का आकर+अमृतमय किरणों वाला=चन्द्रमा । मा० १.५.८
सुधाकरु : सुधाकर+कए । विन० २५५.४
सुधादि : अमृत इत्यादि । मा० २.१२०.१
सुधामु : (दे० धाम) (१) (सं० सुधाम) उत्तम धाम, उत्तम लोक । (२) (सं. स्वधाम) अपना लोक । ‘लिए बारक नाम सुधाम दियो ।' कवि० ७.७
सुधार : सं०पू० (सं० शुद्धकार>प्रा० सुद्धार) । शुद्ध (ठीक) करने की क्रिया ।  'बुधि न बिचार न बिगार न सुधार सुधि ।' गी० २.३२.३
सुधारत : वकृ.पु । सुधारता-सुधारते, सँभालने, ठीक करते । मा० ६.११.६
सुधारा : भूकृ.पु. । ठीक किया, संभाला; भली प्रकार साधा । 'सुनि कटु वचन कुठारु सुधारा।' मा० १.२७६.५
सुधारि : पूकृ० । (१) संभालकर । 'चले सुधारि सरासन बाना।' मा० ६.७०.५ (२) शुद्ध (निर्मल) करके । 'निज मन मुकुरु सुधारि ।' मा० २ दोहा ।
सुधारिए : आ०कवा०प्रए । शुद्ध (ठीक) कीजिए । 'सुधारिए आगिलो काज ।' गी० १.८४.८
सुधारिबी : भकृ०स्त्री० । सुधारनी (चाहिए)। 'समय संभारि सुधारिबी ।' विन० २७८.३
सुधारिबे : भकृ०० शुद्ध करने, ठीक करने । 'बिगरी सुधारि को दूसरो दयालु को।' कवि० ७.१७
सुधारिये : सुधारिए । 'अब मेरियो सुधारिये।' विन० २७१.२
सुधारिहि : आ०भ०प्रए । शुद्ध करेगा, सुधारेगा, सार संभाल कर लेगा। 'मोरि सुधारिहि सो सब भाँती।' मा० १.२८.३
सुधारिहै : सुधारिहि । कवि० ७.१४२
1084

सुधारी : (१) भूकृस्त्री० । शुद्ध कर दी। ‘राम कृपा अवरेब सुधारी ।' मा० २.३१७.३ (२) सधारि । 'सजन समति सनि लेह सधारी ।' मा० १.३६.२
सुधारे : भूकृ००० । ठीक किये, सँभाले । 'उठि रघुबीर सुधारे बाना ।' मा० ६.८६.७
सुधासार : अमृत-सार, अमृत का निचोड़ । किवि० ५.२
सुधि : संस्त्री० । (१) स्मृति, ध्यान, चिन्तन, स्मरण । 'सो सुधि राम कीन्हि नहिं सपनें ।' मा० १.२६.२ (२) समाचार (खबर) । 'खेलत रहे तहाँ सुधि पाई।' मा० १.२६०.७
सुधिबुधि : स्मृति तथा बुद्धि (होशोहवास); चेतना; बिवेक । 'उमा नेह बस विकल देह सुधि-बुधि गइ ।' पा०म० २६
सुधी : वि० (सं.)। उत्तम बद्धि (धी) वाला=विद्वान् । विन० २५५.४
सुधीर : वि० (सं०)। (१) उत्तम बुद्धि वाला, (२) अत्यन्त धैर्यशाली । 'बीर सुधीर धुरंधर देवा ।' मा० २.१५०.४ (यहाँ उत्तम धैर्य का भी तात्पर्य आता है-दे० धीर । धैर्य धुरन्धर का भाव भी है)।
सुधेनु : उत्तम धेनु । गी० १.१५.१
सुन : सुनइ । 'जो मन लाइ न सुन हरिलीलहि ।' मा० ७.१२८.३ /
सुन, सुनइ, ई : आ०प्रए० (सं० शृणोति >प्रा० सुणह)। सुनता-ती है। 'एक न सुनइ एक नहिं देखा।' मा० ७.६६.६
सुनउँ, सुनऊँ : आ० उए । सुन, सुनता हूं। 'समुझउँ सुनउँ गुनउ नहिं भावा ।' मा० ७.११०.५; ७.११२.११
सुनख : सुन्दर नख । गी० ७.१७.८
सुनखतु : (दे० नखत) कए । उत्तम नक्षत्र (जो शुभ मुहूर्त में उपयुक्त हो) । मा. मा० १.६१.४
सुनत : वकृ००। (१) सुनता, सुनते । (२) सुनते हुए । 'सुनत समझत कहत हम सब भई अति अप्रबीन ।' कृ० ३५ (३) सुनने से, में । 'सुनत मधुर परिनाम हित ।' मा० २.५० (४) सुनते ही (क्षण) । 'कहत सुनत एक हर अबिबेका।' मा० १.१५.२
सुनति : वकृ०स्त्री० । श्रवण करती । गी० २.४.३
सुनतिउँ : क्रियाति०स्त्री०ए० । मैं सुनती। 'जौं तुम्ह मिलतेहु प्रथम मुनीसा । सुनति सिख तुम्हारि धरि सीसा ।' मा० १.८१.१
सुनतेउँ : क्रियाति पु० उए ० । मैं सुनता । सुनतेउँ किमि हरि कथा सुहाई ।' मा० ७.६६.५
सुनब : भक०० । सुनना (होगा)। 'देखब सुनव बहुत अब आगे।' मा. २.१८०.२
_______________________________________________
1085
सुनयना : सं०स्त्री० (सं.) । सीरध्वज जनक की पत्नी सीता की माता । मा० १.३२४.४
सुनयनीं : (१) वि०स्त्री०ब०। सुलोचनियाँ, उत्तम नेत्रों वाली स्त्रियाँ । मा० १.२८६.२ (२) संबोधन ब० । हे सुलोचनियो । 'एहि बिआह बड़ लाह सुनायनी ।' मा० १.३१०.७
सुनहिं, सुनहीं : आ०प्रब० । सुनते हैं, सुनें । 'जे सकाम नर सुनहिं जे गावहि ।' मा. ७.१५.३, ७.३२.६
सुनहि : आ०मए । तू सुन । 'सुनहि सूद्र मम बचन प्रमाना।' मा० ७.१०६.८
सुनहुं : आo-कामना--प्रब० । सुनें । 'सुनहुं सकल सज्जन सखु मानी।' मा० १.३०.२
सुनहु, सुनहू : आ०मब० । सुनते हो, सुनो। मा० १.७६ ‘राजकु मारि सिखावन सुनहू ।' मा० २.
सुना : भूकृ०० । श्रवण किया। मा० ७.५५.२
सुनाइ : (१) पू० । सुना कर । का सुनाइ विधि काह सुनावा। मा० २.४८.१ (२) आ०-आज्ञा -मए । तू सुना । 'जाइ अनत सुनाइ मधुकर ज्ञान गिरा पुरानि ।' कृ० ५२
सुनाइअ : आ.कवा०प्रए । सुनाइए, सुनाया-यी जाय । द्विज द्रोहिहि न सुनाइस कबहूं।' मा० ७.१२८.५
सुनाइहि : आ० भ०प्रए० । सुनाएगा, बताएगा। 'सो सब तोहि सुनाइहि सोई।' मा० ७.२१.६
सुनाइहौं : आ०भ० उए० । सुनाऊँगा । 'हों सब कथा सुनाइहौं ।' गी० १.४८.३
सुनाई : सुनाई+ब० । 'कहि पुरान श्रुति कथा सुनाईं।' मा० २.१६७.३
सुनाई : (१) भूक०स्त्री० । श्रवण करायी, कही, बतायी। 'जो भुसुडि खगपतिहि सुनाई ।' मा० ७.५२.६ (२) सुनाइ। सुनाकर । 'करहिं कुटि नारदहि सुनाई।' मा० १.१३४.३
सुनाउ, सुनाऊ : आo-आज्ञा+प्रार्थना-मए । तू सुना, कह, बतला। कारन मोहि सुनाउ ।' मा० २.१५; १५१.१
सुनाए : भूकृ.पु० । श्रवणगत कराये । मा० ७.२.७
सुनाएसि : आ० --- भूकृ.पु+प्रए० । उसने सुनाया। 'सबन्ही बोलि सनाएसि सपना ।' मा० ५.११.२
सुनाएहि : आ०-भूकृ०+मए । तूने सुनाया। 'प्रथमहिं मोहि न सुनाएहि भाई।' मा० ६.६३.४
सुनाएहु : मा०-भ+आज्ञा---मब०। तुम सुनाना। 'भरतहि कुसल हमारि सुनाएहु ।' मा० ६.१२१.२
1086
_______________________________________________
सुनाज : (दे० नाज) उत्तम अन्न । दो० १६७
सुनाजु, सुनाजू : सुनाज+कए० । रुचिकर भोज्य अन्न । 'मुदित छुधित जनु पाइ सुनाजू ।' मा० २.२३५.२
सुनात : उत्तम नाता, श्रेष्ठ सम्बन्ध । जा०म० १४८
सुनाम : सं०० (सं.)। उत्तम नाभि (धुरी) वाला-सुदर्शन चक्र । 'लै सुनाभ बाहन तजि धाए ।' विन० २४०.७
सुनाम : (१) सं०पू० (सं०) । उत्तम शुभ नाम । दो० ७ (२) वि० । उत्तम नाम वाला, सरनाम, विख्यात । 'परिहरि सुरमनि सुनाम गुजा लखि लटत।' विन० १२६.४ (यहाँ 'सुनाम' के दोनों अर्थ हैं-प्रसिद्ध सुरमणि तुल्य रामनाम)।
सुनायउँ : आ० - भूकृ०+उए । मैंने सुनाया । 'तुम्हहि सुनायउँ सोइ ।' मा० ... ७.६२
सुनायउ : भूकृ००कए । सुनाया, बतलाया। 'निज नाम सुनायउ।' मा० ६.६४.३
सुनायबी : भकृ०स्त्री० । सुनानी (होगी) । 'बिनय सुनायबी परि पाय ।' गो० ६.१४.१
सुनायहु : आo.-भूकृ०+मब० । तुमने सुनाया-सुनाई । जिमि यह कथा सुनायहु ___ मोही।' मा० १.१२७.७
सुनाये : सुनाए । हनु० १६
सनायो : सुनायउ । मा०
६.३५:१०
सुनारी : उत्तम स्त्री । कवि० ७.१८
सनावँ : (दे० नाव) । उत्तम सुखद नौका पर । 'गुरहि सुनावें चढ़ाइ सुहाई। मा० २.२०२.४
सुनाव,  सुनावइ : आ०प्रए० (सं० श्रावयति>प्रा० सुणावइ)। सुनाता है, सुनायेगा । 'समाचार मंगल कुशल सुखद सुनावइ कोइ ।' रा०प्र० ६.७.३
सुनावइँ : सुनावहिं । रा०न० २०
सुनावउँ : आ० उए । सुनाता हूं, कह रहा हूं। 'सोउ सब कथा सुनावउँ तोही ।' मा० ७.७४.२
सुनावत : वकृ०० । सुनाता-ते; बतलाता-ते । मा० ७.६०.१
सुनावहिं, सुनावहीं : आ०प्रब०। सुनाते-ती हैं (कहते हैं)। 'रामचंद्र कर सुजस सुनावहिं ।' मा० ६.४४.५; १.६६ छं०
सुनावहु : (१) आ०मब० । सुनावो, कहो। 'अब प्रभु चरित सनावहु मोही ।' मा० ७.२.१४ (२) सुनाएहु । तुम सुनाना । 'तिमि जनि हरिहि सुनावहु कवहूं।' मा० १.१२७.८
_______________________________________________
1087
सुनावा : भूक०० । सुनाया, बताया। 'प्रभु प्रभाउ परिजनहि सुनावा ।' मा० ७.२०.५
सुनावों : सुनावउँ । सुनाऊँ, कह लू । मा० ५.२.४
सुनासीर : सं०० (सं० शुनाशीर, शनासीर)। इन्द्र । मा० ६.१०
सुनि : (१) पूकृ० । सुनकर । 'सो सुनि रामहि भा अति सोचू ।' मा० २.२२७.३ (२) सुनिअ । सुना जाता है । 'प्रभु आइ परे सनि सायर कांठे।' कवि० ६.२८
सुनिअ, य, ए : आ.कवा०प्रए० (सं० श्रूयते>प्रा० सुणीअइ)। (१) सुना जाता है। 'सब कह सुनिअ उचित फल दाता ।' मा० १.२२२.५ (२) सुना जाय । 'सुनिअ माय मैं परम अभागी।' मा० २.६६.३
सुनिअत, यत : वक००कवा । सुना जाता (है) । 'सुनिअत सुरपुर जाइ ।' दो० ४६७
सुनिअति : वकृ०स्त्री०कवा० । सुनी जाती। 'सोभा असि कहुं सुनिअति नाहीं।' ___ मा० २.२२०.६
सुनिए, सुनिये : सुनिअ । कृ० ३७
सुनिबे : भक०० । सुनने । “सुनिबे कह किए कान ।' दो० २५०
सुनिबो : भक००कए । सुनना (होगा)। 'तो सुनिबो देखिबो बहुत अब ।' कृ० ३४
सुनियो : आ०भ०+आज्ञा-प्रार्थना+मब० । तुम सुनना । 'मेरो सुनियो तात संदेसो।' गी० ३.१६.१
सुनिहउँ : आ०भ० उए । सुनूगा। 'तब सुनिहउँ निर्गुन उपदेसा।' मा० ७.१११.११
सुनिहहि : आ०भ०प्रब० । सुनेंगे । 'सुनिहहिं बाल बचन मन लाई ।' मा० १.८.८
सुनिहैं : सुनिहहिं । गी० १.८०.७
सुनिहौं : सुनिहउँ । 'श्रवननि और कथा नहिं सुनिहौं ।' विन० १०४.३
सुनीं : (१) भूक०स्त्री० । मा० ७.५५.४ (२) सुनि । सनकर । कवि० ७.७२ (३) सुनिअ । सुना जाता है, सुनी जाती है। 'उदार दुनी न सुनी ।' मा० ७.१०१.६
सुनु : आ०-~आज्ञा, प्रार्थना-मए । तू सुन । 'नाम मोर सुनु कृपानिधाना।' मा० ७.२.८
सुने : (१) भूक००० । श्रवण किये । मा० २.१७६.७ (२) सुने हुए (सुनने)। 'पढ़े सुने कर यह फल सुदर ।' मा० ७.४६.४ (३) सुनकर । 'धनु भंग सुने फरसा लिएँ धाए ।' कवि० १.२२,
1088

सुनेउँ : आ.--भूकृपु+उए । मैंने सुना-सुने । 'सुनेउँ राम गुन भव भय  हारी।' मा० ७.५२.६
सुनेउ, सुनेऊ : भूकृ००कए । सुना । मा० १.१८२.६ 'यह वृत्तांत दसानन सुनेऊ ।' ___मा० ६.६२.५
सुनेत्र : सं०+वि०पू० (सं.)। (१) उत्तम नेत्र । (२) उत्तम नेत्रों वाला। मा० ७.१०८.७
सुनेम : (दे० नेम) । उत्तम दृढ नियम । दो० २१४
सुनेहि : आ० - भूक००+मए० । तूने सुना । 'सुने हि न श्रवन अलीक प्रलापी।' मा० ६.२५.८
सुनेहु : आ०–भूकृ००+मब० । तुमने सुना । 'कहा हमार न सुनेहु तब।' मा०
सुनैं : भकृ० अव्यय । सुनने । 'लगी सुनै श्रवन मन लाई।' मा० ५.१३.६
सुनै : (१) सुनै । सुनने । 'बृद्ध बृद्ध विहंग तह आए। सुने राम के चरित सुहाए ।' मा० ७.६३.४ (२) सुनइ । सुने, सुने सके । 'को न सुनै अस जानि ।' मा० १.११३ (३) पूर्व० । सुनकर । 'धनु भंग सुने फरमा लिए धाए ।' कवि० १.२२
सुनैगो: आ०भ०पू०प्रए । सुनेगा । 'ताको सिख ब्रज न सुनेगो कोउ भोरे ।' क० ४४
सुनैनी : वि०स्त्री० (सं० सुनयनी) । सुन्दर विशाल नेत्रों वाली । 'राम नीके के निरखि सुनैनो ।' गी० १.८१.१
सुनैया : वि० । सुनने वाला । 'दूजो को कहैया ओ सुनया चख चारि खो।' कवि० १.१६
सुनैहै : आ०भ०मए । तू सुनाएगा-गी । 'सुनि तू संभ्रम आनि मोहि सुन है ।' गी. ५.५०.१
सुनौं : सुनउँ । सुनती हूं । 'सुनौं न द्वार बेद बंदी धुनि ।' गी० २.५१.१
सुनौ : सुनहु । सुन लो । 'सुनो, सांची कहौं।' कवि ७.७१
सुन्यो : सुनेउ । मंदोदरी सन्यो प्रभु आयो।' मा० ६.६.२
सुपंथ : (दे० पंथ) सन्मार्ग, धर्मपथ । 'कुपथ निवारि सुपंथ चलावा ।' मा० ४.७.४
सुपंथु : सपंथ+कए । अनन्य सन्मार्ग । 'बेद पुरान बिहाइ सुपंथु ।' मा० ७.८५
सुपच : स्वपच । 'तुलसी भगत सुपच भलो।' वैरा० ३८
सुपथ : सुपंथ । विन० २६०.४
सुपन : सपन । 'खोया सो अनुप रूप सुपन जू परे।' विन० ७४.२
सुपनखाँ : शूर्पणखा ने । 'जाइ सुपनखा पावन प्रेरा।' मा० ३.२१.५
1089

सुपास, सुपासा : सं०+वि० (सं० सुपार्श्व, सुपश्य>प्रा० सुपास)। (१) देखने में उत्तम, मनोरम । 'बसे सुबास सुपास होहिं सब फिरि गोकुल रजधानी ।' क० ४८ (२) अनुकूल वातावरण । 'पराधन नहिं तोर सुपासा ।' मा० ३.१७.१३ (३) सुविधा । 'सब सुपास सब भाँति सुहाई।' मा० १.२१४.५
सुपासी : वि०पु । सखी करने वाला, सुविधा-सुख देने वाला । 'सीकर तें त्रैलोक सुपासी।' मा० १.१६७.५
सुपासू : सुपास+कए । अनुकूल, सुविधा । 'तुम्ह कहुं बन सब भाँति सुपासू ।'  मा० २.७५.७
सुपिता : पूर्ण रक्षा देने में समर्थ उत्तम पिता। विन० ७७.२
सुपीन : अत्यन्त पीन, अति पुष्ट तथा स्थूल । गी० ७.२१.६
सुपुनीत, सुपुनीता : (दे० पुनीत) । अति पावन । मा० ७.१२४; १२५.८
सुपूत : (सं० सुपुत्र) उत्तम सदाचारी आज्ञापालक पुत्र । दो० ३६८
सुपूरन : (दे० पूरन) सम्पूर्ण । गी० ७.६.२
सुपेती : संस्त्री०ब० । सफेद चादरें। 'कोमल कलित सुपेती नाना ।' मा० १.३५६.२
सुपेम : सुप्रेम । मा० २.२०६.६
सुप्रवृत्ति : प्रवृत्ति (सं.)। सं०स्त्री० अत्यन्त प्रवृत्ति-जागतिक व्यवहार, विषयों ___ की रुचि, प्रेरणा, क्रिया-कलाप आदि । विन० ५८.२
सुप्रेम : अनन्य अविचल प्रेम । मा० १.२२
सुफँसौरि : सं०स्त्री० (सं० सु-पाशावलि)। उत्तम बन्धन । गी० ७.१८.१
सुफर : सुफला ।
सुफरु : सुफर+कए । उत्तम (सरस-सुन्दर) फल । 'कुतरु सुफरु फरत । विन
सुफल : (१) सं०पू० (सं.)। उत्तम फल, उपलब्धि, साधना की सिद्धि । (२) वि.पुं० । उत्तम फल युक्त; कृतार्थ । 'जन्म सुफल निज जानि ।' मा० ७.११
सुफलक : सं०० (सं० श्वफल्क)। मथुरा के एक यादव= अक्रूर के पिता । कृ० २५
सुफेर : (दे० फेर) अनुकल समय चक्र ; अच्छा फेरा या मोड़ । अभिमत दैवगति । ‘समुझि कुफेर सुफेर ।' दो० ४३७
सुबट् ट : वि०+सं० (सं० सुवाट = सुवर्म)। (१) उत्तम मार्गों से सम्पन्न (२) उत्तम मार्ग । मा० ५.३ छं० १
सुबद्ध : वि. (सं०) दृढ़ता से विधिपूर्वक बंधा हुआ । 'घाट सुबद्ध राम बर बानी ।' मा० १.४१.४
1090
_______________________________________________
सुबनाउ : (दे० बनाऊ) उत्तम बनाव; ठीक-ठाक निर्माण । 'सब भौति बिगरी है, __एक सुबनाउ सो ।' विन० १८२.७
सुबरन : (१) सं०० (सं० सुवर्ण) । सोना, काञ्चन । 'काँच ते कृपानिधान किये सुबरन ।' विन. २५७.२ (२) वि० (सं० सवर्ण) । उत्तम जाति वाला+ सोना+उत्तम रंग वाला । 'हौं सुबरन कुबरन कियो।' विन० २६६.२ (३) श्रेष्ठ वर्ण (रंग) वाला । 'सम सुबरन सुमाकर सुखद न थोर ।' बर० १०
सुबल : कृष्ण के एक सखा का नाम ।
सुबस : (१) वि०+क्रि०वि० (सं० सुवास)। भली प्रकार निवास के साथ । (२) (सं०. स्ववश) स्वाधीन । 'सबस बसिहि फिरि अवध सुहाई। मा० २.३६.३
सुबसन : उत्तम वस्त्र । मा० २.२१५.३
सुबस्तु : उत्तम संग्रहणीय वस्तु, सुन्दर वस्तु । मा० १.७ क
सुबाजि : उत्तम अश्व । कवि० ६.३३
सुबानक : (दे० बानक) सुन्दर योग्य बनाव, सजावट, वेषरचना आदि । पा०म०
सुबानि : (दे० बानि)। (१) उत्तम वचन । श्रेष्ठ कथनरीति । 'कही समय सिर भरत गति रानि सुबानि सयानि ।' मा० २.२८७ (२) उत्तम स्वभाव । 'राउरि रीति सुबानि बड़ाई।' मा० २.२६६.१
सुबानीं : (दे० बानी) उचित वाणी से+उत्तम सील के साथ =विनय युक्त वाणी से । 'कहि निषाद निज नाम सुबानी।' मा० २.१९६.४ सुबानी (दे० बानी)। (१) उत्तम वचन । 'आयसु आसिष देहु सुबानी ।' मा० २.१८३.७ (२) उत्तम स्वभाव, विनीत प्रकति ।
सुबारि : उत्तम निर्मल जल । मा० १.४३ क
सुबास, सुबासा : सं०+वि०पु० (सं० सुवास)। (१) उत्तम निवास । ‘बसें सुबास सुपास होहिं सब फिरि गोकुल रजधानी ।' क० ४८; मा० २.१० (२) उत्तम गन्ध, सुगन्ध । 'सोइ पराग मकरंद सुबासा।' मा० १.३७.६ (३) सुगन्धित । 'सुरुचि सुबास सरस अनुरागा।' मा० १.१.१
सुबाहु : (१) सं०० (सं.)। ताटका का पुत्र-राक्ष सविशेष । मा० ३.२५ (२) उत्तम बाहुबल । 'रैअत राज समाज घर तन धन धरम सुबाहु ।' दो० ५२१
सुबाहुहि : सुबाहु राक्षस को, से । अति मारीच सुबाहुहि डरहीं।' मा० १.२०६.३
सुबिचार : उत्तम विचार, विवेक । दो० ३४६
सबिचारी : उच्चकोटि के मनीषी । मा० २.२८४.३
1091
सुबिचित्र : अत्यन्त विलक्षण, चमत्कारी । मा० २.६०
सुबिद्या : उत्तम विद्या, अनुकूल फल प्रद विद्या । रा०प्र० २.७.६
सुबिधान : उत्तम विधान, श्रेष्ठ आचार संहिता आदि । गी० १.४.१२
सुबिनीता : अति विनीत, अतिशय शिष्ट एवं विनयशील । मा० ३.२४.४
सुबिरति : उत्तम विरति = विषय-वैराग्यपूर्वक चित्त के विश्राम की दशा । मा० १.४०.३
सुबेल, सुबेला : (१) सं०० (सं० सुवेल) । लङका के समीप त्रिकूट पर्वत के पास पर्वतविशेष । मा० ६.६.५; ११.६ (२) सं०स्त्री (सं० स्ववेला–वेला= समुद्र तट) अपना तट, सागरीय मर्यादा । 'जन आनंद समुद्र दुइ मिलत बिहाइ सुबेल ।' मा० १.३०५
सुबेलि, सुबेली : (दे० बेली) श्रेष्ठ लता । मा० २.२४४.६
सुबेष, सुबेषा : (दे० बेष) । (१) । सं०० । उत्तम परिधानादि द्वारा रूप सज्जा । मा० १.७.५, ७.४०.८ (२) वि० । उत्तम वेष वाला। 'देखि सुबेष महामुनि जाना ।' मा० १.१५८.७
सुबेषु : सुबेष+कए । 'तुलसी देखि सुबेषु भूलहिं मूढ़ न चतुर नर ।' मा० १.१६१ ख
सुबेस : सुबेष । दो० १६२
सुबोधा : उत्तम ज्ञान । 'पुनि पुनि मोहि सिखाव सुबोधा ।' मा० ७.१०६.८
सुम : सं+वि० (सं० शुभ)। (१) कल्याण । 'जाकर नाम जपत सुभ होई ।' मा० १.१६३.५ (२) शोभायुक्त, सुन्दर । 'घर घर बाज बधाव सुभ ।' मा० १.१६४ (३) कल्याण-कारी, कल्याणसूचक । 'मिलिहहिं राम सगुन सुभ होई ।' मा० ७.१.७ (४) पुण्य, उत्तम । 'सुभ अरु असुभ कर्म फल दाता।' मा० ७.४१.५
सुभग : (१) वि.पुं० (सं.)। सम्पन्न सौन्दर्य-युक्त, सर्वाङ्ग-सुन्दर । 'सुभग उर दधि बुद सुदर ।' कृ० १४ (२) विभूतिमय, शोभामय । 'सुभग सनेह बन । मा० १.३१
सुभगता : सं०स्त्री० (सं.) । सुन्दरता+सम्पन्नता । मा० १.८६ छं०
सुभट : (दे० भट) श्रेष्ठ योद्धा पुरुष । मा० ७.७.८
सुभटनि, सुभटन्ह : सुभट+संब० । सुभटों (ने, के)। 'जिन सुभटनि कौतुक कुधर उखारे ।' गी० १.६८.८; मा० ६.७२.१ ।।
सुभटु : सुभट+कए । एक भी वीर पुरुष । 'तो अस को जग सुभटु जेहि भय बस नावहिं माथ .' मा० १.२८३
सुभट् टा : सुभट । मा० ६.४१.४
सुभद : वि० (सं० शुभद)। कल्याणप्रद । मा० ६.१११.२२
1092

सुभदाता : सुभद । मा० १.३०३.१
सुभलीला : वि० (सं० शुभशील)। सुशील, मङ्गल-प्रकृति । सदाचारी, उत्तम स्वभाव-युक्त । मा० ७.८.१
सुभाउ, सुभाऊ : सुभाव+कए० । स्वभाव =शील । 'करुनामय मदु राम सुभाऊ।' मा० २.४०.३ (२) वैष्णवदर्शन के ३० तत्त्वों में अन्यतम - स्वभावतत्त्व जिसे नियति' कहा जा सकता है । 'काल कर्म सुभाउ गुन भच्छक ।' मा० ७.३५.८
सुभाएँ : स्वभाव से, प्रकृत्या । 'मृगलोचनि तुम्ह भोरु सुभाएँ । मा० २.६३.४
सुभाग : (दे० भाग्य) । उत्तम भाग्य, सौभाग्य । मा० २.२१०.५
सुभागी : वि० । सौभाग्यशाली । 'सोल सनेह सुभाय सुभागी।' मा० २.२२२.८ (अधिक उत्तम भाग वाला =जो शीलादि का भागी हो--इस अर्थ की प्रसंग में संगति है)।
सुभाननु : सं०० कए० (सं० शुभाननम्) । शोभोदीप्त मुख । कवि० ६.५६
सुभामिनि : सुन्दर भामिनी, उत्तम स्त्री। कवि० २.२
सुभायँ : सुभाएं। स्वभाववश । 'राय सुभायें मकुरु कर लीन्हा । मा० २.२.६
सुभाय : सुभाव । (१) उत्तम भाव, सद्भाव । ‘सनेह सील सभाय सों।' मा० १.३२४ छं० २ (२) प्रकृति, शील । 'चीन्हो री सुभाय तेरो।' कृ० १५
सुभायन : सुभाय+संब० । स्वाभावों (से) । 'भाषे मदु परुष सुभायन रिसाइ के।' गी० १.८४६
सुभाये : सभाय । गी० १.३२.५
सुभाव : मं००। (१) (सं० स्वभाव) । वैष्णवमत में तीस तत्त्वों के अन्तर्गत तत्त्वविशेष-नियति, कर्म फल आदि देने का नियमन करने वाली शक्ति । 'काल कर्म सुभाव गुन कृत दुख काहुहि नाहिं ।' मा० ७.२१ (२) शील । 'सुभाव. निर्मल।' मा० ३.३२ छं० ४ (३) अन्त.करणवृत्ति, तत्सम्बधी प्रवृत्ति । 'देखहु नारि सुभाव प्रभाऊ ।' मा० १.५३.५ (४) (सं० सुभाव)। सद्भाव, उत्तम वासना या भावना । (५) काव्यभाव-भक्ति, उत्साह रति आदि । 'अरथ अनूप सुभाव सुभासा ।' मा० १.३७.६
सुभावसिद्ध : वि० (सं० स्वभावसिद्ध) । प्राकृतिक, सहज, स्वाभाविक, अकृत्रिम ।  कवि० ७.१६१
सुभावहि : स्वभाव को, त्रिगुणात्मक व्यामोहकारी भाव को। 'राम पदारबिंद रति करति सुभावहि खोइ ।' मा० ७.२४
सुभाषा : (१) उत्तम वाणी। (२) उत्तम कथन । 'नृपहि मोदु सुनि सचिव सुभाषा ।' मा० २.५.७
सुभाषि : पूकृ० । सुन्दर वार्तालाप करके । मिले हरिहि हरु हरषि सुभाषि सुरेसहि ।' पा०म० ६५
_______________________________________________
1093
सुभासा : सुभाषा (प्रा.)। उच्चकोटि की (काव्यात्मक) भाषा । 'अरथ अनुप सुभाव सुभासा ।' मा० १.३७.६
सुभासिष : (सं० शुभाशिष्) मङ्गलमय आशीर्वाद । पा०म० १२८
सुभासुभ : (सं० शुभाशुभ-दे० सुभ तथा असभ)। (१) पुण्य-पाप । 'करम सुभासुभ तुम्हहि न बाधा ।' मा० १.१३७.४ (२) पुण्य तथा पाप के फल । 'त्याहिं कर्म सुभासुभ दायक ।' मा० ७.४१.७ (३) अनुकूल-प्रतिकूल-फलप्रद । 'करम सुभासुभ देइ बिधाता ।' मा० २.२५५.६ (यहाँ 'करम' प्रारब्ध वाचक है)
सुभाहिं : आ.प्रब० । शुभ लगते हैं, भले प्रतीत होते हैं। 'रंगभूमि पुर कौतुक एक निहारहिं । ललकि सुभाहिं नयन मन फेरि न पारहिं ।' जा०म० १२ यहाँ 'लुभाहि' पाठ होना चाहिए, तभी 'ललकि' की संगति बैठती है।
सुभुज : सुबाहु । राक्षसविशेष । 'जो मारीच सुभज मदमोचन ।' मा० १.२२१.५
सुभूमि : उत्तम उपजाऊ भूमि (सुखेत) । सुमिरि सुभूमि होत तुलसी सो उसरो। विन० ६६.५
सुभोगमय : उत्तम भोगों (भोग्य सामग्रियों से सम्पन्न । मा० २.६०
सुभ्र : वि. (सं० शुभ्र) । दीप्ति, स्वच्छ, सुन्दर, उज्ज्वल । मा० ४.१३.६
सुभ्रवारी : वि०स्त्री० । चाँदी (शुभ) से बनी हुई, उज्ज्वल । गी० १.२५.४
सुमंगल : सं०० (सं.)। (१) शुभ समारोह (२) कल्याण । 'सुदिनु सुमंगल दायकु सोई। मा० २.१५.२ (३) मङ्गल गीत । 'करि कुलरीति सुमंगल गाई।' मा० १.३२२.४ (४) मङ्गलोत्सव का बनाव सिंगार आदि । 'सजि सुमंगल भामिनीं। मा० १.३२२ छं०
सुमंगलचार : सं०० (सं०) । मङ्गलोत्सव की सामग्री, रचना, सजावट, वेषभूषा  आदि । 'सजहिं सुमंगलचार ।' मा० २.२३ ।।
सुमंगलचारा : सुमंगलचार । मा० १.३१८.५
सुमंगलु : सुमंगल+कए । श्रेष्ठ अद्वितीय मङ्गलोत्सव । 'सुदिन सुमंगल ।' मा०
सुमंत : सुमंत्र । गी० २.५६.१
सुमंत्र : (१) सं०० (सं.)। दशरथ के प्रधानमन्त्री तथा सारथि । मा. १.३०१.६ (२) वि० । उत्तम मन्त्रयुक्त, अभिमन्त्रित । ‘गोली बान सुमंत्र सर ।' दो० ५१६
सुमंत्रु : सुमंत्र+कए । एक सुमंत्र को (विशेष रूप से)। 'सेवक सचिव सुमंत्र बोलाए।' मा० २.५.१
सुमंद : रुचिकारी मन्द गति वाला । मा० १.८६ छं.
सुमग : (दे० मग) उत्तम मार्ग । गी० २.२७.१
1094

सुमति : (१) सं०स्त्री० (सं.)। सद-बुद्धि । 'काहू सुमति न खल सँग जामी। __ मा० ७.११२.४ (२) वि० । उत्तम बुद्धि से युक्त । सावधान सनु सुमति भवानी।' मा ० १.१२२.३
सुमन : (सं० सुमनस्) । (१) देवता (२) पुष्प । 'अंजलि गत सुभ सुमन जिमि सम सुगंध कर दोई ।' मा० १.३ क (३) उत्तम निष्कलुष मन । 'माली सुमन सनेह जल सींचत लोचन चारु ।' मा० १.३७ (४) उत्तम मन वाला, मनस्वी। (५) स्वस्थचित्त, सोमनस्ययुक्त, आश्वस्त । 'सुनि मैना भइ सुमन ।' पा०म० १०६
सुमननि : समन+संब० । फूलों (से) । गी० २.४४.४
सुमनमय : वि० (सं० सुमनोमय) । पुष्पावत, पुष्प निमित, फूलों से परिपूर्ण । मा० २.१२१.४
सुमानस : निर्मल मानस । (१) निष्कलुष चित्त । 'भरेउ सुमानस सुथल थिराना ।' मा० १.३६.६ (२) मानस सरोवर । 'नदी पुनीत समानस नंदिनि ।' मा० १.३६.१३ उभयत्र दोनों अर्थ साथ-साथ हैं; प्रधानता की दृष्टि से पथक् उदाहत हैं।
सुमार : अच्छी मार, मारामार, तीव्र प्रहार । 'समर समार सूर मार रघुबीर के।" कवि० ६.३१
सुमित्रहि : सुमित्रा को । 'दीन्ह सुमित्राहि मन प्रसन्न करि ।' मा० १.१६०.४
सुमित्रां : सुमित्रा ने । 'भेटेउ तनय सुमित्रों ।' मा० ७.६
सुमित्रा : संस्त्री० (सं.)। दशरथ की छोटी रानी लक्ष्मण तथा त्रुघ्न की माता । मा० १.२२१.८
सुमिर, सुमिरइ : आ०प्रए० (सं० स्मरति>प्रा० सुमरइ)। स्मरण करता-करती है । 'मन महं रामहि सुमिर सयानी ।' मा० १.५६.५
सुमिरत : वकृ०० । स्मरण करता-करते-करते हुए । 'समिरत हरिहि श्राप गति बाधी।' मा० १.१२५.४
सुमिरति : वकृ०स्त्री० । स्मरण करती । गी० ५.९.३
सुमिरन : (१) सं०० (सं० स्मरण>प्रा० सुमरण)। ध्यान । मा० ५.६.३ (२) भकृ० अव्यय । स्मरण करने । 'राम नाम सिव सुमिरन लागे ।' मा०
सुमिरहिं, सुमिरहीं : आ०प्रब० (सं० स्मरन्ति>प्रा० सुमरंती>अ० सुमरहिं) । स्मरण करते हैं-करें। मा० ७.२.१६ “पापिउ जाकर नाम सुमिरहीं।' मा० ४.२६.३
सुमिरहु : आ०मब० । स्मरण करो, ध्यान में लाओ। मा० २.२६५.८
सुमिरामि : आ० उए० (सं० स्मरामि>प्रा० सुमरामि)। स्मरण करता हूं। 'ब्रह्म सुमिरामि नर भूप रूपं ।' विन० ५०.८
_______________________________________________
1095
सुमिरि : (१) पूक. स्मरण करके, ध्यान करके। मा० ७.१६.४ (२) मा०-आज्ञा-मए। तू स्मरण कर। 'तुलसी अजहुँ सुमिरि रघुनाथहि ।' विन० ८३.६
सुमिरिअ : आ०-कवा-प्रए । स्मरण किया जाय, ध्यान में लाइए । 'रामहि सुमिरिअ गाइअ रामहि ।' मा० ७.१३०.६
सुमिरिए, सुमिरिये : सुमिरिन ।' सुमिरिये छाडि छल ।' विन० २५४.२
सुमिरिबे : भकृ.पु । स्मरण करने । 'साकरे के से इबे सराहिबे सुमिरिबे को।' कवि० ७.२२
सुमिरी : भूकृ०स्त्री० । स्मरण की। 'हिये सुमिरी सारदा सुहाई ।' मा० २.२६७.७
सुमिरु : आo--आज्ञा-मए । तू स्मरण कर । 'सुमिरु राम सेवक सुखदाता।' ___ मा० ५.१५.६
सुमिरें : स्मरण करने से । जो सुमिरें गिरि मेरु सिलाकन होत ।' कवि० २.५
सुमिरे : (१) भूकृ०० ब० । स्मरण किये । 'सुमिरे सिद्धि गहेस ।' मा० १.३३८ (२) समिरें। समिरे हरनहार तुलसी की पीर को।' हनु १०
सुमिरेसि : आ० - भूकृ००+प्रए । उसने स्मरण किया। 'समिरेसि राम समेत सनेहा ।' मा० ३.२७.१६
सुमिरेसु : आ०-भ०+-आज्ञा-मए । तू स्मरण करना । 'सुमिरेसु भजेसु निरंतर ___ मोही।' मा० ७.८८.१
सुमिरेहु : आ०-भ+आज्ञा-मब । तुम स्मरण करना । 'मोहि सुमिरेहु मन  माहिं ।' मा० ६.११६
सुमिरौं : आ० उए० । स्मरण करता हूं। 'हित दै पद सरोज सुमिरौं ।' विन ० १४१.५
सुमीच : (दे० मीचु) उत्तम मृत्यु, सद्गतिदायक मरण । 'मुनि मन अगम सुमी। दो० २२०
सुमीत : (दे० मीत) निष्कपट उत्तम मित्र । दो० ५५७
सुमुख : वि० (सं०) । सुन्दर मुख वाला+सम्मुख रहने वाला=अपने अनुकल सुन्दर मुख वाला । 'सुमुखा सुलोचन सरल सुभाऊ ।' मा० २.२७४.६
सुमुखि : वि.स्त्री० (सं० सुमुखी) । सुन्दर मुख वाली, सुन्दरी । मा० ५.६.४
सुमृति : सं०स्त्री० (सं० स्मृति) । धर्मशास्त्र । 'बेद पुरान सुमृति कर निदा।' मा० ७.४८.६
सुमेरै, रु, रू : सं०० (सं० सुमेरु)। पुराण-वजित स्वर्ण पर्वत । मा० ७.५६.७; २.२८८; २.२६५.४
