796 
_______________________________________________
भरायो : भूकृ.पु.कए । (१) उदर भरण कराया, पाला-पोसा (२) आभूषण आदि के रिक्त भाग को पूर्ण कराया । 'रावरो राम भरायो गढ़ायो।' कवि० ७.६० (३) लदाया। 'मनि गन बसन बिमान भरायो।' मा० ६.११७.३
भरावा : भक०पू० । भरने का काम कराया । 'दिगपालन्ह मैं नीर भरावा ।' मा० ६.२८.५
भरि : पूकृ० (अ०) । (१) व्याप्त करके । 'रमा प्रगटि त्रिभुवन भरि भ्राजी।' कृ०६१ (२) व्याप्त होकर । 'दुइ दंड भरि ।' मा० १.८५ छ० (३) पूर कर, तप्ति पर्यन्त । 'यह उत्सव देखि भरि लोचन ।' मा० १.८६.१ (४) पूरा-पूरा, साधन्त । 'एहि प्रकार भरि माघ नहाहीं ।' मा० १.४५.१ (५) मात्रा में नाप कर । 'तिलु भरि भूमि न सके छड़ाई। मा० १.२५२.२ (६) लाद कर । 'अन्न कनक भाजन भरि जाना ।' मा० १.१०१.८
भरित : भूक० (सं० भृत) । पूरित (भरा हुआ)। विन० १६.२
भरिता : भक स्त्री० । भरी हुई । 'राम बिमल जस जल भरिता सो।' मा. १.२६.११
भरिपूरि : पूर्णतः व्याप्त होकर । 'पुलक तनु भरि-पूरि।' गी० ७.१८.६
भरिपेट : जी भर कर, जितना हो सका उतना, पराकाष्ठा तक । 'पाइ सुसाहिब राम सो, भरिपेट बिगारी।' विन० १४८.४
भरिबे : भकृ.पु । भरना, धारणीय । 'जरि जीवन भरिबे हो।' कृ० ३६
भरिया : भरित (प्रा० भरिय)। भर गया। 'मन तो न भरो घरुप भरिया ।' कवि० ७.४६
भरिहैं : आ०म०प्रब० । भरण-पोषण करेंगे। 'प्रभुहि कनोड़ो भरिहैं ।' विन. १७१.७
भरिहै : (१) आ०भ०प्रए । भरेगा, पूरेगा । 'को भरिहै हरि के रितएँ।' कवि. ७.४७ (२) मए । तू भरेगा, पूरा करेगा (बिताएगा) । 'तू जनम कोनि बिधि भरिहै ।' गी० २.६०.४
भरी : भूकृ०स्त्री०ब० । व्याप्त हुई , भर गईं। 'भरी प्रमोद मातु सब सोहीं।' मा. १.३५०.५
भरी : भकृस्त्री० । (१) ओत-प्रोत । 'गं पतिलोक अनंद भरी।' मा० १,२११ ई० (२) पूरित+व्याप्त । 'भरी क्रोध जल।' मा० २.३४.२ (३) सम्पन्न । 'रहिअहु भरी सोहाग ।' मा० २.२४६ (४) पुष्ट । 'भारी भुजा भरी, भारी सरीर ।' कवि० ६.३३
भरहाइ : पूक० । फूल (कर); आवेशपूर्ण हो (कर) । 'नीच यहि बीच पति पाइ भरहाइ गे।' हनु० ४१ _______________________________________________
797 
भवहाए : भूक०० ब० । आवेश से फुलाए हुए (क्रोध में लाए हुए) । 'भरुहाए नट भाँट के चपरि चढ़े संग्राम ।दो० ४२२
भरें : भरे हुए (स्थिति में) । 'सब सघ सोनित तन भरें।' मा० १.६३ ७०
भरे : भू०पुब० । पूर्ण हुए। 'पुलक सरीर भरे जल नैना।' मा० १.६८.३ (२) व्याप्त । 'हैं घर घर भरे सुसाहिब ।' विन० १५३.२
भरेइ : भरे ही, ज्यों के त्यों पूर्ण । 'तुलसिदास पुनि भरेइ देखियत ।' गी० १.३.६ 
भरेउ, ऊ : भूक००कए । पुर गया। 'भरेउ सुमानस सुथल ।' मा० १.३६.६%; ६.७१.२
भरै : भरहिं । 'सुर मनुज मुनि आनंद भर ।' मा० १.३२४ छं०३
भरै : (१) भरइ । भरता है। 'जो कोइ कोप भरै मुख बैना ।' वैरा० ४६ (२) भर जाय, पूर्ण हो जाय। 'उदर भरै सोइ जतन सिखावहिं ।' मा० ७.६६.६
भरो : भर्यो । 'मन तो न भरो।' कवि० ७.४६ (सन्तुष्ट हुआ)। 
भरोस, सा : सं००। (१) आश्रय, सहारा, शरण । 'राम भरोस हृदयं नहिं दूजा ।' मा० २.१२६.४ (२) विश्वास, आश्वासन । 'निज बुधि बल भरोस मोहि नाहीं ।' मा० १.८.४ (३) आस्था, एक निष्ठा । 'भायप भगति भरोस भलाई ।' मा० २.२८३.३ (४) आशा, अनुकूल संभावना । 'नाथ देव कर कौन भरोसा ।' मा० ५.५१.३
भरोसें : भरोसे पर, सहारा लेकर । 'सेवक सुत पति मातु भरोसे ।' 'रहइ असोच ।' मा० ४.३.४
भरोसे : भरोसें । कृ. २७
भरोसो : भरोसा+कए। एकमात्र अवलम्ब । 'अस मोहि सब बिधि भूरि भरोसो।' मा० २.३१४.५
भरौं : आउए । भरता हूं, पूरता हूँ। 'नाम तव बेंचि नरकप्रद उदर भरौं।" विन० १४१.३
भर्ता : भरतार । (१) पति । अमित दानि भर्ता बैदेही ।' मा० ३.५.६ (२) पालक । "जय भुवन भर्ता ।' विन० २५.२
भयो : भरेउ । मा० ६.९४ छं०
भल : वि०+सं०० (सं० भद्र>प्रा० भल्ल)। (१) कल्याण । 'जानत हौं कछु भल होनिहारा ।' मा० १.१५६.७ (२) उत्तम, अच्छा। 'ताहि कबहुं भल कहइ न कोई ।' मा० ७.४४.३ (३) उत्तम कार्य, विवेकयुक्त कर्म । 'भल न कीन्ह ते निसिचर नाहा।' मा० ६.६३.१ (४) अनकल, उचित । 'पारबती भल जाना। मा० १.१०७.२ (५) शभ, कल्याणकारी । 'खल सन कलह नः 
798 
_______________________________________________
भल नहिं प्रीती ।' मा० १.१०६.१४ (६) कि०वि० । क्या खूब, यह भी अच्छी 
रही कि । 'भल भूलिहु खल के बोराएँ ।' मा० १.७६.७
भलाइहि : भलाई ही, अच्छाई ही । 'भलो भलाइहि पै लहइ ।' मा० १.५
भलाई : भलाई में, से । 'भलेउ प्रकृति बस चकइ भलाई।' मा० १.७.२
भलाई : सं०स्त्री० । (१) अच्छाई। उत्तमता, श्रेष्ठता। 'मति कीरति गति भूति भलाई।' मा० १.३.५ (२) कल्याण, सत्परिणाम । 'बिधि बिपरीत भलाई नाहीं।' मा० १.५२.६ (३) औचित्य । 'सब बिधि भामिनि भवन भलाई।' मा० २.६१.४ (४) स्वास्थ्य आदि । 'पूछी निज कुल कुसल भलाई ।' मा० २.१५६.७ 
भलि, ली : भल+स्त्री० । उत्तम, मङ्गलमय । अच्छी । मा० १.१०.१०; ६४.२
भलिक : भली प्रकार, पूर्णतया । 'भलो मान्यो भलिक ।' कवि० ६.५५
भलें : क्रि०वि० । (१) नितान्त, खूब, पूर्णतया । 'भले भूप कहत भलें भदेख भूपनि सों।' कवि० १.१५ (२) भले..... में । 'भलें कुल जन्म ।' कवि० ७.३३
भले : भल+ब० । निसान नभ बाजे भले ।' मा० १.१०२ छ०
भलेउ : भले भी, अच्छे भी । 'भले उ पोच सब बिधि उपजाए ।' मा० १.६.३
भलेरो: वि.पुं०कए० (सं० भद्रतरम् >प्रा० भल्लयरं>अ. भल्लयरउ) अत्यन्त  शुभ । 'ह्र है.....'तुलसी को भलेरो।' विन० २७२.५
मलेहि : (१) भले ही, चाहे (संभवतः), अन्य की अपेक्षा में । 'सादर भलेहि मिली एक माता ।' मा० १.६४.२ (२) अच्छा, जो आज्ञा, तथास्तु । 'भले हि नाथ आयसु धरि सीसा ।' मा० १.१६०.१
भलेहि : (१) भले को। 'भलेहि मंद मंदेहि भल करहू ।' मा० १.१३७.२ (२) भले के लिए । 'जगु भल भलेहि ।' मा० २.२१७७
भल : भले ही । 'एक बात भले भली ।' विन० २५१.४
भलो : भल+कए। उत्तम (व्यक्ति)। 'भलो भलाइहि प लहइ ।' मा० १.५ (२) शुभ । 'भलो भयो।' कृ० ३९ 
भलोइ, ई : भला ही, अच्छा ही । भलोई कियो।' कवि० ७.१५६
भवर : (१) सं०० (सं० भ्रमर>प्रा० भमर>अ० भवर)। भौंरा । किसि भवर कर हरवा ।' बर० ३२ (२) (सं० भ्रामर) आवर्त, प्रवाहचक्र । 'भवर तरंग मनोहरताई।' मा० १.४०.८
भवरु : भवर+कए० । भौंरा । ‘देखि राम मन भवरु न भूला।' मा० २.५३.४
भव : सं०० (सं.)। (१) सृष्टि, संसार । 'समन सकल भवरुज परिवारू ।' मा० १.१.२ (२) उत्पत्ति । 'भव भव बिभव पराभव कारिनि ।' मा० १.२३५.८ (३) शिव, महादेव । ‘भव अंग भूति मसान की।' मा० १.१० छं. _______________________________________________
799 
(४) (समासान्त में) वि० । उत्पन्न, जनित । 'ईस-अंस-भव परम कृपाला।' 
मा० १.२८.८
भवंत : सर्वनाम पु० (सं० भवत् >प्रा० भवंत) । आप, श्रीमान् । मा० ७.१४ छं०
भवकूपा : संसाररूपी कुआ। मा० १.१६२ छं०
भवचापा : भव =शिव का चाप =धनष । मा० १.२५४.६
भवचापू : भवचाप+कए । एक शिव धनुष । 'भजेउ राम आपु भवचापू।' मा० १.२४.६
भवजाल : संसाररूपी जाल । विन० ७४.४
भवत : (सं० भवतः) आप को। 'भूतभव भवत पिसाच भूत प्रेत प्रिय ।' कवि० ७.१६८
भवतव्यता : संस्त्री० (सं० भवितव्यता) । भावी, होनहार, दैवी विधान । मा० १.१५६ ख
भवता : संसाररूपी वृक्ष । 'भवतरु टर न टार्यो।' विन० २०२.२
भवतारक : संसार से पार ले जाने वाला । विन० १४५.६
भवतु : आ०-कामना-प्रए० (सं.)। हो, होवे । 'भवतु में राम विश्राममेकं ।' विन० ५७.८
भवत्रास : भवमय ! विन० ६३.६
भवदंग : (सं0-भवत+अङ्ग) आपका अङ्ग ईश्वर देह । 'भुवन भवदंग, कामारिवंदित ।' विन० ५४.३ (रामानुज, रामनन्द दर्शनों के अनुसार चित् = आत्मतत्त्व तथा अचित् = अनात्म जड़ तत्त्व दोनों परमेश्वर का अंश एवं शरीर रूप हैं।)
भवदंघ्रि : (भवत्-+अंघ्रि) आपके चरण । मा० ७.१४ छं० ५
भवदंशसंभव : आपके अंश से उत्पन्न (दे० भवदंग)। 'बिस्व भवदंशसंभव पुरारी।' विन० १०.६
भव-धनु : शिवजी का धनुष । विन० १००.५
भवन : सं०० (सं.) । घर, आगार, आवास । मा० १.१०.२
भवननि : भवन+संब० । भवनों। 'भवननि पर सोभा अति पावत ।' मा० ७२८.५
भवनिधि : भवसागर, संसाररूपी समुद्र । मा० ६.६६.३
भवनिसा : संसाररूपी रात्रि । विन० १०५.१
भवनी : घरनी। पत्नी । 'पुलकि तनु कहति मुदित मुनिभवनी।' गी० १.५८.२
भवनु : भवन+कए । वह एक घर । 'भवन ढहावा ।' मा० ६.४४.३
भवपास : (सं० भव-पाश) संसार जाल, जन्म-मरण-बन्धन । विन. ४६.६ 
800 
_______________________________________________
भवपीर : संसार के क्लेश। विन० ६३.५
भव-बंधन : भवपास । विन० १६६.३
भव-बासना : संसार की वासना; जन्म-मरण देने वाली कर्मफलों की भावना, सांसारिक विषयों का आकार लेने वाली चित्तवत्ति । विन० ४७.३
भवबेगारि : (दे० बेगारि) । बेगार के समान निष्फल संसार। 'नाहिं त भव-बेगारि  महँ परिहै ।' विन० १८६.१
भवभंग : संसार का खण्डन । 'सैलसग भवभंग हेतु ।' विन० २४.२
भवभक्त : शिवजी के भक्त । विन० ५६.२
भवभय : संसार का भय, जन्म-मरण आदि क्लेशों का त्रास । मा० १.२४.६
भवभाजन : संसार का पात्र, आवागमन का अधिकारी । 'तातें भवभाजन भयो ।" विन० १६०.१
भवमाननी : संसार (आवागमन) को मिटाने वाली । गी० ७.५.४
भवभामा : शिव-पत्नी पार्वती । मा० १.१००.७
भवभामिनी : भवभामा। विन० १८.५
भवभार : संसार रूपी भार+संसार का भार । विन० १७.२
भवभावते : शिवजी के इष्टदेव । 'सुनियत भवभावते राम हैं।' गी० १.८०.३
भवभीर : भवभय । कवि० ७.४६
भवभूषनु : वि.पु.कए० । विश्व का एकमात्र अलंकरण, प्रसिद्ध । 'पूषन सो भव - भूषनु भो।' कवि० ७.४२
भवभेद : सांसारिक भेदभाव, मायाजनित द्वैत (जो एक तत्त्व से निर्मित पदार्थों का अलगाव तथा ब्रह्म से उसकी पथकता भासित कराता है)। उपादान तत्त्व से कार्य (संसार) तत्त्व को पृथक् भासित कराने वाला द्वैत । विन० ६४.१
भवमग : संसार का मार्ग, आवागमन रूपी कर्मफलों का मार्ग । 'भवमग अनन्त है।" विन० १५१.७
भवमोचन : संसार से मुक्त करने वाला । मा० १.२११ छं०१५
भवरोग : संसार रूपी रोग, जन्म-मरण चक्र की व्याधि । विन० ८१.५
भवबंध : (सं०) शिवजी के पूज्य (प्रणम्य, आराश्य) । विन० ५६.२
भवसरिता : संसार रूपी नदी। विन० १८५.५
भवसागर : संसार रूपी समुद्र ; अपरिमेय आवागमन चक्र । मा० ४.२६.३
भवसिंधु : भवसागर । मा० १.२५ ४
भवसंभव : संसार से उत्पन्न । 'मिटहिं सकल भवसंभव खेदा ।' मा० ४.२३.५
भवसूल : (दे० सूल) । सांसारिक क्लेश । विन० १३६.१ तुलसो शब्द-कोश 
801 
भवहि : भव=शिव को। 'भवहि समरपी जानि भवानी ।' मा० १.१०१.२
भवाई : पू० (सं० भ्रामयित्वा>प्रा. भमाविअ>अ० भावि)। भवा कर, धुमा कर । 'गहि पद पटकेउ धरनि भवाई ।' मा० ६.१८.५
भवान् : सर्वनाम (सं०) भवंत । आप। मा० ५ श्लोक २
भवानि : भवानी। मा० १.१००
भवानिये : भवानी ही । कवि० ७.१६८
भवानी : सं०स्त्री० (सं० भवस्य की पत्नी भवानी)। शिव-पत्नी शिव की आदि शक्ति । भवहि समरणीं जानि भवानी।' भा० १.१०१.२ 
भवानीनाथ, पति : पार्वती के पति = शङकर । कवि० ७.१६९; मा० ७.१०८ छं०१० 
भांबुनाथ : (भव-संसार)+ (अंबुनाथ =सागर)= भवसागर । मा० ३.४.३
भवार्णव : (भव-संसार)+(अर्णव =सागर) =भवसागर । मा० ३.४ छं०
भवेस : (सं० भवेश-भव-संसार) । जगदीश्वर, विश्वेश । कवि० ७.१५२
भसम : भस्म । रा०प्र० ३.१.६ ।
भस्म : सं०० (सं० भस्मन्) । राख । विन० १०.२
महराने : भूकृ.पु०ब० । ध्वस्त हो गए, बिखर गये । 'भहराने भट पर्यो प्रबल परावनो।' कवि० ५.८
भांग : संस्त्री० (सं० भङ्गा)। एक नसीली पत्तो, उसका झाड़ । जो सुमिरत ___ भयो भांग तें तुलसी तुलसीदासु । मा० १.२६
मांट : भाट । दो० ४२२
मांड : सं०० (सं० भण्ड) । स्वांग भरने वाला, विविध रूप भरकर नकल उतारने वाला पुरुष । 'भाड़ भयो तजि गेह ।' दो० ६३
भांडि : पूकृ० । ढहा (कर), ध्वस्त कर । 'सहित समाज गढ़, राँड़ कैसो भाँडि गो।' कवि० ६.२४ ।।
भांड : भाँड़+कए० । 'राम बिमुख कलिकाल को भयो न भाँड़ ।' बर० ६६
मॉड़े : सं०पुब० (सं० भाण्ड) । पात्र, बर्तन (आधार) । 'कपट कलेवर कलिमल भांड़े ।' मा० १.१२.२
भांति : सं०स्त्री० । रीति, प्रकार, शैली, विधि । 'सो कुल भली भांति हम पावा।' ____ मा० १.१०६.४ 
भांतिन, न्ह : भौति+संब० । भांतियों, प्रकारों (की) । 'पठई भेट बिदेह बहुत बहु भांतिन्ह ।' जा०म० १२६
भांतिहिं : भौतियों में, से । 'संतोषु सब भाँतिहि कियो ।' मा० १.१०१ छं०
भांती : भौति । मा० १.२८.३
भांवरि : भावरि । पा०म० १३१ 
802 
_______________________________________________
भावरी : भावरी । जा०म०छं० १८
मांवरी : भावरी । गी० १.१०५.३
भा: (१) भूकृ०० (सं० भूत>प्रा. भविअ) । हुआ। 'मन भा संदेहू ।' मा० १.६८.५ (२) सं०स्त्री० (सं.)। प्रभा, आभा, क्रान्ति । 'दसानन आनन भा न निहारो।' हनु० १६
भाइ : भाई । मा० १.२१८ 
भाइन, न्ह : भाइ-+संब० । भाइयों। 'भाइन्ह सहित भरत पुनि आए।' मा० ७.१६.६
भाइहि : (१) भाई में, प्रति । 'भाइहि भाइहि परम समीती ।' मा० १.१५३.७ (२) भाई को । 'भाइहि सौपि मातु सेवकाई ।' मा० २.१९८.४
भाइहु : भाई+संबोधन (अ० भाईहो) । हे भाइयो । 'भाइहु लावहु धोख जनि।' मा० २.१६१
भाइहै : आ०भ०प्रए० (सं० भास्यति>प्रा० भाइहिइ)। रुचेगा, भाएगा। 'दूत बचन मन भाइहै।' गी० ५.३४.३ ।
भाई : (१) भाई+ब० । भाइयों ने । 'मोहि कृतकृत्य कीन्ह दुई भाई ।' मा. १.२८६.६ (२) भक०स्त्री० (सं० भ्रामिता>प्रा० भामिआ) । घुमा कर बनाई, सान पर चढ़ाई, खरादी हुई । गढ़ि गुढ़ि छोलि छालि कुंद की सी भाई बातें ।' कवि० ७.६३
भाई : (१) सं०० (सं० भ्रातृक>प्रा० भाइअ)। सहोदर, बन्धु । मा० १.४६.७ (२) मित्र । 'जग बहु नर सर सरि सम भाई ।' मा० १.८.१३ (३) भूक०स्त्री० (सं० भाता>प्रा० भाया=भाई) अच्छी लगी, रुची । 'प्रस्न उमा के. सिव मन भाई ।' मा० १.१११.६ 
भाउ, ऊ : भाव+कए० (अ.)। 'जानि ईस सम भाउ न दूजा ।' मा० १.३२१.१ ___ 'एहि बिधि रहा जाहि जस भाऊ ।' मा० १.२४२.८
भाएँ : भाव से, समझ से । 'नहिं भलि बात हमारे भाएँ ।' मा० १.६२.८
भाए : (१) भूक.पु० ब० (सं० भात>प्रा० भाइय) । अच्छे लगे, रुचिकर हुए । संभुबचन मुनिमन नहिं भाए ।' मा० १.१२८.२ (२) अभीष्ट । 'मन के भए भाए।' गी० १.६.५
भाखे : आ.प्रए० (सं० भक्षयति>प्रा० भक्खइ) । खाती है । 'सो माया प्रभु सन भय भाखे।' मा० १.२००.४ (भय भाखे =डर खाती है डरती है)।
भाख : भाष (सं० भाषते>प्रा० भासइ) । कहता है। 'आगेहू भी बेद भाख ।' विन० ७६.१
भाग : (१) सं०० (सं.)। अंश, प्राप्य । 'जे पावत मख भाग।' मा० १.६० (२) अङ्ग, पार्श्व, ओर । 'बाम भाग आसनु हर दीन्हा ।' मा० १.१०७.३ _______________________________________________
803 
(३) (सं० भाग्य>प्रा. भग्ग) देव, नियति, अदृष्ट, प्रारब्ध कर्मफल । 'भाग छोट अभिलाषु बड़ ।' मा० १.८ (४) भूक०वि०० (सं० भग्न>प्रा० भग्ग)। पलायित हुआ, भाग खड़ा हुआ । 'सूख हाड़ ले भाग सठ।' मा० १.१२५ 
(५) दे०/भाग। 
/भाग, मागई : आ.प्रए० (सं० भग्नो भवति>प्रा० भग्गइ)। भागता है, दूर जाता है । 'तेहि बिन मोह न भाग ।' दो० १३२ 'सेवत साधु द्वैत भय भाग ।' विन० १३६.११
भागत : वकृ००। पलायन करता-करते । 'भागत भट पटकहिं धरि धरनी।' मा० ६.४७७
भागन : भक० अव्यय । भागने, पलायित होने । 'भय आतुर कपि भागन लागे।' मा० ६.४३.१
भागभाजन : (दे० भाग) भाग्यपात्र, सौभाग्यशाली। 'भूरि भागभाजन भयहु ।' मा० २.७४ 
माहि, ही : आ०प्रब० । पलायन करते हैं। दिसि बिदिसि कहँ कपि भागहीं।' मा०६.८२ छं०
मागा : (१) भाग । अंश । 'कतहं न दीख संभ कर भागा।' मा० १.६३.४ (२) भाग । पलायित । 'प्रगटत दुरत जात मग भागा ।' मा० १.१५७.४ ।
भागि : (१) पू० । भाग कर, पलायन करके । 'भागि पैठ गिरि गुहां गभीरा।' मा० १.१५७.६ (२) आ०-आज्ञा-मए० । तू भाग । 'अभागे भोंड़े भागि रे।' कवि० ५.६ 
भागिनि, नी : वि०स्त्री० । भाग्यवती, भाग्यशालिनी । गी० २.२२.२
भागिहैं : आ०भ०प्रब० । पलायन कर जायेंगे । 'भभरि भागिहैं भाग ।' दो० ७०
भागिहै : आ०म०प्रए० । भाग खड़ा होगा । 'सहित सहाय कलिकाल भीरु भागिहै।' विन० ७०.२
भागी : (१) भागि । पलायन करके । 'चले लोग सब ब्याकुल भागी।' मा० २.८४.४ (२) वि०पू० (सं० भागिन)। प्राप्यांश का अधिकारी पात्र । 'कलिमल रहित सुमंगल भागी।' मा० १.१५.११ (३) भाग्यशाली। 'कोने बड़े भागी के सुकृत परिपाके हैं ।' गी० १.६४.१ (४) (समासान्त में) वि०स्त्री० । भाग्य वाली । 'मानहुं मोहि जानि हत भागी (सं० हत भाग्या)।' मा० ५.१२.६ (५) भूकृ. स्त्री०। पलायन कर गई। धीरता भागी।' मा० १.३३८.५
भागीरथी : संस्त्री० (सं.)। राजा भगीरथ की पुत्री-गङ्गा जी। कवि० ७.१४७ 
804 
_______________________________________________

भाग, गू : भाग+कए। (१) अंश, प्राप्य । 'जिमि ससु चहै भाग अरि भाग ।' मा० १.२६७.१ (२) भाग्य । 'खुलेउ मग लोगन्ह कर भागु ।' मा० २.२२३ (३) प्राप्यांश+भाग्य । 'देइ अभागहि भागु को।' विन० १६१.७ (४) जन्मपत्र में भाग्य का स्वामी ग्रह (नवमेश) । 'भागु भाग तजि भाल थल ।' रा०प्र० ७.५.५
मागें : भागने से । 'भागें भल, ओडेहं भलो।' दो० ४२४
भागे : भूकृ.पुब० । पलायित हुए । 'बाहन सब भागे।' मा० १.६५.४
भागेउ : भूक०कए० । पलायित हुआ । 'भागेउ बिबेकु ।' मा० १.८४ छं०
भाग : भागइ । भाग सकता है । 'हे हरि कवन जतन भ्रम भाग ।' विन० ११६.१
भागो : भाग्यो । 'भागु भागो लोभ लोल को।' कवि० ७.१५
मागौं : आ० उए । पलायन करूं । 'भागो तुरत तजौं यह सैला।' मा० ४.१.५
भाग्य : सं०० (सं.)। प्रारब्ध कर्म, नियति देव । मा० १.३१३
भाग्यवंत : वि.पु. (सं० भाग्यवत् >प्रा० भग्गवंत)। भाग्यशाली। मा० ३.१२.१२
भाग्यो : भागेउ । 'मानो राम रतन ले भाग्यो।' गी० २.१२.३ 
'भाज, भाजइ : आ०प्रए० (सं० भाजयति>प्रा. भज्जइ)। भागइ । 'उपमा कहत लजाइ भारती भाजइ।' जा०म० १४१
भाजत : वकृ०० । भागता-ते । 'भाजत रुदन कराहिं ।' मा० ७.७७ क
भाजन : (१) सं०० (सं०) । पात्र, बर्तन । मा० २.३१०.१; १.३०५.१ (२) पेटारा आदि । 'मुनि पट भूषन भाजन आनी।' मा० २.७६.२ (३) अधिकारी (व्यक्ति) दे० भाग भाजन । भए अजस अध भाजन प्राना ।' मा० २.१४४.५ (४) आश्रय, आधार ।
भाजनु : भाजन+कए । एकमात्र भाजन । 'जो हठि भयउ सकल दुख भाजनु ।' मा० २.४८.३ 
भाजहि, हीं : आ०प्रब० । भागते हैं । मा० ६.६८.७; १.३२४ छं. १
नाजि : पू० । भाग कर । 'रन ते निलज भाजि गृह आवा।' मा० ६.८५.७
भाजी : (१) भाजि । 'चलेउ बराह मरुत गति भाजी।' मा० १.१५७.१ (२) भूकृस्त्री०। भगी, पलायित हुई। 'सबरी के दिए बिन भूख न भाजी।' कवि० ७.६५
भाजे : भूकृ.पु.ब० । भागे । 'हांक सुनत रजनीचर भाजे ।' मा० ६.४७.६ 
भाट, टा : सं०० (सं० भट्ट) । एक स्तुतिपाठक संकर जाति । मा० १.३१६% २१४.१
मात : सं०० (सं० भक्त>प्रा० भत्त)। पका चावल । 'लंक नहिं खात कोरः भात रांध्यो।' कवि०६.४ _______________________________________________
805 
माति : आ०प्रए० (सं.)। प्रतीत होता है । मा० १ श्लोक ६ 
भाथ, था : सं०स्त्री० (सं० भस्त्रा>प्रा० भत्था)। (१) तूणीर, तरकस । मा० १.२५३ (२) तूणीर के साथ का कमरबन्द । 'कटि पट पीत कसे बर भाथा ।' मा० १.२०८.१
माथी : भाथी+ब० । तरकसें । 'भाथीं बांधि चढ़ाइन्हि धनहीं ।' मा० २.१६१.४
भाथी: भाथ । मा० २.६०.४ 
भादव, भादो, दो : सं०० (सं० भाद्रपद>प्रा० भद्दवअ) । वर्षा ऋतु का दूसरा महीना। मा० १.१६; कृ० २६
भान : भान । गी० २.४४.२
मानन : भंजन । 'खल दल बल भानन ।' हनु० २
'माननी : भंजनि । गी० ७.५.४ 
मानस : सं०० (सं० महानस, माहानस) । सूपकार, रसोइया । मा० ३.२६.४
मानि : भंजि । तोड़कर । 'रोक्यो परलोक लोग भारी भ्रम भानि के।' कवि० 
मानि : आ०भ०प्रब० । तोड़ेगे । 'राम''संभु सरासन भानिहैं ।' गी० १.८०.६
मानिहीं : आ०भ०मब० । भङ्ग करोगे। 'सरनागत भय भानिहो ।' विन० २२३.४
मानी : भूकृ०स्त्री । तोड़ी, नष्ट कर दी। सभ के सकति संभ धन भानी।' मा० १.२६२.६
भानु : सं०पु० (सं०) । (१) सूर्य । मा० १.१६.१ (२) किरण । जैसे, हिमभानु । 'भानुकुल भानु को प्रताप भानु-भानु सो।' कवि० ५.२८ (३) सूर्यवत् प्रतापशाली । 'भानुकुल भानु ।'
भानुकर : सूर्य-किरण । मा० १.११७
भानुकुल : सूर्यवंश जिस में राम का जन्म हुआ। मा० २.४१.५
भानुकूलकेतु : सूर्यवंश में पताका के समान सर्वोपरि । कवि० ६.३
भानुजान : सूर्य का रथ (दे० जान) । मा० १.२६६.४ 
भानुप्रताप, पा : एक राजा का नाम । मा० १.१७१.७; १.१६६.३
मानुबंस : भानुकुल । मा० २.२५५.५
भानुमंडल : सूर्य-बिम्ब । गी० ७.१७.३
भानुमंत : सं०+वि.पु. (सं० भानुमत् >प्रा० भाणुमंत)। (१) सूर्य । भूरि भूषन भानुमंत ।' विन० ५६.२ (२) किरणों (भानु) से सम्पन्न, प्रकाशपूर्ण । कवि० ७.१५२
भानू : भानु । मा० २.४१.५ 
806 
_______________________________________________
मान्यो : भूकृ.पु.कए । तोड़ डाला । 'विधातां बड़ो पछु आजुहि भान्यो।' गी० ३.१३.२
भाबी : सं०+वि० (सं० भाविन्) । (१) होनहार, देव, अदृष्ट । 'तसि मति फिरी अहइ जसि भाबी।' मा० २.१७.२ (२) आगामी, भविष्यत् । 'त भयो न भावी।' कृ० १६
भाभी : सं०स्त्री० (सं० भ्रतृ देवी) । भ्रातृपत्नी, अग्रज की पत्नी । कवि० ५.६
भामा : (१) सं० स्त्री० (सं.)। भामिनी, स्त्री (कोपना स्त्री) । (२) पत्नी । 'भवभामा' =शिवपत्नी। मा० १.१००.७ 
भामिनि, नी : संस्त्री० (सं० भामिनी)। (१) कोपशीला स्त्री । 'समुझि धौं जिय भामिनी ।' मा० २.५० छं० (२) पत्नी। 'प्रात बरात चलि हि सुनि भूपति भामिनि ।' जा०म० १६२ (३) स्त्री। 'सब बिधि भामिनि भवन भलाई।' मा० २.६१.४
मामिनों : भामिनी+ब० । स्त्रियाँ । 'चलि ल्याइ सीतहि भामिनीं ।' मा० १.३२२ छं०
भामो : भामा भी स्त्री भी। भइ सुकृतसील भील-भामो।' विन० २२८.३. (भीलभामो-भील स्त्री भी शबरी भी)।
मायें : भाव से । 'रामहि चितव भायें जेहि सीया।' मा० १.२४२.६
माय : (१) भाव । रुचि आदि । 'पागि पागि ढेरी कीन्ही भली भांति भाय सों।' कवि० ५.२४ (२) भाइ । भाई। (३) भाया, अच्छा लगा (सं० भात>प्रा. भाय) । दे० भायउ।
भायउँ : आ०-- भूक००+उए । मैं अच्छा लगा, रुचा । 'देखि दीन प्रभु के मन भायउँ ।' मा० ६.६४.६ 
भायउ, ऊ : भूक००कए० । भाया, रुचा (सं० भातम् >प्रा० भायं>अ०. भायउ) । 'श्री रघुपतिहि यह मत भायऊ ।' मा० ५.६० छं०
भायप : सं० (सं० भ्रातृत्व>अ० भायप्पण) । भ्रातभाव (भाई चारा)। 'भायफ भलि चहुं बंधु की।' मा० १.४२
भायप-भगति : भ्रातृत्वभक्ति (जिसे गोस्वामी जी ने सख्यभक्ति से पृथक महत्त्व दिया है-भरत आदि आश्रय में रामविषयक भ्रातृत्वरति स्थायी भाव है जिसकी भक्तिरस में निष्पत्ति होती है) । 'भायप-भगति भरत आचरन ।' मा० २.२२३.१
भाये : भाए। अभीष्ट (यथारुचि) । 'किये मूढ मन भाये ।' विन० २०१.३
भायो : भायउ। (१) अच्छा लगा, रुचा। रघुपति भक्त जानि मन भायो।' मा०. ६.६४.४ (२) भाया हुआ, मनचाहा । 'भूरि भाग भयो भायो।' गी० ५.१.४ _______________________________________________
807 
भार : सं०० (सं.)। (१) गुरुता, भारीपन । 'बिस्वभार भर अचल छमासी ।' मा० १.३१.१० (२) संकट, क्लेशसमूह । 'हरि भंजन भुबिभार ।' मा० १.१३६ (३) अति मात्रा, प्रचुरता । 'भूस सरीर दुख भार ।' मा० २.१६३ (४) बंधा हुआ बोझ । 'चंदन अगर भार बहु आए।' मा० २.१७०.६ (५) ढोया जाने वाला बोझ (लदान) । 'कांवरि भार ।' मा० २.२७८
भारत : सं०'० (सं०) । (१) भारतवर्ष, भरत खण्ड । 'भलि भारत भूमि ।' कवि० ७.३३ (२) महाभारत-ग्रन्थ । 'रामायन अनुहरत सिख जग भयो भारत रीति ।' दो० ५४६ (३) महाभारत संग्राम । 'भारत में पारथ के रथकेतु हनुमान ।' हनु० ५
भारति : भारती। कवि० १.७
भारती : सं०स्त्री० (सं०) । सरस्वती । मा० १.३४५.६
भारन : भार+सब० । भारों, लदावों (से) | ‘फल भारन नमि बिटप सब ।' मा० ३.४०
भारा : (१) भार । तेहि अवसर भंजन महि भारा।' मा० १.४८.७ (२) वि०पू० (सं० भारित>प्रा० भारिअ) । भारयुक्त, बोझिल । नितनव सोचु सती उर भारा।' मा० १.५६.१
भारि : (१) भारी । भारयुक्त, अधिक । 'बझत छेम-भरोसो भारि के ।' गी० ५.३६.३ (२) पू० । भार डाल कर । 'मन फेरियत कुतर्क कोटि करि कुबल भरोसे भारि ।' कृ० २७
भारिये : (१) भारी ही, बड़ा ही । 'भरोसो तेरो भारिये ।' हनु० २३ (२) बहुत ही। 'देव दुखी देखि अत भारिये ।' हनु० २४
भारी : वि०पू० (सं० भारिन् । बोझिल, अतिशय, अधिक । 'हरहु नाथ मम मति भ्रम भारी।' मा० १.१०८.४ 
भार, रू : भार+कए । (१) बोझ (क्लेशदायक) । भोग रोग सम भूषन भारू ।' मा० २.६५.५ (२) भारी, अतिशय । 'गुहहि भयउ दुख भारु।' मा० २.१८
भारे : वि०पू०ब० (सं० भारित>प्रा० भारिय)। भारी, बड़े, विशाल । 'मारग अगम भूमिधर भारे।' मा० २.६२.६
भारो : भारा+कए० । भारी, अधिक । 'सबै सहमे सुनि साहसु भारो।' कवि० 
भार्गव : सं०पु० (सं.) । भृगुवंशी परशुराम । विन० ५०.४
भाल : सं०० (सं.)। (१) मस्तक । मा० १.१०६ (२) भाग्य (मस्तक रेखा)। __ 'बिधिहू न लिखी कछु भाल भलाई।' कवि० ७.५७ (३) जन्मपत्र में भाग्य का (नवम) स्थान । 'भाग भागु तजि भालथल ।' रा०प्र० ७.५.५
भालहीं : मस्तक पर । 'चंद्रिका जन चंद्रभूषन भालहीं ।' पा०म०/०१ 
808 
_______________________________________________
भाला : भाल । मस्तक, भाग्य । मा० ६.२६.१
भालु : सं०पू० (सं०) रीछ । मा० १.२५.३
भालनाथ : ऋक्षराज जाम्बवान् । गी० ५.१.२
भालुपति : भालुनाथ । मा० ६.६७
भालू : भालु (सं० भल्लूक'>प्रा. भल्लू अ) । रीछ। मा० ६.८१.७
भाले : (सं०) मस्तक पर । मा० २ श्लो० १
भावती : (१) वकृ०स्त्री० (सं० भावयन्ती>प्रा० भावंती)। भावमग्न करती हुई। (२) (सं० भ्रामयन्ती>प्रा० भामंती>अ० भावंती)। घुमा देने वाली। (३) (सं० भामती-भा=किरण>प्रा० भामंती>अ. भावंती)। कान्तियुक्त, रुचिपूर्ण । 'चितवनि ललित भावती जीकी।' मा० १.१४७.३ 
भावरि, री : संस्त्री० (सं० भ्रामरी>प्रा० भामरी>अ. भावरि, भावरी)। प्रदक्षिणा (विशेषतः विवाह में वर-वधू की प्रदक्षिणा) । 'कुवर कुर्वरि कल भावरि देहीं।' मा० १.३२४.१
भावरी : भारी+ब०। भावरें, परिक्रमाएँ। होन लागी भारौं।' मा० १.३२४ छं० ४
भाव : सं०पू० (सं०)। (१) मनोवृत्ति, चित्त व्यापार, चित्तस्तर (जाग्रत्, स्वप्न, सुषप्ति दशाएं)। 'सर्व भाव भज कपट तजि ।' मा० ७.८७ क (२) प्रेम भक्ति । 'भजामि भाव-बल्लभं । मा० ३.४.१६ (३) समर्पण, अनन्य निष्ठा, दढ संकल्प । 'भाव सहित खोजइ जो प्रानी।' मा० ७.१२०.१५ (४) तन्मयता, तदाकारता । 'भाव भगति आनंद अघाने ।' मा० २.१०८.१ (५) सम्बन्ध, सम्बन्धनिष्ठा, सम्बन्धात्मक भक्तिभावना । 'सेवक-सेव्य भाव बिन भव न तरिअ उरगारि ।' मा० ७.११६ क (६) भावना, धारणा । 'बयर भाव सुमिरत मोहि निसिचर ।' मा० ६.४५.४ (७) अनुकृत पदार्थ, नाट्य-काव्यानुकति । 'जथा अनेक बेष धरि नृत्य करइ नट कोइ । सोइ सोइ भाव देखावइ आपुन होइ न सोइ ।' मा० ७.७२ ख (८) भावइ । रुचता है । 'भजनु मोर तेहि भाव न काऊ ।' मा० ५.४४.३ (९) काव्य रस के स्थायी, संचारी तथा सात्त्विक भाव । 'भाव भेद रस भेद अपारा ।' मा० १.६.१० '
भाव, भावइ, ई : (१) आ०प्रए० (सं० भाति>प्रा० भाअइ)। रुचता-ती है। 'दंभिहि नीति कि भावई ।' मा० ७.१०५ ख (२) (सं० भावयति>प्रा० भावइ)। भावमग्न करता-करती है। 'नपति मन भावइ हो।' रान० ५ (३) भावना में आता है । 'भावइ मनहि करहु तुम्ह सोई ।' मा० १.१३७.१
भावगम्य : अनन्य निष्ठा (भक्ति) से प्राप्य, स्वानुभूति मात्र से साध्य। 'भजेऽहं भवानीपति भावगम्यं ।' मा० ७.१०२.१० तुलसो शब्द-कोश 
809 
मावत : वकृ.पु (सं० भावयत् >प्रा० भावंत) । (१) भावविभोर करता-करते। 'एतेहुं पर भावत तुलसी प्रभु ।' कृ० २६ (२) रुचिकर, अभीष्ट । 'मन भावत बर मागउँ स्वामी।' मा० ७.८४.८ 
भावति, ती : वक स्त्री० । (१) रुचती, तन्मय करती। 'भावति हृदय जाति नहि बरनी ।' मा० १.२४३.३ (२) रुचिकर । अभीष्ट । 'मन भावती असीसें पाईं।' मा० १.३०८.६ (३) इष्ट (देवी)। सिय भावती भवानि हैं।' गी० १.८०.३
मावते : भावत+ब। (१) तन्मय करते । 'नख सिख सुभग भावते जी के ।' मा० २.११५.६ (२) भावानुकल, प्रिय । 'भैया भरत भावते के संग ।' गी० २.६६.४
भावतो : भावत+कए। चाहा हुआ, भावान कल । 'सब को भावतो ह्र है।' कवि० १.१२
भावन : वि०० (सं०) । भावमग्नकारी, भावित करने वाला । 'रामचरितमानस मुनि भावन ।' मा० १.३५.६
भावना : संस्त्री० (सं०) भाव । मनोदशा, चित्तवृत्ति, धारणा, निष्ठा । 'जिन्ह के रही भावना जैसी।' मा० १.२४१.४
भावनातीत : वि० (सं.)। भावनाओं से परे, चित्तवृत्तियों द्वारा अगम्य, अतीन्द्रिय (चित्तवृत्ति निरोध से ही साध्य) । विन० ५६.२
भावनी : वि०स्त्री० । भावमग्न करने वाली । 'मुनि मन भावनी ।' गी० ७.१६१
भावनो : भावन+कए । 'कीन्ह बिधि मन भावनो।' पा०म०ई०६
मावप्रिय : वि० (सं.)। जिसे भाव (अनन्य प्रेम) प्रिय हो। 'जान सिरोमनि भावप्रिय ।' मा० १.३३६
भावबल्लभ : भावप्रिय । कवि० ७.१५२
भावसिद्ध : वि० (सं.).। स्वभावसिद्ध, स्वाभाविक । कवि० ७.१४०
भावहिं : मा०प्रब० (सं० भावयन्ति>प्रा० भावंति>अ. भावहिं)। भावमग्न __करते हैं, रुचते हैं । 'मन भावहिं मुख बरनि न जाहीं।' मा० १.३११.८ ।
भावहि : आ०मए० (सं० भावयसि>प्रा० भावसि>अ० भावहि) । भावना करता है, रुचि लेता है । 'काम कथा सुनत श्रवन दै भावहि ।' विन० २३७.३
भावा : (१) भावइ । रुचता है, रुचे। 'करहु जाइ जाकहुं जोइ भावा।' मा० १.२४६.६ (२) रुचती है । 'चोरहि चंदिनि राति न भावा ।' मा० २.११.७ (३) भूकृ०० । रुचा । 'मातु पितहि पुनि यह मत भावा ।' मा० १.७३.२
भाविउ : भावी भी, होनहार भी। 'भाविउ मेटि सकहिं त्रिपुरारी ।' मा० १.७०.५
भावी : भाबी । मा० १.५६.६
भाव : (१) भावइ । भाता है, रुचता है, तृप्त करता है। 'दीन दयालु दिबोई भावे ।' विन० ४.१ (२) रुचे, भावमग्न करे । 'तुलसिदास सो भजन बहाओ जाहि दूसरो भाव ।' कृ० ३३ 
810 
_______________________________________________
भावौं : आ.उए०। रुच सक, भावमग्न करूँ, प्रभावित करूं। 'केहि भांति नाथ मन भावौं ।' विन० १४२.१
भाषत : वकृ०० । कहता। वैरा० ११
भाषउँ : आ० उए० (सं० भाषे>प्रा० भासामि>अ० भासउँ)। कहता हूं। 'संत मत भाषउँ ।' मा० ७.११६.१
भाषा : भाषा में (बोली में), लोकवाणी में । 'भाषां जिन्ह हरि चरित बखाने ।' मा० १.१४.५
भाषा : संस्त्री० (सं.)। (१) उक्ति, कथन, बात । 'होइ न मृषा देवरिषि भाषा ।' मा० १.६८.४ (२) लोक भाषा, बोली, ग्राम जनवाणी। 'भाषा भनिति भोरि मति मोरी।' मा० १.६.४ (३) भूकृ.पु. । कहा । 'भजन प्रभाउ भांति बहु भाषा।' मा० १.१३.२
भाषानिबन्ध : लोकवाणी में रचित प्रबन्धकाव्य । मा० १ श्लो०७
भाषा-बद्ध : वि० (सं.)। लोकवाणी में विरचित (प्रबन्धीकृत) । 'भाषाबद्ध करबि मैं सोई ।' मा० १.३१.२
भाषि : पूकृ० । कह कर । 'चले बिनय बिबिध बिधि भाषि ।' मा० ६.११८ क
माषिहै : आ० भ०प्रए । कहेगा । 'जनु भाषिहै दूसरे दीनन पाहीं।' कवि० ७.६४
भाषी : (१) भाषि । कह कर, वर्णन कर । बिरिदावलि भाषी-फिरे सकल ।' मा० १.३४०.३ (२) शर्त लगा कर, पण करके । 'चला प्रभंजन सुत बल भाषी।' मा० ६.५६.१ (३) भूक०स्त्री० । कही। 'बिनय बहु भाषी।' मा० २.२१६.२ (४) (समासान्त में) । वि.पु । कहने वाला । 'कौशला कुशल कल्याण भाषी।' विन० २७.४
माणे : कहने से । 'सब कर हित''फुट भाष।' मा० २.२५८.३
भाषे : भूकृ००ब० । कहे, वणित किये। 'कामचरित नारद सब भाषे।' मा० १.१२८.७
भाषेउँ : आ.- भूक००+ उए । मैंने कहा। 'नाथ जथामति भाषेउ। मा० ७.१२३ ख
भाषेउ : भूक००कए । कहा । 'सत्य सब भाषेउ।' पा०म० ६४
भाषौं : भाषउँ । कहूं, कहता होऊँ । जौं अनीति कछु भाषौं भाई ।' मा० ७.४३.६
भाष्यो : भाषेउ । बताया, कहा । 'भजन प्रभाउ बिभीषन भाष्यो।' गी० ५.४६.४ _ 
'भास, भासइ : आ०प्रए० (सं० भासते>प्रा० भासइ)। आभासित होता है, अयथार्थ प्रतीत होता है । "रजत सीप महं भास जिमि ।' मा० १.११७
मासा : भूकृ०० (सं० भासित>प्रा० भासिस)। प्रतीत हुआ। 'जोगिन्ह परम तत्त्वमय भासा।' मा० १.२४२.४
मास : भासइ । 'जद्यपि मृषा सत्य भासै ।' विन० १२०.१ _______________________________________________
811 
भास्कर : सं०पू० (सं०) । सूर्य । मा० ३ श्लो० १
मिडिपाल : सं०पू० (सं० भिन्दिपाल)। एक प्रकार का छोटा भाला जो फेंक कर मारा जाता है। मा० ६.४०.७ 
भिखारि, री : वि.पु(सं० भिक्षाकारिन् >प्रा. भिक्खारि, री)। भिक्षुक, भिक्षाटन करने वाला । मा० १.१६०; ३.१७.१५
मिजई : भूक स्त्री० । भिगोयी, सींच दी । 'करुना बारि भूमि भिजई है।' विन. १३६.१०
भितहौं : आ०-भ०उए । भीत होऊँगा, डरूंगा। 'मैं न भित हौं ।' कवि० ७.१०२
भितही : आ०भ०मब० । भीत होओगे, डरोगे। 'जो लघुतहि न भितहो।' विन० २७०.२ 
मिनुसार, रा : सं०पु० (सं० भिन्नोषःकाल>प्रा० भिन्नु साल ?)। प्रभात की लाली फूटने का समय, सबेरा । मा० २.२१५; २.३७.५
भिन्न : भूक०वि० (सं.)। (१) अलग, पथक, विविक्त । 'कहित भिन्न न भिन्न ।' मा० १.१८ (२) काटकर अलग । 'धर तें भिन्न तासु सिर कीन्हा ।' मा० ६.७१.४ (३) विविध । 'भिन्न भिन्न अस्तुति ।' मा० ७.१२ ख (४) अन्य, अन्य प्रकार का । 'लोक लोक प्रति भिन्न बिधाता ।' मा० ७.८१.१
भिन्नमभिन्न : (सं० भिन्नम् +अभिन्न)। पृथक् तथा अपृथक् । पृथक् भासित होकर भी एकरूप । 'रबि आतप भिन्नमभिन्न जथा।' मा० ६.११.१६
भिन्नसेतु : वि० (सं.)। मर्यादा रहित (सेतु-मर्यादा, सीमा); आचारसंहिता की सीमा तोड़े हुए; नियमहीन । 'भिन्न सेतु सब लोग ।' मा० ७.१०० क
मिया : भैया (अरे मेरे भाई)। 'मो पर कीबी तोहि जो करि लेहि भिया रे।" विन० ३३.१
भियो : भूकृ० पु०कए० (सं०
भीत:>प्रा० भीओ)। डरा हुआ। 'सकुचि सहमि सिसु भारी भय भियो है।' कृ. १६
भिरउँ : आ० उए । भिड़ता हूं, संघर्षरत होता हूं। 'जब जब भिरउँ जाइ बरिआईं।' मा० ६.२५.५
भिरत : वकृ०० । भिड़ता-ते, संघर्ष करता-करते । सो अब भिरत काल ज्यों।' मा० ६.६४
मिरहिं : आ०प्रब० । भिड़ते हैं, संघर्ष करते हैं । ‘एक एक सन भिरहिं पचारहिं ।' मा० ६.८१.४
भिरिहि : आ०भ०प्रए । भिड़ेगा, संघर्ष में ठहरेगा। 'मोसन भिरिहि कौन जोधा बद।' मा० ६.२३.१ 
812 
_______________________________________________
भिरे : भूकृ.पु०ब० । भिड़े, गुथ गए। भिरे सकल जोरिहि सन जोरी।' मा० ६.५३.४
मिरेउ : भूकृ.पु०कए । भिड़ा, गुथ गया । 'पुनि फिरि भिरेउ प्रबल हनुमाना।' मा० ६.६५.५
भिल्ल : सं०० (सं.)। भील, वनवासी जातिविशेष । मा० २.२५०.१
मिल्लनि : भिल्ल+संब०। भिल्लों। सुनि कोल-भिल्लनि की गिरा।' मा० . २.२५१ छं० 
भिल्लिनि, नी : भिल्ल+स्त्री० (सं० भिल्ली)। भील स्त्री। 'भिल्लिनि जिमि छाड़न चहति बचनु भयंकर बाज ।' मा० २.२८
भीजति : भीजति ।
भी : सं०स्त्री० (सं.)। भय । 'जो सुमिरत भय भी के।' गी० १.१२.३
'भीख : सं०स्त्री० (सं० भिक्षा>प्रा०भिक्खा>अ० भिक्ख)। भीख मागि भव खाहिं ।' मा० १.७६ 
भोज, भीजइ : आ.प्रए० (सं० भियते>प्रा. भिज्जइ)। भीगता-ती है। जल आदि से ओत-प्रोत होता-होती है। 'तुलसी त्यों-त्यों होगी गरुई ज्यों ज्यों कामरि भीजै ।' कृ० ४६
भीजति : वकृस्त्री० । फूटती, फट रही (उग रही) । 'उठति बयस मसि भीजति ।' गी० २.३७.२
मीज : भीजइ । 'तन राम नयन जल भीज।' गी० ३.१५.३
भीत : (१) भूकृ०वि० (सं.) । डरा हुआ (दे० भयभीत)। (२) भीति । दीवाल । गी० ७.२०.२
भीतर : सं+क्रि०वि० (सं० अभ्यन्तर>प्रा० अभितर>अ० भित्तर) । अन्दर। मा० १.२१
भीता : भूकृ०स्त्री० (सं०) । डरी हुई । मा० १.१८४.६
मीति : (१) सं०स्त्री० (सं०) । भय । ईति भीति जनु प्रजा दुखारी।' मा० २.२३५.३ (२) (सं० भित्ति) दीवाल । 'चहत बारि पर भीति उठावा।' मा० १.७८.५
भीती : भीत पर, दीवाल पर । 'चारु चित्त भीती लिखि लीन्हीं।' मा० १.२३५.३
भीम : वि.+सं०० (सं.)। (१) भयानक, भीषण । मा० १.३२.३ (२) पाण्डवविशेष । 'पाँचहि मारि न सो सके, सयो सँघारे भीम ।' दो० ४२८ (३) शिवजी । कवि० ७.१५१ ।।
भीमता : सं०स्त्री० (सं.)। भयानकता, भीषण कर्म । 'भीमता निरखि कर नयन ढाँके ।' कवि० ६.४५ _______________________________________________
813 
भोमरूप : भयानक आकार-प्रकार वाले। मा० १.१८३.३
भीमा : वि०+संस्त्री. (सं.)। (१) भयदायिनी । (२) दुर्गा जी। 'भीमासि रामासि वामासि ।' विन० १५.३ 
भीर, रा : (१) सं०स्त्री० (प्रा० अभिड>अ० भिड़)। भीड़, अव्यवथित समूह, संमर्द । 'भूप भीर नट मागध भाटा ।' मा० १.२१४.१ (२) संकट, भय । 'कौन भीर जो नीरदहि जेहि लागि रटत बिहंग।' कृ० ५४ (३) वि. (सं० भीरु>प्रा० भीइर) । भयशील, डरपोक । 'सील सनेह न छाडिहि भीरा।' मा० २.७६.३
भीरु : वि० (सं०) । भयशील, प्रस्त, भयभीत । 'जानि जानकी भीरु ।' मा० १.२७०
भील : भिल्ल । कवि० ७.१८
भीलनी : भिल्लिनी। विन० १८३.२
भीलभामो : भील जाति की भामाशबरी भी। (भइ सुकृत-सील भीलभामो।' विन० २२८.३
भीषणाकार : वि० (सं.)। भयानक आकृति (डील-डौल) वाला । विन० ११.१
भीषम : वि० सं०० (सं० भीष्म) । (१) भयानक । (२) महाभारत में शान्तनु के पुत्र देवव्रत । कृ० ६०
भीष्म : सं०० (सं०) । देवव्रत । विन० २८.३
भुपंग : (१) भुजंग (प्रा.) । मा० २.२५ छं० (२) जार, उपपति । 
भुग्रंगिनि, नी : भुअंग+स्त्री० । सपिणी । मा० १.३१.८
भुग : भुअंग+कए । सर्प । 'मनहं दीन मनिहीन भुअंगू।' मा० २.४०.१
भुअन : भुवन । मा० ७.२२.२ 
भुआल, ला : सं०० (सं० भूपाल>प्रा० भूवाल=भूआल)। राजा। मा० १.१६, २.३५.५ 
भुमालु, लू : भुआल+कए । मा० २.३.१; ३७.१
भई : सं०स्त्री० (सं० भूमि) । पृथ्वी । मा० २.२३.५
भुक्ति : सं०स्त्री० (सं.)। विषयभोग, लौकिक सुख । विन० १६.१
भुज : सं०० (सं०) । बाहु । मा० १.८२.५ 
भुजंग, गा : सं०० (सं० भुजंग) । सर्प । मा० १.११२.१; १.६२.३
भुजग : भुजंग (सं०) । मा० १.१०६.८
भूजगराज : (१) सर्पराज, शेषनाग । मा० १.१०६.८ (२) शेषावतार लक्ष्मण जी। विन० ३८.१
भुजगेंद्र : भुजगराज (सं०) । शेषनाग । विन० १३.२ 
भुजदंड, डा : बाहुदण्ड, पुष्ट बाहु । मा० ६.३२.३; १०३.१० 
814 
_______________________________________________

भुजनि, न्हि : भुज+संब० । भुजाओं। 'भुजन्हि समेत सीस महि पारे ।' मा० ६.६२.१०
भुजबल : बाहुबल (युद्ध शक्ति) । मा० १.१३६.६
भुजबलु : भुजबल+कए । एकीभूत बाहुबल । 'नृप भुजबल बिधु सिवधनु राहू ।' मा० १.२५०.१
भुजबल्ली : (सं भुजवल्ली) । लता के समान (कम्पशील) सुकुमार बाहु । 'चालति न भुजबल्ली।' मा० १.३२७ छं० ३
भुजमूले : (सं० पद) बाहुमूल में । गी० ७.१२.५
भुगो : भुजाओं में । 'बीस भुजां दस चाप ।' मा० ६.५१
भुजा : भुज । मा० ६.६८.६
भुबि : भूमि । 'हरि भंजन भुबि भार ।' मा० १.१३६
भुलाई : पू० । भूलकर, भटकर । 'फिरत अहेरें परेउ भुलाई।' मा० १.१५६.६ 
भुलान, ना : भूक० । भ्रान्त, भटका हुआ । 'तव माया बस फिरउँ भुलाना ।' मा० ४.२.६ 
भुलानि, नी : भूकृ०स्त्री० । भटकी, भ्रान्त हुई । 'भूप बिकल मति मोहें भुलानी।'  मा० १.१७३.८
भुलाने : भूकृ०पुब० । भूले, भ्रान्त हुए, मोह में पड़े। 'लच्छन तासु बिलोकि __भुलाने ।' मा० १.१३१.२
भुलाब : भकृ.पु । भूलना, भटकना। 'मिलब हमार भुलाब निज ।' मा० 
भुलावा : भूक पु । भटकाया, भ्रान्त किया। 'जेहिं सूकर होइ नृपहि भुलावा ।' मा० १.१७०.३
भुलाहु : आ०मब० । भूलो, भ्रम में पड़ो । 'जनि आचरज भुलाहु ।' मा० १.३१४
भुव : सं०स्त्री० (सं० ध्रुवी) । भौंहैं । 'नि.संक बंक भुव ।' हनु० १
भुवन : सं०० (सं.)। लोक । (१) स्वर्ग-मर्त्य-पाताल को मिलाकर त्रिभुवन कहे जाते हैं। कृ० ६१ (२) सात ऊर्ध्व-भूः, भुवः, 
स्वः, महः, जनः, तप:, सत्यम् (अथवा-पंशाच, राक्षस, याक्ष, गान्धर्व, ऐन्द्र, सौम्य, प्राजापत्य, ब्राह्म) तथा सात अधोलोक-तल, अतल, वितल, सुतल, तलातल रसातल, पाताल मिलाकर चौदह भुवन । 'भुवन चारिदस भूधर भारी ।' मा० २.१.२
भुवनकोस : (सं० भुवनकोश)। ब्रह्माण्ड, चौदहों भुवनों का समग्र रूप । विन० २५८.२
भवनाभिराम : (१) सम्पूर्ण लोकों में सर्वाधिक सौन्दर्य सम्पन्न । (२) जिसमें सभी लोक सर्वात्मना रमण करते हैं =सर्वाधार, परमेश्वर । विन० ४६.२
भुवनेश : (सं०) सभी लोकों का स्वामी । विन० ३८.१ _______________________________________________
815 
भुवनेस्वर : (सं० भुवनेश्वर) । भुवनेश । मा० ५.३६.१
भुवनकप्रभु : सभी लोकों का एकमात्र स्वामी। विन० ४६.२
भुवनकर्ता : सभी लोकों का एकमात्र धारण-पोषण कर्ता। विन० २६.१
भुवनकभूषण : सभी लोकों को एकमात्र अलंकृत करने वाला = भुवनाभिराम । विन० २६.६
भुवालु : भुआलु । गी० १.४२.४ 
भुसुंड, डा : भुसुंडि । मा० ७.६८.७; ६३.१
भुसुंडि : सं०० (सं० भुशुण्डि) । काक भुशुण्डि जिसने गरुड़ को रामकथा सुनायी ___थी। मा० १.१२० ख
भूख : भूख।
भूखा : भूखा । मा० ५.२२.३
भूजब : भक०० (सं० भोक्तव्य>प्रा० भुजिअव्य)। भोगना (संभव होगा)। ___राजु कि भूजब भरत पुर ।' मा० २.४६ 
भू : (१) सं०स्त्री० (सं०) । पृथ्वी । मा० ६.९१ छं० (२) (सं० भ्रू)। भौंह । ____ बिलोकति पंथ भू पर पानि के ।' गी० ३.१७.३
भूख : सं०स्त्री० (सं० बुभुक्षा>प्रा० भुक्खा) । क्षुधा । 'मन मोदकन्हि कि भूख बुताई।' मा० १.२४६.१
भूखा : (१) भूख । 'सुनहु मातु मोहि अतिसय भूखा।' मा० ५.१७.७ (२) भूकृपु० (सं० बुभुक्षित>प्रा० मुक्खिअ)। क्षुधित, भोग-लालस । 'सुरतरु लहै जनम कर भूखा ।' मा० १.३३५.५
भूखी : भूक०स्त्री० । क्षुधिता । मा० २.५०.३
भूखें : भूखे होने पर। 'प्यासेहूं न पावै बारि, भूखें न चनक चारि ।' कवि० ७.१४८
भूखे : भूकृपु० (सं० बुभुक्षित>प्रा० भुक्खिय)। क्षुधित, भोगेच्छु । 'नाहिन रामु राज के भूखे । मा० २.५०.३ 'माय बाप भूखे को।' विन० ६६.४
भूखो : भूखा+कए० । इच्छुक, लालस । 'भोरो भलो भले भाय को भूखो।' कवि० ७.१५६
भूचर : सं०+वि०० (सं.)। पृथ्वी पर चलने वाले जन्तु (खेचर तथा जलचर का विलोम)। विन० ११.६
भूत : सं०० (सं.)। (१) पिशाच-सदृश नीच देवविशेष । 'प्रेत पिसाच भूत बेताला ।' मा० १.८५.६ (२) प्राणी, जीव । 'भूत द्रोह रत मोह बस ।' मा० ६.७८ (३) जड़-चेतन । विश्व, चराचर । 'प्रसीद प्रभो सर्व-भूताधिवासं ।' मा० ७.१०८.१४ (४) पञ्च महाभूत-पृथ्वी, जल, तेज, वायु और आकाश 
816 
_______________________________________________
(५) (समासान्त में) वि० । अभिन्न, तत्स्वरूप, एकरूप । 'पद-द्वंद्व मंदाकिनी 
मूलभूतं ।' विन० ४६.५
भूतगन : प्रेत-पिशाच सदृश शक्तियों का समूह । 'भजहिं भूतगन घोर ।' मा० २.१६७
भूतजनित : भूत-प्रेत आदि से उत्पन्न । 'व्याधि भूतजनित।' हनु० ४३
भूत-द्रोह : प्राणियों के प्रति वैरभाव । 'भूत-द्रोह तिष्टइ नहिं सोई।' मा० ५.३८.७
भूतनाथ : (१) सं०० (सं.)। सभी जीवों (चराचर) के स्वामी शिव जी । कवि० ७.१५२ (२) शिवावतार-हनुमान । हनु० ४३
भूतनि : भूत+संब० । भूतों प्राणियों (चराचर द्रव्यों) । 'भूतनि की आपनी पराये की।' हनु० ३७
भूतभव : वि०पु० (सं०) पञ्च भूतों तथा जीवों की उत्पत्ति के कारण । कवि० ७.१६८
भूतमय : वि०पू० (सं.)। सभी जीवों तथा चराचर में व्याप्त =अन्तर्यामी। ___ 'ईस्वर सर्ब-भूतमय अहई ।' मा० ७.११०.१५
भूतल : सं०० (सं.)। पृथ्वी मण्डल । मा० १.१
भूता : भूत । पिशाचादिसदश । 'परिजन जनु भूता।' मा० २.८३.७
भूति : संस्त्री० (सं.)। (१) विभूति, ऐश्वर्य, वैभव । (२) अष्ट सिद्धियाँ अणिमा, महिमा, लघिमा, गरिमा, प्राप्ति, प्राकाम्य, ईशित्व और वशित्व । 'मति कीरति गति भूति भलाई ।' मा० १.३.५ (३) भस्म, राख । 'भुजग भूति भूषन त्रिपुरारी।' मा० १.१०६.८ ।।
भूतिभूषन : भस्मरूप अलंकार वाले शिव । कवि० ७.१५२
भूतिमय : वि० (सं०) ऐश्वर्य सम्पन्न+पिद्धियों से युक्त । 'कीरति सुगति भूतिमय बेनी ।' मा० २.३०६.४
भूधर : (१) सं०० (सं.)। पर्वत (पृथ्वी को धारण करने, संभालने वाला)। मा० ६.५३.३ (२) शेषनाग+शेषावतार लक्ष्मण । विन० ३८.१ (३) पृथ्वी पालक । मा० ७.३४.४
भूधरण : भूधर (गोवर्धन पर्वत) । 'भूमि उद्धरण, भूधरणधारी ।' विन० ५६.२
भूधरसुता : पार्वती । मा० २ श्लोक १
भूधराकार : पर्वताकार, पहाड़ जैसी आकृति वाला (विशाल)। कनक-भूधराकार सरीरा।' मा० ५.१६.८
भूधराधिप : पर्वतराज = हिमालय (कैलास) । विन० ११.४
भूनंदिनी : भूमिपुत्री-सोता । विन० २५.५ _______________________________________________
817 
भूनाथ : पृथ्वी के स्वामी सर्वेश्वर । विन० ५५.६
भूपं : राजा ने । 'भूपं प्रतीति तोरि किमि कीन्ही ।' मा० २.१६२.३
भूप : सं०० (सं०) । राजा। मा० १.१३०.८
भूपतहि : भूपता (राजस्व) को, राजा होने को। 'चहत न भरत भूपतहि भोरें।' ___मा० २.३६.१
भूपति : भूप । पृथ्वी का स्वामी राजा । मा० १.१३०
भूपतिमान : राजाओं में शिरोमणि । श्रेष्ठ राजा । मा० १.३३०.२
भूपनि : भूप+संब० । राजाओं। 'भले भूप कहत भलें भदेस भूपनि सों।' कवि० 
भूपबर : राजाओं में श्रेष्ठ; श्रेष्ठ राजा । मा० ७.५१.६'
भूपमनि : भूपतिमनि । मा० १.३५३.६
भूपरूप : राजारूपी । 'ढाहत भपरूप तरु मूला।' मा० २.३४.४
भूपसुत : राजकुमार । मा० ३.२३.६
भूपा : भूप । मा० १.१४१.२ 
भूपाल, ला : सं०पू० (सं०) । राजा। मा० २.५८; ५.३६.१
भूपावली : राजसमुदाय । विन० १८.५
भूपु : भूप+कए । अद्वितीय राजा । 'पछिले पहर भुपु नित जागा। मा० २.३८.१
भूमार : पृथ्वी का भार (क्लेश) । विन० ३८.१
भूभुरि : सं०स्त्री० (सं० भुर्भुरी = बालूसाही>प्रा० भुन्भुरी>अ० भुन्भुरि)। (अवधी में) धूप से तचती बालू । 'अरु पाय पखारिहौं भूभरि डाढ़े।' कवि० २.१२
भूमि : सं०स्त्री० (सं०) । पृथ्वी । मा० १.१७.७
भूमिजा : पृथ्वीपुत्री=सीताजी। विन० २६.४
भूमिजारमण : सीतापति = राम । विन० ३६.१
भूमितल : भूतल । मा० २.१४८.५
भूमिधर : (१) भूधर । पर्वत । 'मारग अगम भूमिधर भारे।' मा० २.६२.६ (२) पृथ्वी के धारणकर्ता, रक्षक । कवि० ७.१५२
भूमिधरनि : भूमिधर-+संब० । पर्वतों । 'भूमि के हरैया, उखरैया भूमिधरनि के।' गी० १.८५.३
भूमिनागु : भूमिनाग (सं.) कए । भूनाग--एक प्रकार का विषहीन सर्प; मटिहा साँप ; केंचुए जसा सर्पविशेष । 'भमिनागु सिर धरइ कि धरनी।' मा० १.३५५.६
भूमिपति : भूपति । मा० २.७६.८ 
818 
_______________________________________________
भूमिपाल : भूपाल । कवि० १.१०
भूमिभार : भूभार । विन० ६४.५
भूमि-सुर : भूसुर । ब्राह्मण । मा० २.१७०
भूरि : वि० (सं०) । (१) अधिक, प्रचुर। 'भूतल भूरि निधान ।' मा० १.१ (२) अतिशय, अत्यन्त । 'भूरि भागभाजन ।' मा० २.७४
भरिमाग : अधिक भाग्यशाली। 'भूरिभाग दसरथ सम नाहीं।' मा० २.२.४
भरिमागिनी : अत्यन्त भाग्यशालिनी (स्त्री)। गी० २.२२.२
भूरिभागी : अत्यन्त भाग्यशाली । 'आपु हैं अभागी, भरिभागी डाटियतु है ।' कवि० ७.६४
भूरिभोग : अत्यधिक आयाम वाला (भोग =आभोग-विस्तार); व्यापक शिव । कवि० ७.१५२
भूरी : भूरि । मा० १.४२.१
भूरुह : सं०पू० (सं०) । पृथ्वी में उगने वाला=वृक्ष । विन० १५२.१३
भूर्ज : सं०० (सं.)। भोजपत्र का वृक्ष जिसकी छाल का कागज के लिए उपयोग होता था । मा० ७.१२१.१६ 
भल, भूलइ : आ०प्र० (सं० भोल-मुग्ध+माधा०>प्रा० भुल्ल)। भ्रान्त होता है, विस्मृत होता है, सुध बुध खोता है, मोहित हो जाता है । 'मनु बिरंचि कर भूल ।' मा० १.२८७
भूलत : वकृ०० । भूलता-ते । हनु० २८
भूलहिं : आ०प्रब० (अ० भुल्लहि) । भटक जाते हैं, भ्रम में पड़ते हैं, चूक जाते हैं ।  'भूलहिं मूढ़ न चतुर नर ।' मा० १.१६१ ख भूल
हि : आ०मए० (प्रा० भुल्लहि) । तू मोह में पड़ । 'भूलहि जनि भरम ।' विन० १३१.३
भूला : भूकृ००। (१) भ्रान्त हुआ। 'निरखि राम मन भवरु न भूला।' मा० २.५३.४ (२) विस्मृत हुआ । 'माउँ गाउँ कर भूला रे ।' विन० १८६.५
भूलि : (१) पूकृ० । भूल कर । 'भूलि न देहिं कुमारग पाऊ।' मा० ३.५६.६ (२) भुल्लहि (अ० भुल्लि) । 'धुआं कैसो धौरहर देखि तू न भूलि रे ।' विन० ६६.४
भूलिहु : आ०-भूकृ० स्त्री०+मब० । तुम भ्रम में पड़ गयी हो । 'भल भूलिहु खल के बौराएं ।' मा० १.७९.७ । 
भूलिहुं, हु, हूँ, हू : भूल कर भी । 'भयो न भूलिहू भलो।' विन० २६१.२
भूली : (१) भूलि । भूल कर । 'सो दिसि तेहिं न विलोकी भूली।' मा० १.१३५.१ (२) भूक० स्त्री० । विस्मृत हुई। 'अति अभिमान त्रास सब भूली।' मा० ६.३८.२ _______________________________________________
819 
'भूलें : भूलने से, भटकने पर । 'रबिहि न दोसु देव दिसि भूलें।' मा० २.२६७.३ 
भूले : भूक००व० । भ्रान्त हुए, सुध बुध खोये हुए । 'गुजत मंजु मधुप रस भूले ।' मा० २.१२४.७
भलेहुं : भूल से भी । 'भूले हुं संगति करिअ न काऊ ।' मा० ७.३६.१
भूल्यो : भूकृ००कए० । भूला, विस्मृत हो गया । विन० १४३.२ 
"भूष, भूषह : आ.प्रए० (सं० भषयति>प्रा. भसइ) । अलंकृत करता है, सजाता है । 'ससिहि भूष अहि लोभ अमी के ।' मा० १.३२५.६
भूषन : सं+वि.पु० (सं० भूषण) । (१) अलंकार, आभरण । मा० १.१४७.६ (२) अलंकृत करने वाला, श्रेष्ठ । 'तिय-भूषन ।' मा० १.१६.७ (३) (समासान्त में) भूषण वाला । 'भुज ग-भूति-भूषन ।' मा० १.१०६.८ (४) विभूषित करने वाला अङ्ग । 'किय भूषन तिय भूषन ती को।' मा० १.१६.७ (५) काव्य में शब्दालंकार तथा अर्थालंकार-दे० बिभूषन ।
भूषनधारी : वि० । आभूषण धारण करने वाला-वाले । मा० १.८.१०
भूषन-विभाग : अङ्गानुरूप अलंकारों की विभक्त रचना । गी० २.४४.४ भूषन
भूषन : आभूषणों को भी अलंकृत करने वाला-वाले । 'ब्याह बिभूषन भूषित भूषन-भूषन ।' जा०म० १२४
भूषिअत : वकृ००कवा० । अलंकृत किये जाते । 'सुतिय सुभूपति भूषिअत ।' दो० 
भूषित : भूकृ०वि० (सं.)। अलंकृत, सुसज्जित । मा० १.६.७
भूसुर : सं०० (सं०) । पृथ्वी का देव = ब्राह्मण । मा० १.२१४
भुंग : सं०० (सं०) । (१) भ्रमर । 'गुजत भृग ।' मा० २.२४६ (२) एक प्रकार का पतिंगा जो कीड़े को अपनी ध्वनि से अपने ही आकार का करने वाला बताया गया है। 'भइ मम कीट भग की नाई ।' मा० ३.२५.७
भृगनि : भृग+संब० । भ्रमरों (से)। ‘सेबित सुर मुनि भृगनि ।' गी० २.५७.३
भंगा : भग । मा० १.१२६.२
भगिहि : भङ्गी (शिवगण विशेष) को। मा० १.९३.४ 
भृकुटि, टी : संस्त्री० (सं.)। भौं, भों की वक्रता। मा० १.१४७.४; २४२.५
भृकुटी : भृकुटी+ब० । भौंहैं । 'चले भृकुटीं।' कवि० २.२६
भृगु : सं०० (सं.)। ब्रह्मा के पुत्र ऋषि विशेष । मा० १.६४
भगुकुल : भगु ऋषि का वंश जिसमें परशुराम हुए थे। मा० १.२६८.२ भगाल
केतू : भगु वंश में पताकावत् सर्वोत्तम । परशुराम । मा० १.२७१.८ 
820 
तुलसी शब्द-कोशः 
भृगचरन : भृगु ऋषि का चरणचिह्न। विन० ६२.६ कहा जाता है विष्णु की परीक्षा हेतु क्रोध करके भगु ने वक्ष पर चरण प्रहार किया था जिसका चिह्न भगवान् अपने उरस्थल पर सदा रखते हैं।
भृगुतिलक : भृगुवंश में श्रेष्ठ । परशराम । कवि० १.१६
भृगुनाथ : परशुराम । मा० १.२८३
भृगुनायक : परशुराम । मा० १.२६३.१
भृगपति : परशुराम । मा० १.२८२
भृगुपद : भगुचरन । गी० ७.१६.४ भृगुवंश
मनि : भृगुकुल में श्रेष्ठ परशुराम । मा० १.२७३
भृगबर : परशुराम । मा० १.२७६
भृगुमुख्य : भृगुवंश के मुख्य पुरुष परशुराम । हनु० ३
भृगसुत : भृगुवंश की संतति परशुराम । मा० १.२७३.५
भत्य : सं०० (सं.)। दास, परिचारक । गी० १.३८.४
भेंट : सं०स्त्री० । (१) मिलन । 'मोहि तोहि भेंट भूप दिन तीजें ।' मा० १.१६६.७. (२) उपहार । 'हरषि भेंट हित भूप पठाई।' मा० १.३०५.३ (३) उपहार सामग्री। 'भेंट संजोवन लागे ।' मा० २.१९३.२ (४) आ.प्रए० = भेंट इ । मिलता है, भेंटता है, लिपटता है। 'कनक तरुहि जनु भेंट तमाला ।' मा० ३.१०.२३
भेटत : वकृ.पु । मिलता-ते; आलिङ्गन करता-ते । 'ते भरतहि भेटत सनमाने।" मा० १.२६.८
भेंटति : वकृस्त्री० । लिपटती । 'भेंटति अति अनुराग ।' मा० २.२४६
भेंटलगाऊ : भेंट लगाने वाला साथियों से मिलाने वाला; राह बताने वाला है। विन० १८६.४
भेंटहि : आ०प्रब० । मिलते हैं, लिपटले-ती हैं । मा० १.३३७.६
भेटह : आ०मब । मिलो । 'सबहि जिअत जेहिं भेंटहु आई।' मा० २.५७.३
भेंटा : भकृ०० । लिपटाया । 'रामसखा रिषि बरबस भेंटा ।' मा० २.२४३.६
भेटि : पू० । लिपट कर । 'बार बार मिलि भेंटि सिय बिदा कोन्हि सनमानि ।' मा० २.२८७
भेंटी : भक०स्त्री०ब० । लिपट गयीं, लिपट कर मिलीं। 'करि प्रनाम भेंटी सब सासू ।' मा० २.३२०.२
भेंटी : भक स्त्री० । मिलने द्वारा सम्मानित की। प्रथम राम भेंटी कैकेयी।' मा० २.२४४.७
भेंट : आ०-आज्ञा-मए । तू लिपट कर मिल । 'अब भरि अंक भेंट मोहिः भाई।' मा० ६.६३.७