_______________________________________________
421 
तु : अवधारणार्थक अव्यय (सं.)। तो । 'न तु कामी बिषया बस.........। मा०  ७.११५ क 'तो तु देहिं कबि खोरि ।' दो० ३१७
तुंग : वि० (सं.)। उत्तुङ्ग, ऊँचा । मा० ३.१०१ छं० १
तुड : सं०० (सं.)। (१) नासिका । (२) चोंच । 'सुक तुंड बिनिंदक सुभग  सुउन्नत नासा ।' गी० ७.१२.७ (३) मुख । 'सारद ससि सम तुड ।' गो.  ७.१६.४
तुंबरि : सं०स्त्री० (सं० तुम्बी>अ० तु बडी) । लौकी । मा० १.११३.४ तुअ,
व : तव (प्रा.) । तेरा, तेरी, तेरे । मा० २.२१
तुपक : सं० स्त्री० । तोप । दो० ५१५
तुभ्यं : सर्वनाम (सं०) । तुझको, तेरे लिए । मा० ७.१०८ छं० १५
तुम : तुम्ह। मा० १.५६.३
तुम्ह : सर्वनाम (सं० युष्मद्>प्रा० तुम्ह) । तुम । मा० १.४६
तुम्हा : तुम ही, तुम्ही । 'जानत तुम्हहि तुम्हइ होइ जाई।' मा० २.१२७३
तुम्हउ : तुम भी, तुमको भी। 'हमरें बयर तुम्हउ बिसराई ।' मा० १.६२.२
तुम्हरिहि : तुम्हारी ही । मा० २.१२७.४
तुम्हरी : तुम्हारी..'के । 'है तुम्हरी सेवा बस राऊ ।' मा० २.२१.८
तुम्हरी : तुम्हारी । मा० १.१४.११
तुम्हरें : तुम्हारे में, से । 'भरत भगति तुम्हरें मन आई।' मा० २.२६६.२
तुम्हरे : तुम्हारे । 'तुम्हरे हृदय होइ संदेहू ।' मा० २.५६.६
तुम्हरेई : तुम्हारे ही । 'तुम्हरेई भजन प्रभाव ।' मा० ३.१३.५
तुम्हरेहिं : तुम्हरेई । मा० २.७५.३
तुम्हरो : तुम्हारो। तुम्हारा । कवि० ७.४१ तुम्हहि,
ही : तुमको । 'जानत तुम्हहि तुम्हइ होइ जाई ।' मा० २.१२७.३ तुम्हहि,
हीं : तुम्हीं, केवल तुम । तुम्हहु, हूं, हु,
हू : तुम भी । 'तुम्हहू तात कहहु अब जाना।' मा० ५.२७.७ तुम्हार,
रा : (सं० युष्मदीय>अ० तुम्हार) मा० १.७७.६, ४६.३ तुम्हारि,
री : मा० १.४७.३
तुम्हारें : तुम्हरें । तुम्हारे लिए। 'सब बिधि सोइ करतब्य तुम्हारे ।' मा० २.९६.२
तुम्हारे : मा० १.१४६.३
तुम्हारो : तुम्हारा+कए० । मा० ६.१०६ छं०
तुम्हें : तुम्हारे । 'तुम्हें विद्यमान'' कपि रोप्यो पाउ ।' कवि० ६.२२
तम्है : तुम्हीं। 'परिनाम तुम्है पछितैहो ।' कवि० ७.१०२
तरंग : सं०० (सं०) । अश्व । मा० २.१४३ 
422 
_______________________________________________
सुरंगनि : तुरंग+सब० । घोड़ों (को)। 'चुचकारि तुरंगनि सादर जाइ जोहारे ।'  गी० १.४६.१
तुरंगा : तुरंग। मा० १.३१६.५
तुरंत : वि०+क्रि०वि० (सं० त्वरमाण>प्रा० तुरंत) । द्रुत गति लेता हुआ - (शीघ्र) । 'जहउँ नाथ तुरंत ।' मा० ६.६० क 
तुरंता : तुरंत । मा० ५.१.७ ।।
तुरग : तुरंग (सं०) । मा० २.१८७.४
तुरगा : तुरग । मा० ६.६२.१
तुरत : तुरंत; तुरित । तुरत कपिन्ह कहुं आयसु दीन्हा ।' मा० ५ ३४.७
तुरतहिं : जीघ्र ही । तत्काल ही। तासु कपटु कपि तुरतहिं चीन्हा ।' मा० ५.३.४
तुरा : सं०स्त्री० (सं० त्वरा) । अति शीघ्रता, अति वेग । कवि० ६.५४
तुराई : तुराई+ब० । तुलाइयाँ, गद्दे, दुलाइयाँ । 'बिविध बसन उपधान तुराईं ।'  मा० २.६१.१
तराई : सं०स्त्री० (सं० तूलिका) । रुई का गद्दा-दुलाई आदि। मा० २.१४.६
तरित : क्रि०वि० (सं० त्वरित) । शीघ्र, तत्काल । 'तुरित गयउ कपि राम पहिं ।  मा० ७.२ ख
तुरीय : सं०+ वि० (सं०) (१) चतुर्थ । (२) चेतन की चतुर्थ दशा जो तीन  अवस्थाओं.---जाग्रत, स्वप्न और सुषप्ति-से परे अन्तर्यामी अवस्था होती है और जो ब्रह्म का ही सूक्ष्म रूप है-दे० 'तीनि अवस्था ।' 'तूल तुरीय सँवारी  पुनि ।' मा० ७.११७ ग
तुरीयमेव : (सं०) चतुर्थदशामात्र (ब्रह्म) । मा० ३.४.६
तुलसि : तुलसी । क्षुपविशेष । मा० १.३४६५
तुलसिका : तुलसी (सं०)। (१) क्षुपविशेष । 'उरन्हि तुलसिका माल ।' मा०  १.२४३ (२) जालन्धर असुर की पत्नी जो तुलसीक्षुप के रूप में अवतीर्ण मानी  गयी है । 'अजहुं तुलसिका हरिहि प्रिय ।' मा० ३.५ क
तुलसिदास : तुलसीदास । मा० १.१६६
तुलसी : तुलसीदास ने । 'तुलसी लख्यो राम सुभाउ तिहारो।' कवि० ७.३
तुरूसी : सं०स्त्री० (सं०) । (१) तुलसी नामक पूछ्य क्षुपविशेष । 'जो सुमिरत  भयो भांग ते तुलसी तुलसीदासु ।' मा० १.२६ (२) जालन्ध की पत्नी जो तुलसी वृक्ष होकर अवतीर्ण हुई जब विष्णु ने उसका सतीत्व भङ्ग कर जालंधर को मारा; उसके सतीत्व के कारण विष्णु ने उसे अङ्गीकार किया। 'रामहिं प्रिय पावनि तुलसी-सी ।' मा० १.३१.१२ (३) तुलसीदास कवि । मा०.  १.१० छं०  सुलसी शब्द-कोश 
423 
तुलसीक : तुलसीदास के लिए । 'ती नीको तुलसीक ।' मा० १.२६ ख
तुलसीदास : कवि का नाम । मा० १.२८ख
तुलसीदासु : तुलसीदास+कए । मा० १.२६
तुलसीस : (सं० तुलसीश) तुलसीदास के स्वामी राम । मा० १.३३६ छं.
तलसीस्वरी : (सं० तलसीश्वरी) तलसीदास की आराध्या-सीता। कवि० ६.२
तुला : तुला पर, तराजू पर (उपमा में) । 'भले सुकृती के संग मोहि तुला तौलिए।'  कवि० ७.७१
तुला : सं०स्त्री० (सं०) । (१) उपमा--जिसके उपमान और उपमेय दो मुख्य  अङ्ग होते हैं । (२) तराज-जिसके अङ्ग दो पल्ले होते हैं । 'धरिअ तुला एक  अंग ।' मा० ५.४
तष : सं०० (सं.)। भूली, छिलका । दो० ३०३
तुषार : सं०० (सं०) । पाला, हिम (बर्फ)। मा० ६.११५.५ (२) ओस ।
तुषाराद्रि : सं०० (सं०) । हिमालय । मा० ७.१०८.३
तुषारु : तुषार+कए । ओस । 'मनहुं मरकत मृदु सिखर पर लसत बिसद  तुषार ।' क० १४
तुसार : तुषार । मा० २.१६३ तुसारु,
रू : तुषार । पाला । 'मनहुं कमल बन परेउ तुषारू ।' मा० २.२६३.२
तुहिन : सं०० (सं०) । तुषार, पाला, हिम । मा० २.७१.८
तुहिनगिरि : हिमाचल । मा० १.६७
तुहिनाचल : हिमाचल । मा० १.६४.६
तुही : तू ही। 'राम गुलाम तुही हनुमान ।' हनु० ३६
तहूं : तू भी । 'तुहूं सराहसि करसि सनेहू ।' मा० २.३२.७
तूं : मध्यम पुरुषीय सर्वनाम (सं० त्वम् >प्रा० तुं)। तू । 'जननी तू जननी भई ।'  मा० २.१६१
तू : तूं (फा०) । मा० २.१६२.७
तूठनि : स०स्त्री० । तुष्ट (प्रसन्न) होने की क्रिया । रूठनि तूठनि किलकनि ।'  गी० १.३०.३ तू
ठहि : आप्रब । सन्तुष्ट होते हैं । 'तूठहिं निज रुचि काज करि ।' दो० ४७६
तूणीर : संपु० (सं०) । निषङ्ग, तरकस । मा० ३ श्लोक २
तून : तूणीर । (सं० तूण) । मा० १.२६८.८
तूनीर : तूणीर । मा० १.२४४.१
तूनीरा : तूनीर । मा० २.११५.८ 
424 
_______________________________________________
तूर : सं०० (सं० तूर्य) । वाद्य, वाद्यविशेष तुड़हो । 'पाछे लागे बाजत निसान ___ढोल तूर हैं।' कवि० ५.३ 
तूरना : तुर । 'डोल लोल बुझत सबद ढोल तूरना।' कवि० ७.१४८
तूरी : पू० । तोड़कर । 'मन तन बचन तजे तिन तूरी ।' मा० २.३२४.५
तूल : (१) सं००+ स्त्री. (सं०) । रूई। मा० ७.११७ ग (२) वि० (सं० __तुल्य>प्रा० तुल्ल) । समान, सदृश । 'तून न तासु सकल मिलि ।' मा० ५.४
तूला : तूल। (१) रूई । 'जासु नाम पावक अघतुला ।' मा० २.२४६.२ (२) तुल्य।  दे० समतुला । मा० १.११३.४
तृन : तिन । तिनका, घास । मा० १.१६७.७ (२) पापी से बात करने में तिनके  का व्यवधान करके बात करने की परम्परा रही है दे० दूतवाक्यम् (भासकृत व्यायोग) श्लोक ३५
वासुदेव:---भोः कुरुकुलकलङ्कभूत अयशोलुब्ध  वयं किल तृणान्तराभि भाषकाः । दुर्योधनः-भो गोपालक तृणान्तराभि भाष्यो भवान्  अवध्यां प्रमदां हत्वा हयं गोवृषमेव च ।  मल्लानपि सुनिलज्जिो वक्तुमिच्छसि साधुभिः ॥३६॥ अतएव गोस्वामी जी का वचन है  तन धरि ओट कहति बैदेही । मा० ५
तनासन : (१) (सं० तृणासन) तिनकों का आसन । (२) (सं० तृणाशन) घास 
का भोजन=सागपात । 'बार कोटि सिर काटि साटि लटि रावन संकर 4 लई । सोइ लंका लखि अतिथि अनवसर राम तनासन ज्यों दई।' गी० 
५.३८.३
तृनु : तृन+कए । घास की एक पत्ती। 'देह गेह सब सन तनु तोरें।' मा०  २.७०.६
तृपित : भूकृ०वि० (सं० तृप्त) । सन्तुष्ट, पूर्णकाम । मा० २.२६०
तृपिति : तृप्ति । मा० ७.११६.६
तृप्ति : सं०स्त्री० (सं०) । तुष्टि, अघाव, इच्छापूर्ति । 'तप्ति न मानहिं मन  सतरूपा।' मा० १.१४८.६
तृषा : सं०स्त्री० (सं०) । प्यास । मा० ४.१७.५
तषावंत : वि.पु. (सं० तृषावत्) प्यासा । मा० ७.२.६
तषित : वि० (सं०)। प्यासा। तृषित बारि बिन जो तन त्यागा।' मा०  १.२६१.२
तृस्ना : तृष्णा ने । 'तृस्ना केहि न कीन्ह बौराहा ।' मा० ७.७०.८ 
_______________________________________________
425 
तस्ना : सं०स्त्री० (सं० तृष्णा)। (१) तृषा, प्यास । (२) दृढ़ इच्छा, तीव्र  लालसा । 'तस्ना उदरबृद्धि अति भारी।' मा० ७.१२१.३६
तें: अव्यय (सं० तेन>प्रा० तेण>अ० तें) । से। तेहि तें कछु गुन दोष बखाने ।'  मा० १.६.२
ते : (१) तें। से। 'अजहि मसक ते हीन ।' मा० ७.१२२ ख (२) हुते। थे। 'तिन्ह  के काज साधु समाजु तजि कृपासिंधु उठि गे ते।' विन० २४१.३ (३) प्रथम पुरुषीय सर्वनाम (सं० ते)। वे। 'ते बर पुरुष बहुत जग नाहीं।' मा० १.८.१२ (४) मध्यम पुरुष सर्वनाम (सं० ते) । तुझे, तेरे लिए। 'राम नमामि ते।'  मा० ७.१३० छं०१
तेई : उसने । 'एक मास तेइ जात न जाना।' मा० १.१६५.८ तेइ,
ई : वे ही। तेइ रघुनंदन लखन सिय ।' मा० २.२६२ ‘भए उपल बोहित सम  तेई। मा० ६.३.८ तेउ,
ऊ : वे भो । 'परम कौतुकी तेउ ।' मा० १.१३३ 'बेष प्रताप पूजिअहिं तेऊ ।'  मा० १.७.५
तेज : सं०० (सं० तेजस्) । (१) आतप (धाम) (२) ओज (आभा आदि)।  'बिन तप तेज कि कर बिस्तारा ।' मा० ७६०.५
तेजवंत : वि०पु । तेजस्वी, प्रतापी । 'तेजवंत लघु गनिअ न रानी।' मा०  १.२५६.६
तेजसी : वि.पु. (सं० तेजस्वी)। प्रतापी, प्रभावशाली । मा० १.१७०
तेजहत : वि० (सं० तेजोहत)। प्रताप से रहित, निठप्रभ, प्रभावहीन । मा०  ६.३५.४०
तेजायतन : (तेज+आयतन) । प्रतापागार, प्रभावशाली। विन० ४६१
तेजी : वि०स्त्री० (फा० तेज) । महँगी । 'तेजी माटी मगहू की मृगमद साथ जू ।'  कदि० ७.१६
तेजु : तेज+कए । एकमात्र प्रताप । 'दुरे नखत जग तेजु प्रकासा ।' मा०  १.२३६.४
तेते : वि.पुं०ब० । (सं० तावत् >प्रा० तेत्तिअ)। उतने । 'कहि न सकहिं सारद  श्रुति तेते ।' मा० ३.४६.८
तेन्ह : तिन्ह । ग्तेन्ह कर मरन एक बिधि होई ।' मा० १.१८१.७
तेपि : (सं.) वे भी । तेपि कामबस भए बियोगी।' मा० १.८५.८
तेरसि : सं+वि०स्त्री० (सं० त्रयोदशी>प्रा० तेरसी)। (१) तेरहवीं (२) पक्ष  की तेरहवीं तिथि ।' विन० २०३.१४
तेरहति : संस्त्री० । जनक देश, मिथिला । मा० २.२७१ 
426 
_______________________________________________
तेरहूति : तेरहुति । मा० २.२६२.८
तेरिये : तेरी ही । 'अवलंब मेरे तेरिये ।' हन० ३४
तेरी : सार्वनामिक वि० (स्त्री०)। हन० २८
तेरे : वि.पु । 'सहेउँ कठोर बचन सठ तेरे।' मा० ६.३०.४
तेरेउ : तेरे भी । 'कलि तेरेउ मन गुन गन कीले ।' विन० ३२.२
तेरो : वि.पु.कए । तेरा। हनु० २३
तेल : सं०० (सं० तैल>प्रा० तेल्ल) । मा० २.१५७.१
तेला : तेल । मा० ५.२५.५
तेलि : संपु० (सं० तैलिक>प्रा. तेल्लिअ)। तैल व्यवसायी जाति । मा०  ७.१००.५
तेल : तेल+कए० । माङ्गलिक तेलविशेष । 'करि कुलरीति कलस थपि तेलु  चढ़ावहिं ।' जामं० ११५
तेषां : सर्वनाम (सं०) । उनका-की-के । मा० ७.१०८.६ 
तेहिं : (१) उसने । 'तेहिं अपने मन अस अनुमाना।' मा० ६.४६.४ (२) उससे ।।  'तेहिं करि बिमल बिबेक बिलोचन ।' मा० १.२.२ (३) उस पर । तेहिं  मग चलत सुगम मोहि भाई ।' मा० १.१३.१०
तेहि : (१) उस । 'सनमुख होइ न सके तेहि अवसर ।' मा० ६.५०.६ (२) उसे,  उसके लिए, उसके प्रति । 'जो जेहि भाव नीक तेहि सोई ।' मा० १.५.६
तेहीं : तेहिं । उसी । तेही समय बिभीषनु जागा।' मा० ५.६.२
तेही : तेहि । उस, उसी । 'बहुरि सक्र सम बिनवउँ तेही ।' मा० १.४.१०
ते : मध्यमपुरुष सर्वनाम (सं० त्वया>प्रा० तइ>अ० तइँ) । (१) तूने । 'सीता  ते मम कृत अपमाना।' मा० ५.१०.१ (२) तू । 'तै निसिचर पति गर्ब बहुता।" मा० ६.३०.७ (३) परायेपन का भाव (अहंकार का रूप) । 'मैं तें मोर मूढ़ता  त्यागू ।' मा० ६.५६.७
तैलिक : तेली। विन० २५.७
तैसइ : वैसा ही । 'तैसइ सीलरूप सुबिनीता।' मा० ३.२४.४ तसिअ, य
ये : वैसी ही । तसिअ नाथ पुरुष बिनु नारी।' मा० २.६५.७
तैसी : वि०स्त्री० (सं० तादृशी>प्रा० तारिसी>प्रा० तइसी)। वैसी। मा०.  २.२८६.६
तैसें : उस प्रकार से । 'तेज निधान लखन पुनि तैसे।' मा० १.२६३.३
तैसेइ : वैसे ही । 'तैसेइ भूप संग दुइ ढोटा ।' मा० १.३११.३
तसेहि : उसी प्रकार से । मा० २.२३०.७
तैसो : वि०पू० कए । वैसा । 'मुख तेसो रिस लाल भो।' कवि० ५.४ 
_______________________________________________
427 
तेहैं : आ०म०प्रब० । (१) (सं० तप्स्यन्ति>प्रा० तविहिति>अ० तविहिहिं) ।  सन्तप्त करेंगे (२) (सं० तायिष्यन्ते>प्रा० ताइहिति>अ० ताइहिहिं) । संवृत करेंगे, छिपा देंगे। 'तनु छबि कोटि मनोजन्हि तेहैं।' गो० ५.५०.४  (दे० तावों)
तो : (१) तुअ । तव , तुझ । 'सपनेहुं तो पर को पुन मोही।' मा० २.१५.१ __(२) तु । 'अब तो दादुर बोलि हैं ।' दो० ५६४ (३) तो (तहि) । 'तो तुलसिहि  तारिहो।' विन० १६.३ (४) हतो। था। 'मो तें कोउ न सबल तो।' गी०  ५.१३.५
तोतरात : वकृ.पु । तुतलाते, रुक-रुक कर शिशुवाणी बोलते, जीभ के व्याघात  से अस्पष्ट उच्चारण करते । 'मुनिमन हरत बचन कहैं तोतरात ।' कृ० २
तोतरि : वि०स्त्री० । तुतली, लड़खड़ाती (ध्वनि) । 'जौं बालक कह तोतरि बाता।'  मा० १.८.६
तोतरे : वि.पु०ब० । तुतले, लटपटाते । 'अति प्रिय मधुर तोतरे बोला।' मा०  १.१६६.६
तोपची : सं०० (फा०) । तोप दागने वाला । दो० ५१५
तोपिहैं : आ०म०प्रब० । पाट देंगे, (गर्त) भर देंगे । 'तुलसी बड़े पहार ले पयोधि  तोपिहैं।' कवि० ६.१
तोपं : आप्रब । तोपे दे रहे हैं, पाट रहे हैं। 'तो तोयनिधि, सुर को समाजु  हरषा।' कवि० ६.७
तोप्यो : भूकृपु०कए० । तोप दिया, पाट दिया (ढक दिया)। 'बरषि बान रघुपति  रथ तोप्यो।' मा० ६.६३.३
तोम : सं.पु० (सं० स्तोत्र) । समूह । 'तीतर तोम तमीचर सेन ।' कवि० ६.२६
तोमनि : तोम+संब० । समूहों । 'महामीनाबास तिमि तोमनि को थलु भो।'  हन ०७
तोमर : स.पु. (सं.)। लोहे का बड़ा भारी भाला । मा० ३.१६ छं०
तोय : स.० (स०) । जल । मा० २.३०६
तोयनिधि : समुद्र । मा० ६.५
तोर : वि.पु । तेरा । 'जदपि न दूषन तोर ।' मा० १.१७४ (२) परायेपन का  भाव । 'मैं अरु मोर तोर ते माया।' मा० ३.१५.२ /तार,
तोरइ : (सं० तोडति--तुड छेदे>प्रा० तोडइ-तोड़ना, छिन्न करना)  आ०प्रए । तोड़ता है, तोड़ सकता है, तोड़े, तोड़ सके। 'धनु तोरै सो बरै  जानकी।' गी० १.८६.३
तोरत : वपु । तोड़ता-ते । तुलसी तोरत तीर तरु ।' दो० ४६८ 
-428 
_______________________________________________
तोरन : सं०० (सं० तोरण) (१) बहिरि, फाटक । (२) मङ्गलोत्सव में बनाया  सजाया कृत्रिम द्वार । मा० १.१६४.१
तोरब : (१) भकृ०० (सं० तोडितव्य>प्रा० तोडिअव्व)। तोड़ना । 'रहउ  चढ़ाउब तोरब भाई।' मा० १.२५२.२ (२) तोड़ना होगा (तोड़ेंगे) । 'राम  चाप तोरब, सक नाहीं।' मा० १.२४५.२
तोरहीं : आ०प्रब० (सं० तोडन्ति>प्रा० तोडंति>अ० तोडहिं)। तोड़ते हैं ।  बिलोकि सब तिन तोरहीं।' मा० १.३२७ छं०१
तोरई : आo-कामना--प्रब ० (ईश्वर करे कि) तोड़ डालें, तोड़ सकें। 'तो सिव  धन मनाल की नाई । 'तोरहुं राम गनेस गोसाई।' मा० १.२५५.८
तोरा : (१) तोर । तोरा । 'कृष्न तनय होइहि पति तोरा।' मा० १.८८.२  (२) भकृ.पु०ए० (सं० तोडित>प्रा० तोडिअ) । तोड़ा, खण्डित किया।  'तेहि छन मध्य राम धनु तोरा।' मा० १.२६१.८
तोराइ : पूकृ० (सं० तोडयित्वा>प्रा० तोडाविअ>अ० तोडावि)। तुड़ा कर,  बन्धनविच्छेद करके । 'बागुर विषम तोराइ मनहं भाग मग भागबस ।' मा०  २.७५
तोराई : वि०स्त्री० (सं० त्वरावती) । द्रुतगामिनी । (२) (सं० त्वरयित्त्वा>प्रा.  तोराविअ>अ० तोरावि) । शीघ्रता करके । 'छुद्र नदी भरि चली तोराई।' मा० ४.१४.५ (यहाँ 'तोराइ' वाला अर्थ भी है--जिस प्रकार क्षुद्र स्त्री मर्यादा  तोड़कर चलती है, उसी प्रकार नदी सीमा तोड़कर बह चली)
तोरावति : वि०स्त्री० (सं० त्वरावती)। द्रुतगामिनी+ (सं० तोडयन्ती>प्रा.  तोडावंती) मर्यादा भङ्ग करने वाली सीमा तोड़कर शीघ्र गति लेती हुई।  'बिषम बिषाद तोरावति धारा।' मा० २.२७६.३
तोरि : (१) सार्वनामिक वि०स्त्री० । तेरी। 'भूपं प्रतीति तोरि किमि कीन्ही ।' __ मा० २.१६२.३ (२) प्रकृ० (सं० तोडयित्वा>प्रा० तोडिअ>अ० तोडि)। __ तोड़कर। संभु सरासन तोरि सठ करसि हमार प्रबोधु ।' मा० १.२८०
तोरिए : आ०कवा-प्रए० (सं० तोड्यते>प्रा० तोडीआइ) । तोड़ा जाय । 'तुलसीस __ तोरिए सरासन इसान को।' गी० १.८८.५
तोरिबे : भूकृ०० । तोड़ने । 'मैं तव दसन तोरिबे लायक ।' मा० ६.३४.१
तोरिहि : आ०भ० प्रब० (सं० तोडिष्यन्ति>प्रा० तोडिहिति>अ० तोडिहिहिं)।  तोड़ेंगे । 'तमकि ताहि ए तोरिहिं कहब महेस ।' बर० १५
तोरी : भूकृ० स्त्री०व० । तोड़ी, उच्छिन्न की । 'बहु धनहीं तोरी लरिकाई।' मा०  १.२७१.७
तोरी : (१) तोरि । तेरी । 'अस्तुति तोरी के हि बिधि करौं।' मा० १.१६३ छं० 
_______________________________________________
429 
(२) तोरि । तोड़कर । 'निरखहि छबि जननी तन तोरी।' मा० १.१६८.५ 
(३) भूकृ०स्त्री० । तोड़ डाली।
तोरें: (१) तुझमें । 'सकल प्रकार भगति दृढ़ तोरें।' मा० ३.३६.७ (२) तेरे में।  'कर गत बेद तत्त्व सब तोरें ।' मा० १.४५.७ (३) तेरे.. से । 'अनुदिन बढ़उ अनुग्रह तोरें।' मा० १.२०५.२ (४) तोड़ने से (सं० तोडितेन>प्रा० तोडिएण >अ० तोडिएँ) । 'तोरें धनुषु चाड़ नहिं सरई ।' मा० १.२६६.४ (५) तोड़े  हुए (स्थिति में) । 'देह गेह सब सन तनु तोरें।' मा० २.७०.६
तोरे : (१) सार्वनामिक वि०० । तेरे । 'राम प्रताप नाथ बल तोरे ।' मा०  २.१६२.१ (२) भूक०० ब० (सं० तोडित>प्रा० तोडिय) । उच्छिन्न किये।  'तुलसी जे तोरे तरु, किए देव, दिए बरु ।' कृ० १७
तोरेउ : आ०-भूक.पु+उए । मैंने तोड़े। 'कपि सुभाव तें तोरेउँ रूखा।'  मा० ५.२२.३
तोरेहं : तोड़ने पर भी। 'तोरेहुं धनुष ब्याहु अवगाहा ।' मा० १.२४५.६
तोरै : भकृ० अव्यय । तोड़ने । 'फल खाएसि तरु तोरै लागा।' मा० ५.१८.१
तोरै : तोरइ ।
तोरौं : आउए० (सं० तोडामि>प्रा० तोडमि>अ० तोडउँ)। तोड़ता हूं, तोड़  डालू. तोड़ सकता हूं। 'तोरौं छत्रक दंड जिमि ।' मा० १.२५३
तोर्यो : भूक.पु.कए । तोड़ डाला । 'बालक नृपाल जू के ख्याल ही पिनाकु  तोर्यो।' कवि० १.१२
तोष : सं०० (सं.) । सन्तोष, तुष्टि । 'तोष मरुत तब छमा जुड़ावं ।' मा०  ७.११७.१४
तोषक : वि० (सं०) । तुष्ट करने वाला। मा० १.४३.४
तोषन : वि.पु । तुष्ट करने (के शील) वाला । मा० ७.१०६.११
तोषनिहारा : वि.पुं० । तुष्ट करने वाला । मा० २.४१.८
तोषये : सन्तुष्ट करने के लिए। मा० ७.१०८.६
तोषा : तोष । मा० १.४३.४
तोषि : पू० । सन्तुष्ट करके । 'पोषि तोषि थापि आपनो न अवडेरिए ।' हन० ३४ तोषिए,
ये : आ०कवा०प्रए । संतुष्ट कीजिए । 'तुलसिदास हरि तोषिये सो साधन  नाहीं।' विन० १०६.५ तोषि
हैं : आ०भ०प्रए । तुष्ट करेंगे । “जोगिनी जमति कालिका कलाप तोषिहैं ।'  कवि० ६.२
तोष : तोष+कए । 'बिन अधार मन तोषु न साँती।' मा० २३१६.२
तोषे : भूकृ००ब० । तोषयुक्त हुए । 'तोषे राम सखा की से।' मा० २.२२१.३
तोषेउ : भूकृ००कए । तोषयुक्त हुआ। 'प्रभु तोषेउ ।' मा० १.७७.६ 
430 
_______________________________________________
तोहारा : (अ० तुहार) तेरा। मा० १.२८२.६
तोहि : तोहि । 'तोहिं स्याम को सपथ जसोदा ।' कृ० ३
तोहि : तुझे । 'सपन सुनावउँ तोहि ।' मा० १.७२
तोही : तोहि । 'प्रिय बादिनि सिख दीन्हिउँ तोही ।' मा० २.१५.१
तोहू : तुझे भी। तोहू है बिदित बलु ।' कवि० ६.११
सौंको : पूकृ० । तौंक कर, तमक कर, आँच से तमतमा कर। 'लपट झपट सो  तमीचर तौंकी।' कवि० ७.१४३
तौंसिअत : वकृ.पुकवा० (तमस्+कर्मवाच्य कृ.) । (धुएँ के धुन्ध में) अंधराये  जाते (हए । 'तात तात तौंसित झौंसित झारहीं।' कवि० ५.१५
तो : अव्यय । (१) तो, उस दशा में, तब । 'तो कहि प्रगट जनावहु सोई ।' मा०  २.५०.६ (२) तु । 'गंगाजल कर कलस तो तुरित मंगाइय हो ।' रान०३ (३) (सं तावत् >प्रा० ताव) । पहले, सर्वप्रथम । 'प्रभु कर चरन पछालि तो अति सुकुमारी हो ।' रा०न०१५ (४) तउ।तो भी। ‘ऐसे भए तो कहा  तुलसी ।' कवि० ७.४४
तौलि : पू० । तोलकर (आजमाकर) 'मनहुं तौलि निज बाहु बल चला।' मा०  १.१७६ तौलिए,
ये : आ०कवा०प्रए० । तोला जाय । 'भले सुकृती के संग मोहि तुला तौलिये  तो नाम के प्रसाद भारु मेरी ओर नमिहै।' कवि० ७.७१
तोलौं : तब तक । 'जो लौं कान्ह रही गुन गोए। तोलौं तुम्हहि पत्यात लोग सब।'  कृ० ११
तौल्यो : भूकृ००कए । तोल लिया (उठा लिया)। जेहिं तोल्यो कैलास ।'  दो० १६७
त्यक्त : भूकृ० (सं०) । त्यागा हुआ-त्यागे हुए। विन० ५०.५
त्याग : सं०पु० (सं.)। (१) परिहार, छोड़ना । 'संग्रह त्याग न बिनु पहिचाने ।' __ मा० १.६.२ (२) दान, सांसारिकता के प्रति विराग । 'ध्यान को भूषन त्याग।'  वरा० ४४
त्यागइ : त्याग+प्रए । छोड़ता है । 'जलहीन मीन तनु त्यागइ ।' पा०म० ६०
त्यागत : त्याग+ वकृ०० । छोड़ता । मा० ७.१४ छं० ७
त्यागन : त्याज्य । 'त्यागन गहन उपेच्छनी ।' विन० १२४.२
त्याहिं : त्याग+प्रब० । छोड़ते हैं । 'मुनि ध्यान त्याहिं।' मा० १.३२२ छं० त्यागहु,
हू : त्याग+मब० । (१) छोड़ते हो। यह सामरथ अछत मोहि त्यागहु ।'  विन० ६४.५ (२) छोड़ो । त्यागहु तम अभिमान ।' मा० ५.२३
स्यागा : त्याग+भूक०० । छोड़ दिया । 'सहज बयरु सब जीवन्ह त्यागा।' मा०  १.६६.२ 
_______________________________________________
431 
स्यागि : त्याग+पूकृ० । छोड़ (कर) । 'सकउँ पूत पति त्यागि ।' मा० २.२१
त्यागिहहिं : त्याग+भप्रब० । छोड़ेंगे । 'आपन जानि न त्यागिहहिं ।' मा० २.१८३
त्यागिहै : (१) त्याग+भ०प्रए । छोड़ेगा। (२) मए । तू छोड़ेगा । 'कुटिल कपट  कब त्यागिहै।' विन० २२४.१ ।।
त्यागी : (१) वि.पु । उदार, दानी । (२) छोड़ने वाला। 'माया त्यागी संत ।'  वैरा० ३२ (३) त्यागि। 'सिव समाधि बैठे सब त्यागी।' मा० १.८३.३ (४) त्याग+भूकृ०स्त्री० । छोड़ दी। 'मन हौं तजी, कान्ह हौं त्यागी।' कृ०  २५ त्याग,
गू : (१) त्याग+कए । दान आदि । 'आजु सुफल तपु तीरथ त्यागू ।'  मा० २.१०७.५ (२) त्याग+आज्ञा-मए । तू छोड़ । 'मैं ते मोर मूढ़ता  त्याग ।' मा० ६.५६.७
त्यागें : छोड़े हए, छोड़ कर । 'तब चलि गयउ निकट भय त्यागें ।' मा० ६.५४.८
त्यागे : त्याग+भूक पुब० । छोड़ दिये । 'बारि अधार मूल फल त्यागे ।' मा०  १.१४४.२
त्यागेउ : त्याग+भक०पू०कए० । छोड दिया। बरस सहस दस त्यागेउ सोऊ।'  मा० १.१४५.१
त्याग : त्यागइ । छोड़ दे। 'जो पन त्यागे ।' जा०म० ७०
त्यागौं : त्याग+ उए । छोड़, छोड़ सकता हूँ। 'हौं तौ नहिं त्यागौं ।' विन०  १७७.१
त्यागौ : त्यागहु । 'जो तुम त्यागौ राम ।' विन० १७७.१ त्यों,
त्यौं : (१) तिमि (अ० तेव) । उस प्रकार । 'तुलसी ज्यों ज्यों घटत तेज तन  त्यों त्यों प्रीति अधिकाई।' गी० २.७९.४ (२) ओर (तन)। 'चित तुम्ह त्यों  हमरो मन मोहैं।' कवि० २.२१
त्रपा : सं०स्त्री० (सं.)। लज्जा । ‘भए बिहाल नृपाल अपा हैं । गी० ७.१३.५
त्रय : सं०० (सं.)। तीन का समूह (तीन)। 'तपत सदा त्रय ताप ।' वैरा० ६
प्रयताप : तापत्रय । मा० १.३६.६
त्रयो : सं०० (सं.)। (१) तीन का समूह (२) वेदत्रयी=ऋक्, यजुः,  साम । 'अदभुत त्रयी किधौं पठई है।' गी० २.२४.३
त्रसित : भूकृ०वि० (सं० त्रस्त)। भयभीत । मा० १.१७४.८ 
से : त्रसित । डर गये । 'कमठ भू भूधर बसे ।' मा० ६.६१ छं०
त्रस्त : त्रसित । विन० ५६.६
त्रस्यो : भूक००कए० । डर गया । 'बली त्रास अस्यो हौं ।' विन० १८१.४
त्रातहि : त्राता को, रक्षक को। मा० ७.३०.३ 
432 
तुलसी शब्दकोश 
त्राता : वि०० (सं.)। रक्षक । मा० ७८३.२
त्रातु : मा0-प्रार्थना-प्रए० (सं० त्रायताम् =पातु) । रक्षा करे । मा० ३.११.६
त्रान : सं०० (सं० त्राण) । रक्षा, रक्षा साधन । 'नहिं पद बान सीस नहिं छाया।'  मा० २.२१६.५
त्राना : बान । मा० ६.८०.३
त्रास : सं० +स्त्री० (सं.)। भय । मा० १.६३.१
त्रासइ : त्रास+प्रए । भयभीत करता है । 'तेहि बहु बिधि त्रास इ देस निकासइ।'  मा० १.१८३ छं०
त्रासक : वि० (सं.)। भयदायक । 'त्रिविध ताप त्रासक तिमुहानी।' मा०  १.४०.४ 
त्रासक : त्रासक+कए० । एकमात्र भयदाता । 'तरनि त्रासकु ।' गी० ६.१४.५
त्रासन : (१) त्रास+संबः । त्रासों (से) । 'त्रासन चकित सो परावनो परो सो  है।' कवि० ७.८४ (२) संपु० (सं०) । त्रस्त करना । 'बौधि करि त्रासन  दीन्हो ।' कवि० ७.११७
त्रासहु : त्रास+मब० । डराओ, भयभीत करो। 'सीतहि बहु बिधि त्रासहु जाई ।'  मा० ५.१०.८
प्रासा : त्रास । 'भाजि भवन पैठीं अति त्रासा।' मा० १.६६.५
त्रासित : भूक०वि० (सं०) । डराया हुआ, भयाक्रान्त किया हुआ । 'एक एक रिपु - ते त्रासित जन ।' विन० ६३.५
त्राहि : आ०-प्रार्थना-~मए० (सं० त्रायस्व=पाहि) । तू रक्षा कर । 'त्राहि त्राहि  आरत जन त्राता।' मा० ७.८३.२ (२) रक्षा हेतु कहा जाने वाला शब्द ।  त्राहि तीनि कह्यो द्रौपदी। दो० १६९
त्रिकाल : तीन काल =भूत, वर्तमान, भविष्यत् । 'तुम्ह त्रिकाल दरसी मुनि नाथा।'  मा० २.१२५.७
त्रिकालग्य : (सं० त्रिकालज्ञ)। तीनों कालों के विषयों का ज्ञाता । मा० १.६६
त्रिकूट : सं०० (सं.)। तीन शिखरों वाला पर्वत विशेष जिस पर लङका बसी  थी। मा० १.१७८.५
त्रिकटु : त्रिकूट-+कए । त्रिकूट उपारि लै बारिधि बोरौं ।' कवि० ६.१४
त्रिगुन : माया (प्रकृति) के तीन गुण - (१) सत्त्व गुण प्रकाश, सुख, ज्ञान ।  (२) रजोगुण =चपलता, दुःख । (३) तमोगुण = मोह, अज्ञान ।।
त्रिगुनपर : माया के तीनों गुणों से परे निर्गुण । 'त्रिपुरारि त्रिलोचन त्रिगुनपर।'  कवि० ७.१५०
त्रिजग : सं०० (सं० तिर्यक्-ग) । तमोगुणी सृष्टि = पशुपक्षी आदि । 'त्रिजग देक  नर असुर समेते।' मा० ७.८७.६ 
_______________________________________________
433 
त्रिजटा : त्रिजटाने । 'त्रिजटा कहा ।' मा० ६.६६ छं०
त्रिजटा : (सं०) एक राक्षसी जो सीता की सखी हो गयी थी। मा० ५.११.१
त्रिताप : तापत्रय । हन० २८
त्रिदस : सं०पू० (सं० त्रिदश)। देव । कवि० ७.१५०
त्रिदोष : सं०० (सं०) । आयुर्वेद वर्णित तीन तत्त्व- वात, पित्त और कफ जब 
__ कुपित होते हैं तो सन्निपात रोग (त्रिदोष) बनता है । हनु० २६
त्रिदोषदाह : सन्निपात रोग की जलन । कवि० ६.२५
त्रिदोषे : भूक००ब० । त्रिदोषग्रस्त, सन्निपात रोगी । 'कैधौं कूर काल बस तमकि  त्रिदोषे हैं।' गी० १.६५.२
त्रिपथ : तीन मार्ग (स्वर्ग, पाताल, मर्त्य)। 'त्रिपथ लससि नभ पताल धरनि ।'  विन० २०.१
त्रिपथगा : सं०स्त्री० (सं०) । गङ्गा । विन० १७.१
त्रिपथगामिनि : त्रिपथगा। कवि० २.६
त्रिपुंड : सं०० (सं० त्रिपुण्ड)। मस्तक पर भस्म आदि की तीन आड़ी रेखाएँ।  मा० १.२६८.४
त्रिपुर : सं०० (सं०) । (१) असुरविशेष के तीन नगर=स्वर्ण, चाँदी तथा लोह  के पुर जो त्रिगुण के प्रतीक हैं (२) उन नगरों का स्वामी असुर=  त्रिपुरासुर । मा० १.५७.८ त्रिपुरारि,
री : त्रिपुर के शत्रु-शिवजी। मा० १.४६; ४८.६ त्रिबलि,
ली : सं०स्त्री० (सं० त्रिवलि, त्रिवली)। उदर की तीन सिकुड़ने या  रेखाएं । गी० ७.१६.३ 'नाभी सर त्रिबली निसेनिका ।' गी० ७.१७.६
त्रिबिक्रम : सं०+वि० (सं० त्रिविक्रम)। विष्णु, विराट् भगवान् जिन्होंने तीनों  लोकों को तीन डगों =पादक्षेपों (विक्रमों) में नापा था (ऋग्वेद में त्रिलोक  व्यापी परमात्मा)। मा० ४.२६.८
त्रिबिध : वि० (सं० त्रिविध)। तीन प्रकारों (विधाओं) वाला । 'त्रिविध ताप  त्रासक तिमुहानी ।' मा० १.४०.४
त्रिबिधि : त्रिबिध । तीन विधियों (रीतियों प्रकारों) वाला । 'त्रिबिधि ताप भव  दाप नसावनि ।' मा० ७.३५.१
त्रिबेनिहिं : त्रिवेणी में । त्रिबेनिहिं आए।' मा० २.२०४.३
त्रिबेनी : त्रिवेणी में । 'सादर मजहिं सकल त्रिबेनी ।' मा० १.४४.४
त्रिबेनी : सं०स्त्री. (सं० त्रिवेणी) । प्रयाग में गङ्गा-यमुना-सरस्वती की त्रिधारा  (तीन वेणियों) का संगम । मा० २.२०५.६ 
434 
_______________________________________________
विभंग : सं०पू० (सं०) । खड़े होने की विशेष मुद्रा जिसमें घुटने, कटि और ग्रीवा  टेढ़े रहते हैं । (२) उस मुद्रा में खड़ा होने वाला-ली (कृष्ण) । 'जो हैं मूरति  त्रिभंग।' कृ० २०
त्रिभुअन : त्रिभुवन । मा० ६.८३ छं०
त्रिभुवन : सं०० (सं०)। स्वर्ग, मर्त्य और पाताल लोकों का समुदाय । मा० 
त्रिय : तिय । मा० १.६७.६
त्रिरेख : त्रिबली । 'उदर त्रिरेख मनोहर ।' गी० ७.२१.११
त्रिलोक : त्रिभुवन । मा० ३.४ छं०
त्रिलोचन : वि०+सं० (सं.)। तीन नेत्रों वाला-शिव । कवि० ७.१४६
त्रिविधाति : (त्रिविध+आति) =त्रिताप । विन० ४३.६
त्रिसंकू : सं० पु (सं० त्रिशङ कु) । एक सूर्यवंशी राजा हरिश्चन्द्र का पिता ।  मा० २.२२६.१
त्रिसिरा : सं०० (सं० त्रिशिरस्-त्रिशिराः) । खर-दूषण बन्ध एक राक्षस ।  मा० ५.२१.६
त्रिसिरारि : (सं० त्रिशिरोडरि) त्रिसिरा के शत्रु = राम । मा० ४.३० क
त्रिसिरु : त्रिसिरा+कए । कवि० ६.४
त्रिसूल : सं०पू० (सं० त्रिशूल)। (१) आयुध विशेष जिसमें तीन नोकें होती हैं ।  मा० ६.७६.४-६ (२) शिव का आयुध जो तापत्रय का प्रतीक है। मा०  १.६२.५
त्रिसूलन्हि : त्रिसूल+संब० । त्रिशूलों (से)। 'ब्याकुल किए भालु कपि परिध  त्रिसूलन्हि मारि ।' मा० ६.४२
त्रेता : त्रेता यग में। त्रेतां ब्रह्म मनुज तनु धरिही।' मा० ४.२८.७
त्रेता : सं०स्त्री०+पु० (सं० । चतुर्युगी का दूसरा युग । 'सत्त्व बहुत, रज कछु,  रति कर्मा । सब बिधि सुख त्रेता कर धर्मा ।' मा० ७.१०४.३
त्रैकटक : (सं० त्रयकटक) तीन तत्त्वों की सेना । 'सत्त्वगुण-प्रमुख कटक कारी।'  विन० ५८.२
नैन : त्रिनयन । त्रिलोचन शिव । विन० ४६.५
त्रैलोक : त्रैलोक्य । मा० १.१६७.५
त्रैलोका : त्रैलोक । मा० १.८७.५
त्रैलोक्य : (सं०) तोनों लोकों का समूह-दे० त्रिभुवन । कृ० २१ 
वर्ग : (सं० त्रिवर्ग==वर्गत्रय) अर्थ, धर्म और काम पुरुषार्थों का गण जिसे  अभ्युदय' कहते हैं (लौकिक मल्य) । विन० ५७.२
व्याधि : (सं० व्याधित्रय) =त्रिविधाति-दे० तापत्रय । विन० ५७.६ 
_______________________________________________
433 
. 
त्रोन : सं०० (सं० तूण) । तूणीर, तरकस । मा० ६.७१.३
स्वं : सर्वनाम (सं.) । तू । विन० ५४.४
त्वच : सं०स्त्री० (सं० त्वच) । चमड़ी, छाल । मा० ७.१३ छं० ५
त्वदांघ्रि : (सं.)। तेरे चरण । मा० ३.४ छं०
त्वदीय : सार्वनामिक वि० (सं०) । तेरा, तेरी, तेरे । मा० ३.४ छं०
त्वभक्ति : (सं०) तेरी भक्ति । विन० ५७.८
त्वद्रूप : (सं०) तेरा रूप, तुझ से अभिन्न, तुझ से एकाकार | 'सर्व मेवात्र त्वद्रूप ।'  विन० ५४.३
स्वयि : सर्वनाम (सं०) । तेरे..... पर । 'गति त्वयि प्रसन्ने ।' विन० ५७.२ ..  o 
यकि : पू० (सं० स्तकित्वा---ष्टक प्रतिघाते, स्थित्वा>प्रा० थक्किअ>अ०  थक्कि)। (१) परिश्रान्त होकर । 'जहँ तह रहे पथिक थकि नाना ।' मा० ४.१५.१२ (२) अकचका कर, स्थिर होकर । 'रामहि चितइ रहे थकि  लोचन ।' मा० १.२६६.८
थकित : भूक० (सं० स्तकित, स्थित>प्रा० थक्किय) । (१) एक तान-स्थिर,  (मुग्ध तथा अचंचल । 'सहज बिराग रूप मन मोरा । थकित होत जिमि चंद चकोरा ।' मा० १.२१६.३ (२) रुका हुआ। 'चंडकर थकित फिरि तुरग हाँके ।' कवि० ६.४५ (३) परिश्रान्त, स्तब्ध । 'थकित रहे धरि मौन ।' मा०  २.१६०
थकें : थकने पर, परिश्रान्त होने पर । 'परत थके थाह जन पाई।' मा० १.२६३.४
थके : भक०पू०=थकित -ब० । एक तान-स्थिर, मुग्ध-स्तब्ध । 'थके नयन रघुपति  छबि देखें ।' मा० १.२३२.५ (२) परिश्रान्त । 'थके बिलोकि पथिक हिये  हारे ।' मा० २.२७६.५
थन : सं०० (सं० स्तन>प्रा० थण)। पयोधन, कुच । मा० २.१६६.५ Vथप
थपइ : (सं० स्थापयति>प्रा० थप्पइ>स्थापित करना, स्थायी बनाना,  प्रतिष्ठित करना) आ०प्रए० । स्थापित करता है 'उथप तेहि को जेहि राम थपै।' कवि० ७.४७ 
436 
_______________________________________________
थपत : वकृ०० (सं० स्थापयत् >प्रा० थप्पंत)। स्थापित करता-ते । 'नाम सों  प्रतीति प्रीति हृदय सुथिर थपत ।' विन० १३०.५
थपति : सं०० (सं० स्थपति) । थवई, वास्तु कलाकार । 'चले सहित सुर थपति  प्रधाना ।' मा० २.१३३.६
थपन : (१) वि०० । स्थापित करने वाला । 'उथपे थपन थिर, थपे उथपनहार। 
हनु० २२ (२) सं०० (सं० स्थापन>प्रा० थप्पण) । प्रतिष्ठित करना, __ स्थायित्व देना । 'उथपे थपन थपे उथपन पन ।' विन० ३१.३ ।।
थपि : थापि । स्थापित कर । 'करि कुलरीति कलस थपि तेल चढ़ावहिं ।' जा०म०  ११५
थपिहै : आ०भ०ए० । स्थापित करेगा, प्रतिष्ठ देगा। थपिहै तेहि को हरि जो  टरिहै।' कवि० ७.४७
थपे : भूक०पु । स्थापित किये हुए (को)। 'तेरे थपे उथप न महेस ।' हनु० १७
थप : थपइ । थाप सकता है । 'थप थिर को कपि जे घर घाले ।' हन० १७
थप्यो : भूकृ०० कए । स्थापित किया। 'बालि सो बीरु बिदारि सुकंठु थप्यो।"  कवि० ७.१
थर : थल ।
थरथर : कांपने की चेष्टा । 'नयन सजल तन थर थर कांपी।' मा० २.५४.४
थरु : थर+कए० । स्थान । 'प्रतीति मानि तुलसी बिचारि काको थरु है।' कवि०  ७.१३६
थल : सं०० (सं० स्थल>प्रा० थल) । स्थान, भूभाग। मा० १.८.१
थलचर : स्थल (भूमि) पर रहने वाले जीव । मा० १.३.४
थलचारी : थलचर । मा० १.८५.४
थलरुह : सं०० (सं० स्थलरुह) । पृथ्वी पर उगने वाले वृक्षादि । गी० २.४६.३
थलु : थल+कए० । वह स्थान । 'थलु बिलोकि रघुवर सुखु पावा ।' मा०  २.१३३.५
थहाइबी : भकृ०स्त्री० । अवगाहित करनी । 'धाइ न जाइ थहाइबी सर सरिता  अवगाह ।' दो० ४४६
थहावौं : आ० उए० (सं० स्ताधयामि>प्रा० थाहावमि>प्रा० थाहावउँ)। थाह  लेता हूं। 'गोपद. बुडिबे जोग करम करि, बातनि जलधि थहावौं ।' विन.  २३२.३
थाका : भूकृ०० (सं० स्थित, स्तकित>प्रा० थक्क) रुक गया, परिश्रान्त हुआ।  गर्जा अनि अंतर बल थाका । मा० ६.६२.२
थाक : सं००कए । रोक टोक, कभी। 'मेरे कहा थाकु गोरस को।' कृ० ५
थाके : थके । परि परि थाके हैं।' गी० १.६४.३ 
_______________________________________________
437 
थाकेउ : थाका+कए० । अचल हुआ, स्तब्ध रह गया । 'रबि समेत रथ थाकेउ ।'  मा० १.१६५
थाको : थाकेउ । रुक गया, निष्ट चेष्ट हो गया, थक गया। 'मेरो सब पुरुषारथ  थाको ।' गी० ६.७
थाक्यो : थाके उ । रह गया, रुका पड़ा रहा । “सो थाक्यो बरह्यो एकहिं तक ।'  कृ० ५६ थाति,
ती : सं०स्त्री० (प्रा० यत्ति)। (१) स्थायी निधि । 'अघ अवगुननि की  थाति ।' विन० २२१.२ (२) धरोहर, न्यास । 'दुइ बरदान भूप सन थाती।'  मा० २.२२.५
थाना : सं०० (सं० स्थानक>प्रा० थाणअ) । चौकी, पड़ाव । 'तहँ तहं बैठे सुर  करि थाना।' मा० ७.११८.११
थानी : वि.पु. (सं० स्थानिक>प्रा० थाणिअ)। किसी स्थान का स्वामी  दिक्पाल आदि । 'सुख सनेह सब दिये दसरथहि खरि खलेल थिर थानी ।'  गी० १.४.१३
थापन : थपन । स्थापित करने वाला । तुम उथपन थापन ।' जा०म० १७२
थापना : सं० स्त्री० (सं० स्थापना) । 'करिहउँ इहाँ संभु थापना ।' मा० ६.२.४
थापनो : यापन+कए । एकमात्र स्थापन कर्ता। 'राय दसरथ के तू उथपन  थापनो।' विन० १८०.१
थापहि : आ०प्रब० (सं० स्थापयन्ति>प्रा० थप्पंति>अ० थप्पहि)। स्थिर  प्रतिष्ठा देते हैं । 'असुर मारि थापहिं सुरन्ह ।' मा० १.१२१
थापि : थपि । लिंग थापि बिधिवत करि पूजा।' मा० ६.२.६ थापिन, ए, थापिय,
ये : आ० कवा०प्रए । स्थापित कीजिए। 'थापिअ जनु सब  लोगु सिहाऊ ।' मा० २.८८.७
थापेउँ : आ०-भक००+उए० । मैंने स्थापित किया। थापेउँ सिव सुखधाम ।'  मा० ६.११६ क
थाप्यो : थप्यो । कवि० ७.१०
थार : सं०० (सं० स्थाल >प्रा० थाल) । मा० १.६६.३
थारा : थार । मा० १.३०५.१
थारी : थाली में । 'लिएँ आरती मंगल थारी ।' मा० १.३०१.४
थारी : सं०स्त्री० (सं० स्थाली>प्रा० थाली)। छोटा थाल ।।
थालिका : (१) थारी (सं० स्थालिका)। (२) आलबाल, थाला जो वृक्षों के आस  पास सींचने को बनाते हैं। भक्ति कल्प थालिका ।' विन० १७.२
याह : सं०स्त्री० (सं० स्ताध>प्रा० थाह) । पानी में रुकने को भूमि । 'पैरत थके  थाह जनु पाई।' मा० १.२६३.४ 
438 
_______________________________________________
थाहत : वक.पु । थाह लेते । 'सरि थाहत जहँ तह घई ।' गी० ५.३८.४
थाहा : थाह । मा० ७.६१.६
थाहैं : थाह में । 'कोउ लांघत कोउ उतरत थाहैं।' गी० ७.१३.१
थिति : सं०स्त्री० (सं० स्थिति) । (१) स्थिरता, धृति । 'प्रभु चित हित थिति  पावत नाहीं।' मा० २.२२७.४ (२) रक्षा, धारण-पोषण । 'उतपति थिति लय ।' मा० २.२८२.५ (३) रहना । 'तुलसी किएँ कुसंग थिति होहिं दाहिने  बाम । दो० ३६१
थिर : वि० (सं० स्थिर>प्रा० थिर) । दृढ़, अचल, टिकाऊ । 'मनु थिर करि तब  संभु सुजाना ।' मा० १.८२.४
थिरता : सं०स्त्री० (सं० स्थिरता)। अचलता, दृढ़ता, स्थायित्व ।
थिरताइ : थिरता । 'राम भगति थिरताइ ।' दो० १४०
थिरथानी : (दे० थानी) अचल स्थान वाला-दिक्पाल, लोकपाल । गी० १.४.१३
थिरातो : क्रियाति पु०ए० । स्थिर हो जाता+निर्मल होता। 'जनम कोटि को 
__ कांदलो ह्रद हृदय थिरातो।' विन० १५१.६
थिराना : भूक.पु । (१) स्थिर हुआ (२) निर्मल हुआ। 'भरेउ सुमानस  सुथल थिराना ।' मा० १.३६.६
थिराने : थिराना' का रूपान्तर । (१) स्थिर हुए (२) निर्मल हुए । 'सदा मलीन  पंथ के जल ज्यों कबहुं न हृदय थिराने ।' विन० २३५.३
थोरा : सं०० (सं० स्थैर्य>प्रा० थीर)। दृढता, स्थिरता । 'निज सुख बिनु मन  होइ कि थीरा ।' मा० ७.६०.७ (२) थिर । थूनि,
नी : सं०स्त्री० (सं० स्थूणा>प्रा० थूणा>अ० थूणी)। स्तम्भ । जा०म०. 
थैली : सं०स्त्री० (सं० स्थगिका>प्रा० थविआथइल्ली) । रुपया-पैसा आदि रखने ___का वस्त्र-पात्र । मा० १.२७६.४
थोर : वि.पु. (सं० स्तोक>प्रा० थोअ>अ० थोअड=थोअडअ । थोड़ा । 'मोहि  बधि बल अति थोर ।' मा० १.१४ ख
थोरा : थोर । मा० ७.१०४.५
थोरि : थोरी । 'मति थोरि कठोरि न कोमलता।' मा० ७.१०२.२
थोरिउ : थोड़ी भी। 'मातु तोहि नहिं थोरिउ खोरी।' मा० २.१२.२
थोरिक : (थोरि+इक) । कुछ थोड़ी=अल्पतर । 'एहि घाट तें थोरिक दूरि अहै।"  कवि० २.६
थोरिहिं : थोड़ी ही । 'थोरिहिं बात पितहि दुख भारी ।' मा० २.४२.६
थोरी : थोर+स्त्री० । थोड़ी, अल्प । मा० १.४३.६ 
_______________________________________________
439 
थोरें : (१) थोड़े से । 'सिथिल सरीरु सनेह न थोरें। मा० २.१६८.५ (२) थोड़े  में। रीझत थोरें।' कवि० ७.४६
थोरे : 'थोर' का रूपान्तर । थोड़े । 'थोरे महं जानिहहिं सयाने।' मा० १.१२.६
थोरेहि : थोड़े ही। थोरेहि महं सब कहउँ बझाई।' मा० ३.१५.१
योरेहु : थोड़े में भी। 'जस थोरेहुं धन खल इतराई।' मा० ४.१४.५
थोरो : थोरा-कए० । 'जनि मागिये थोरो।' कवि० ७.१५३ 
दतियाँ : सं०स्त्री०ब० । शिशु के दांत । कवि० १.३
बतुरियां : देतियां । 'दमकति दै _ _तुरियां रूरौं ।' गी० १.३१.४
द : (समासान्त में) वि०पु० (सं०) । देने वाला । नर्मद, जलद आदि ।
दंड : सं०० (सं.)। (१) ध्वज आदि-सम्बन्धी लग्गी । 'रघुपति कीरति बिमल 
पताका । दंड समान भयउ जसु जाका ।' मा० १.१७.६ (२) इंडा, यष्टि । 'काल दंड गहि काहु न मारा।' मा० ६.३७.७ (३) (समासान्त में) दृढ़, पुष्ट, समर्थ । 'उर बिसाल भुजदंड चंड ।' हनु० २ (४) नाल, डंठल । 'तोरौं छत्रक दंड जिमि ।' मा० १.२५३ (५) प्रणाम की साष्टाङ्ग विधि जिसमें दण्डाकार पृथ्वी पर गिरते हैं-दंडवत । 'लगे करन सब दंड प्रनामा ।' मा० १.२६६.२ (६) घड़ी भर का समय-६० पल । 'दुइ दंड भरि ब्रह्मांड भीतर काम कृत कौतुक अयं ।' मा० १.८५ छं० (७) अपराध की निष्कृति-सजा । 'आन दंड कछु करिअ गोसाई ।' मा० ५.२४.८ (८) पराजित शत्रु से ग्राह्य धन आदि । 'लै लै दंड छाडि नप दीन्हे ।' मा० १.१५४.७ (8) राजनीति में-साम, दान और भेद के अतिरिक्त-चतुर्थ उपाय-दण्डनीति-शत्रु पर आक्रमण की 
नीति । 'साम दान अरु दंड बिभेदा ।' मा० ६.३८.६ /दंड
दंडइ : (सं० दण्डयति>प्रा० दंडइ-दण्ड देना, डाँड़ना) आप्रए । दण्ड  देता है, डांड़ता है। 'सरल दंडै चक्र।' दो० ५३७
दंडक : सं०० (सं०) । पौराणिक राजा 'दण्ड' के नाम से प्रसिद्ध दक्षिण का  वन प्रदेश-विशेष । मा० ३.१३.१६
दंडकारण्य : (दंडक+अरण्य) । दण्डक वन । विन० ५०.६ 
440 
_______________________________________________
दंडकारि,
री : वि० (सं० दण्ड-कारिन्) । दण्डाधिकारी, न्यायपाल, सजा देने  वाला । 'काल नाथ कोतवाल, दंड-कारि दंडपानि ।' कवि० ७.१७१
दंडपानि : वि०+सं० (सं० दण्डपाणि)। (३) हाथ में दण्ड लिये हुए । (२) लठत।  (३) यमराज (४) कालभैरव, भैरवनाथ । कवि० ७.१७१
दंडवत : (सं० दण्डवत् ==दण्डतुल्य) प्रणाम की रीतिविशेष जिसमें प्रणामकर्ता भूमि  पर साष्टाङ्ग प्रणिपात करता हुआ दण्डाकार हो जाता है। मा० १.१४५
दंडे : दंडइ।
दंत : सं०० (सं० दन्त)। दाँत । कवि० १.५
दंतकथा : सं०स्त्री० (सं.)। किंवदन्ती, कहकूत, कही-कहावत, लोक-प्रचलित  मनगढन्त कहानी । 'इति बेद बदंति न दंतकथा ।' मा० ६.१११.१६
दंतन : दंत+संब० । दाँतों । 'नख दंतन सों भज दंड बिहंडत ।' कवि० ६.३५ दंति,
ती : सं०० (सं० दन्तिन्) । दन्तावल, हाथी । गी० १.६०.५
दंपति : सं०पु० (सं०) । पति-पत्नी (का युगल) । मा० १.६८.७
दंभ : सं०पु० (सं०) । (१) छलना (२) धर्म, सदाचार आदि का मिथ्या प्रदर्शन  (३) धूर्तता (४) मिथ्याभिमान । 'लोभ के इच्छा दंभ बल ।' मा० ३.३८ ख
वंमा : दंभ । मा० १.३५.६
दंभापहन : वि० (सं० दम्भापहन्) । दम्भनाशक । विन० ५६.१
दंभिन्ह : दंभी+संब० । दम्भियों, पाखण्डियों । 'जनु दंभिन्ह कर जुरा समाजा।'  मा० ४.१५.६
दभिहि : दम्भी को । 'दंभिहि नीति कि भावई ।' मा० ७.१०५ ख
दंभी : वि०पु० (सं० दम्भिन्) दम्भ-युक्त । मिथ्याचारी, पाखण्डी।
दंस : सं०० (सं० दंश) । एक प्रकार की बड़ी मक्खी जो तीव्र दंशन के लिए  प्रसिद्ध है= डाँस । मा० ४.१७.८
दइअ : सं०पू० (सं० देव>प्रा० दइअ)। भाग्य, नियति, कर्मदेव । 'आह दइअ मैं  काह नसावा ।' मा० २.१६३.६
दइउ : दइअ-+कए । भाग्य । 'दाहिन दइउ होइ जब सबही ।' मा० २.२८०.५
दई : भक०स्त्री०ब० । दी। 'असीस सब काहं दई । मा० १.१०२ छं०
दई : भूक०स्त्री० । दी । 'बिधि ''तुम्हहि सुदरता दई ।' मा० १.६६ छं०
दए : भूकृ.पुं० । दिये, दिये हुए । 'जनु बंसी खेलत चित दए।' मा० ६.८८.५
दक्ष : (१) सं००० (सं०) । सती के पिता=शिव के श्वशुर=एक प्रजापति ।  'दक्षमख अखिल विध्वंसकर्ता ।' विन० ४६.७ (२) वि. निपुण । 'यज्ञ रक्षण दक्ष ।' विन० ५०.४ (३) दक्षिण, दाहिना । दक्ष दिशि रुचिर वारीश कन्या।'  विन० ६१.७
दक्षिण : वि० (सं०) (१) दाहिना; (२) दिशाविशेष। विन० ५१.७ 
_______________________________________________
441 
१ 
दखिन : दक्षिण (प्रा० दक्षिण)। 'देखि दखिन दिसि हय हिहिनाहीं ।' मा०  २.१४२.८
दगा : सं०स्त्री० (फा० दगा)। धोखा, विश्वासघात । 'जब पलकनि हठि दगा दई।'  कृ० २४
दगाई : दगा । 'नाम सुहेत जो देत दगाई ।' कवि० ७.९३
दगाबाज : वि० (फा० दगाबाज) । विश्वासघाती, वञ्चक । कवि० ७.१३ दगाबाजि,
जी : सं०स्त्री० (फा० दगाबाजी)। विश्वासघाती का कर्म, धोखा-धड़ी। _ 'सुहृद समाज दगाबाजिही को सौदा सूत ।' विन० २६४.२
दगो : भक००कए । तोप के घोष के समान सर्वत्र विदित । लोक बंद हं लौं  दगो नाम भले को पोच ।' दो० ३७३
दच्छ : दक्ष । (१) प्रजापतिविशेष । मा० १.६०.५ (२) निपुण । 'भवखेद छेदन  दच्छ।' मा० ७.१३ छं० २ (३) दाहिना । 'दच्छ भाग अनुराग सहित इंदिरा  अधिक ललिताई ।' विन० ६२.१२
दच्छिन : दखिन । 'देखु बिभीषन दच्छिन आसा ।' मा० ६.१३.१
दछिना : सं०स्त्री० (सं० दक्षिणा)। यज्ञादि में ब्राह्मणों को प्रदेय द्रव्य । 'विप्रन्ह  पुनि दछिना बहु पाई।' मा० १.२०३.३
दत्त : भूकृ० (सं.)। दिया हुआ, दी हुई। सो ब्रह्म दत्त प्रचंड सक्ति ।' मा०  ६.८३ छं०
ददाति : आ०प्रए० (सं.)। देता है। मा० ६ श्लोक ३
दधि : सं०० (सं०) । दही । मा० १.२०३
दधिमुख : एक वानर-यूथप । मा० ५.५४ दधीच
दधीचि : एक मुनि जिनकी अस्थियों से इन्द्र ने वज्र बनाया था। मा०  २.६५.३; मा० २.३०.७
दनियाँ : दानी+ब० । देने वाले । 'नख सिख सुभग सकल सुख दनियाँ । गी.  १.३४.१
दनुज : सं०पु० (सं०) । कश्यप-पत्नी दनु के पुत्र=दानव जो दितिपुत्र दैत्यों के  साथी थे। मा० १.७ घ दनुजारि,
रो : दनुजों के शत्रु= विष्णु । मा० १.१३६.४
दनुजेश : दनुजों के स्वामी (हिरण्याक्ष आदि) । विन० ५२.२
दनुजेस : दनुजेश ।
दपटि : पू० (सं० दर्प---अट्ट अतिक्रमहिंसयोः>प्रा० दप्पट्ट)। डपट कर, डाँट  कर। मा० ६.८२.५
दपट्टहि : आ०प्रब० डपटते हैं । 'बाहिं हुआहिं अघहिं दपट्टहिं ।' मा० ६.८८.६ 
442 
तुलसी शब्द कोश 
दबकि : पूर्व० । दबा कर, रौंद कर । 'दबकि दबोरे एक ।' कवि० ६.४१
दबत : वकृ०पू० । धसकता, धसकते, दबाते । 'महाबली बालि के दबत दलकति ___भूमि ।' कवि० ६.१६
दबाई : भूक०स्त्री० । दबा ली, दबोच रखी। 'दारिद दसानन दबाई दुनी दीनबंधु ।'  कवि० ७.६७
दाब : दाबि । 'मैं तो दियो छाती पबि, लयो कलिकाल दबि ।' विन० २५९.२
दबोरे : भूकृ००ब० । दबोच लिये, कुचल डाले । कवि० ६.४१
दम : सं०पू० (सं०) (१) दमन, नियन्त्रण । (२) इन्द्रियों तथा मन का निग्रह,  वासनाओं से चित्त को हटाना जो वेदान्त की छह सम्पत्तियों में द्वितीय है।  मा० १.३७.१३
वमंकहिं : दमकहिं । 'जनु दहुँ दिसि दामिनी दमकहिं ।' मा० ६.८७.३
दमंका : दमक । सोइ प्रभ जन दामिनी दमका ।' मा० ६.१३.६
दमक : संस्त्री० । दमकने की क्रिया। चकचौंधने वाली तीखी दीप्ति; बिजली की  तेज चमचमाहट । मा० १.१४.२ । /दमक
दमका : दमक+प्रए० । दमकती है। कहत बचन रद लसहिं दमक जन  दामिनि ।' जा०म० ७२
दमकति : वकृ०स्त्री० । दमकती, चमचमाती । कृ० १८
दमकहि : मा०प्रब० । चमचमाती हैं, तीखी किरणे फेकती हैं। 'चारु चपल जनु  दमकहिं दामिनि ।' मा० १.३४७.४ दमके
उ : भूकृ००कए । चमचमा उठा। 'दमके उ दामिनि जिमि जब लयऊ।'  मा० १.२६१.६
दमकै : दमकहिं । 'दमकै दंतियाँ दुति दामिनि ज्यों ।' कवि० १.३
दमन : (१) वि० (सं०) । संचत करने वाला, दमन करने वाला। 'संसय समन  दमन मन राम सुजस सुख मूल ।' मा० ३.६ क (२) सं०पु । दमन करने की  क्रिया । 'दुवन दल दमन को कौन तुलसीस है।' हनु० ३
दमनीय : भकृ.पु. (सं०) । दमन-योग्य, खण्डनीय । ‘रचेउ न धनु दमनीय ।'  मा० १.२५१
दमन : दमन+कए । एकमात्र दमनकारी। ‘मंगल मूल अमंगल दमनू ।' मा०  २.६.५
दमसीला : वि० सं० दमशील)। मन तथा इन्द्रियों का स्वभावतः निग्रह करने  वाले, संयमी । मा० ७.२२.५
दमानक : सं०स्त्री० (फा० दमान =हाथी, अजगर, सिंह, मगर, नदी, बाढ़, जोश)।  तीव्र आक्रमण, आक्रामक वेग । 'देव भूत पितर करम खल काल ग्रह मोहि पर दवरि दमानक सी दई है। हनु० ३८