896
_______________________________________________
यंत्रित : भूक०वि० (सं.)। नियन्त्रित, नियमित, बद्ध । विन.३९.३
यः : सर्वनाम (सं०) । जो। मा० ६ श्लो० ३
यज्ञोपवीत : सं०पू० (सं०) । जनेऊ । गी० ७.१६.६
यत् : सर्वनाम (सं०) । जो। मा० १ श्लो०६
यत्र : क्रि०वि० अव्यय (सं.)। जहाँ । 'यत्र हरि तत्र नहि भेद माया ।' विन ४७.५
यथा : अव्यय (सं.)। जैसे, जैसा, जिस प्रकार । विन० ५४.४
यथार्थ : वि.+क्रि०वि० (सं० यथार्थ) । सार्थक, सत्य, सप्रयोजन, जैसा है वैसा । 'की मुख पट दीन्हे रहै, यथाअर्थ भाषत ।' वैरा० ११
यम् : सर्वनाम (सं.)। जिसे । मा० १ श्लो० ३
यम : (१) सं.पु. (सं०) । यमराज, कर्मफलों के अनुसार स्वर्ग, नरक आदि की व्यवस्था देने वाला। विन० १०.६ (२) अष्टाङ्गयोग (यम, नियम, आसन, प्राणायाम, प्रत्याहार, धारणा, ध्यान और समाधि) में प्रथम अङ्ग (जिसमें अहिंसा, सत्य, अस्तेय, ब्रह्मचर्य और अपरिग्रह परिगणित हैं) । विन० ५८.६
यवन : सं०० (सं०) । म्लेच्छ । विन० ४६.६
यष्टी : सं०स्त्री० (सं० यष्टि)। छड़ी, लाठी (सहारा)। विन० ६०.८
यस्य : सर्वनाम (सं०) । जिसका-की-के । मा० २ श्लो० १
यह : एह-एहा । मा० १.१२४.८
यहउ : यह भी । 'यहउ कहत भल कहिहि न कोऊ ।' मा० २.२०७.१
यहि : एहि । 'तो यहि मारग लागु ।' विन० २०३.१७
यहु : एह । 'कहहु काहि यहु लाभु न भावा ।' मा० १.२५२.१
यहै : इहै। यही । 'रघुबर रावरि यहै बड़ाई ।' विन० १६५.१
या : (१) सर्वनाम स्त्री. (सं.)। जो। मा० २ श्लो० २ (२) यह (सं० एतद्)। संतराज सो जानिये तुलसी या सहिदानु ।' वैरा० ३३ (३) इस । 'जितिहहिं राम न संसय या महिं ।' मा० ६.५७.५ (यामहि = इसमें) । 'या के' = इसके । मा० ६.१०२.५ 'या को इसको। मा० ६.३३.७
यातुधान : सं०० (सं.)। राक्षा ('मायावी' मूल अर्थ है-~यातु = जादू, माया, इन्द्रजाल)। विन० २६.५
यान : सं०० (सं०) वाहन । विन० १०.४
याभ्यां विना : (सं.) जिन (दो) के बिना । मा० १ श्लो०२
यामिनी : सं० स्त्री० (सं.)। रात्रि । विन० १८.३
यावद् : अव्यय (सं०) । जब तक । मा० ७.१०८.१३
याहि : इसको । 'याहि कहा मैया मुह लावति ।' कृ० १२
याहीं : इसी से, पर । 'याही बल बालिसो बिरोध रघुनाथ सों।' कवि० ५.१३.
_______________________________________________
897
याही : इसी । 'बयो लुनिअत सब याही दाढ़ी जार को।' कवि० ५.१२
युगल : सं०० (सं०) । द्वय, जोड़ा । विन० ५१.६
युत : वि० (सं०) । संयुक्त, सहित । मा० ३ श्लो० २
युवति : (१) सं०स्त्री० (सं०) । तरुणी। (२) युवती।
युवती : (१) सं०स्त्री० (सं०) । स्त्री । (२) युवति, तरुणी । विन० ३६.२
यूथ : सं०पू० (सं.)। सेना की टुकड़ी, समूह । मा० ३.११.१०
ये : (१) सर्वनाम (सं०) । जो सब, जो लोग । 'पश्यन्ति ये ब्रह्मबादी ।' विन ५४.४; मा० ७.१३० श्लो० २ (२)ए। ये सब । 'ये अभागी जीव ।' कवि० ७.८३
यों : अव्यय (सं० एवम्>प्रा० एवं>अ0 एवं) । इस प्रकार । 'यों सुधारि सनमानि जन ।' मा० २.२६६
योग : (१) सं०० (सं.) । अष्टाङ्गयोग, चित्तवृत्ति निरोध या समाधि। 'न जानामि योगं जपं नैव पूजां ।' मा० ७.१०८.१ (२) नाथमत का हठयोग दे० जोगु । (३) विशेष स्थिति (संयोग)। (४) मिलन । (५) ज्योतिष में विशेष ग्रहस्थिति । (६) ज्योतिष के पञ्चाङ्ग का एक अङ्ग । (७) वैद्यक में औषधिमिश्रण।
योगीन्द्र : श्रेष्ठ योगी। मा० ६ श्लो० १
योनि : (१) सं०स्त्री. (सं०)। उद्गम, उत्पत्ति स्थान । (२) विविध जीव जाति । 'भ्रमत जग योनि नहिं कोपि त्राता।' विन० ११.८
# र
रँग : दे० रंग।
रँगमगे : भूकृ०वि००० (सं० रङ्ग-मग्न>प्रा० रंगमग्गय)। (१) उत्साह में लीन । 'महेस आनंद रंगमगे।' पा०म०ई० ११ (२) अरुणिमा आदि में डबे हुए । 'सोहत स्याम जलद मदु छोरत धातु रंगमगे सुगनि ।' गी० २.५०.३
रँगीले : वि०पू०ब० (सं० रङ्गवन्त:>प्रा. रंगिल्लया)। रागयुक्त, अनुरक्त । तिहं काल तिन को भलो जे राम रंगीले।' विन० ३२.५
रँगे : भूक००ब० । रागयुक्त, रजित, रंगे हुए, अनुरक्त। 'खग मृग प्रेम मगन रेंगे रूप रंग ।' गी० १.५३.३
898
_______________________________________________
रँगो : आ०-संभावना-प्रए । चाहे कोई रंग ले । 'चरन चोंच लोचन रंगो चली मराली चाल ।' दो० ३३३
रँग्यो : भूक.पु.कए० । रंगा हुआ+अनुरक्त । 'राम रेग्यो रुचि राच्यो न केहो।' कवि० ७.३६
रंक : (१) वि० (सं.) । दरिद्र, अकिञ्चन । मा० १.८.६ (२) हीन, तुच्छ ।
रंकतर : अतिशय दरिद्र । 'कबहुं दीन मतिहीन रंकतर ।' विन० ८१.३
रंकन, रंकन्ह : रक+संब० । रंकों (ने)। 'लहि जनु रंकन्ह सुरमनि ढेरी' मा० २.११४.५
रंका : रंक । (१) दरिद्र (२) तुच्छ । 'मोहि ते अधिक ते जड़मति रंका ।' मा० १.१२.८
रंकु : रंक+कए । अद्वितीय रंक । 'रंकु नाकपति होइ।' मा० २.६२
रंग, रंगा : सं०० (सं.)। (१) वर्णक (जिसमें रंगा जाय) । 'मृग बिहंग बहु रंग।' मा० २.२४६ (२) प्रेम। हरि रंग रए।' मा० ३.४६ छं० (३) उत्साह । 'कुंभकरन दुर्मद रन रंगा।' मा० ६.६४.२ (४) पंडाल । 'रंग अवनि सब मुनि हि देखाई ।' मा० १.२४४.५ (५) नाट्यादि के दर्शकों, संगीतादि के श्रोताओं का समाज । (६) रञ्जन, हर्षोल्लास । 'मुख प्रसन्न मन रंग न रोषू ।' मा० २.१६६.१
रंगभूमि : संस्त्री० (सं.)। पण्डाल, दृश्य-श्रव्य-शाला। 'रंगभूमि आए दोउ भाई।' मा० १.२४०.५
रंच : वि० । थोड़ा-सा, लेशमात्र । 'रिपु रिन रंच न राखब काउ.।' मा० २.२२६.२
रंचक : रंच । बहुत थोड़ा-सा । 'रति को जेहिं रंचक रूपु दियो है।' कवि० २.१६
रंचौ : रंच भी, लेशमात्र भी । 'बाँची रुचिरता रंचो नहीं।' जा०म०छं० ४
रंजन : वि०पुं० (सं.)। रंगने वाला+अनुरक्त करने वाला, रागयुक्त तथा तन्मय करने वाला । 'कृपासिंधु सेवक मन रंजन ।' मा० १.७०.७
रंजनि : रंजन+स्त्री० (सं० रञ्जनी) । 'सकल जन रंजनि.. रामकथा।' मा. १.३१.५
रंजित : भूक०वि० (सं०) । रंगे हुए । 'रंजित अंजन नैन ।' कवि० १.१
रंतिदेव : सं०० (सं०) । एक सूर्यवंशी राजा जिसने अपना सम्पूर्ण धन दान, यज्ञादि सत्कर्मों में लगाया । उसके यज्ञों में इतनी गो बलियां हुई कि चमड़ों के पहाड़ से चर्मण्वती (चम्बल) नदी निकली। मा० २.६५.४
रंध्र : सं०० (सं०)। छिद्र, बिल । मा० १.११३.२
रंमादिक : रम्भा इत्यादि (देवाङ्गनाएँ) । मा० १.१२६.४
_______________________________________________
899
रई : भूकृ०स्त्री० । रचित, रंगी हई। 'सब की सुमति राम-राग-रंग रई है ।' गी. २.३४.३
रउरें : (दे० राउर) आपको (द्वारा, ने) । 'राम मातु मत जानब रउरें।' मा० २.१८.२
रउरें : (दे० राउर) आपके । 'रउरे अंग जोगु जग को है।' मा० २.२८५.५
रउरेहि : आपको । 'भलेउ कहत दुख रउरेहि लागा।' मा० २.१६.२
रए : भूकृ०० ब० । रंगे हुए+ अनुरक्त । 'जे हरि रंग रए ।' मा० ३.४६ छं०
रकतबीज : सं०पू० (सं० रक्तबीज) । एक असुर जिसके रक्त की बदे पृथ्वी पर  गिरें तो उतनी संख्या में रक्तबीज बन जाते थे। काली ने खप्पर में बूंद-बूद रक्त ऊपर ही लेकर पी लिया, तब वह मारा जा सका। 'पाप'."रकतबीज जिमि बाढ़त जाहीं।' विन० १२८.३
रक्षक : वि० (सं०) । पालक, रखवाला । रा०प्र० ५.५.१
रक्षण : सं०० (सं.)। रक्षा, पालन । विन० २५.४
रखवार, रखवारा : वि०पुं० (सं० रक्षपाल, रक्षपालक>प्रा० रक्खवाल, रक्खवालअ)। रक्षक, बचाने वाला, पालक । 'को रखवार जग खरभरु परा ।' मा०१.८४छं० १६५.३
रखवारी : सं०स्त्री० (सं० रक्षपालिका>प्रा० रक्ख वालिआ) । ब्याघात आदि से बचाने की क्रिया । 'आपु रहे मख की रखवारी ।' मा० १.२१०.२
रखवारे : रखवारा+ब० (प्रा० रक्ख वालय) । बचाने वाले। 'मुनि कोसिक मख __के रखवारे ।' मा० १.२२१.४
रखवारो : रखवारा+कए । एकमात्र रक्षक । ‘रखवारो जगदीस ।' दो० ४०५
रखिअहिं : आ० कवा०प्रए० (सं० रक्ष्यन्ताम् >प्रा० रक्खीअंतु>अ० रक्खीअहिं) । रखे जायें। (१) सुरक्षित कर लिये जायं । 'ए रखिअहिं सखि आँखिन माहीं।' मा० २.१२१.५ (२) रोक लिये जायं । ‘रखिअहिं लखनु भरतु गवनहिं बन ।' मा० २.२८४.२
रखिहउँ : आ० भ० उए । रखगा । 'रखिहउँ इहाँ बरष परवाना !' मा० १.१६६.५
रखिहहिं : आ० भ०प्रब। रखेंगे। (१) रोकेंगे। 'रखिहहिं भवन कि लेहहिं साथा ।' मा० २.७०.५ (२) मान लेंगे। 'रुचि रखिहहिं राम कृपाल ।' मा० १.२८
रगर : सं०स्त्री० । (१) संघर्षण । (२) टेक, आग्रह । 'जनम कोटि लगि रगर हमारी।' मा० १.८१.५
रघु : (१) सं०० (सं.)। सूर्यवंशी राजा विशेष दशरथ के पितामह । मा० १.१८७.५ (२) रघुगोत्र-जैसे, रघुनायक, रघुनंद आदि । 'रघुकुल' । मा० १.६८.७ 'रघुकुल केतू'= रघुकुल में पताका के समान सर्वोपरि राम (आदि)। मा० २.१२६.८ रघुकुलचंदु' = रघकुल में चन्द्रमा के समान आह्लादकारी। मा० १.३५० 'रघुकुल तिलक'=रघुवंश में तिलक के समान श्रेष्ठ । मा० २.५२.१ रघु कुलदीप'= रघुवंश को प्रकाशित करने वाले दीपक के समान =राम । मा० २.३६.७ रघुकुलनायक' = रघुवंश में अग्रणी, श्रेष्ठ= राम । मा० ७.८५.१ रिघुकुलभानु'=रघुवंश में सूर्यवत् प्रकाशकारी= राम मा० १.२७६ 'रघुकुल मनि' == रघुवंश में शिरोमणि । मा० १.११६
रघुचंदु : रघुवंश में चन्द्रमा के समान आह्लाद, शान्ति आदि बिखेरने वाले। मा० २.२३६
रघुनंदन : रघुनंदू । मा० १.२४.८
रघुनंदनु : रघुनंदन+कए । एकमात्र राम । मा० २.१४१.७
रघुनंदू : रघुवंश को आनन्दित करने वाले राम । मा० २.२६३.४
रघुनाथ, रघुनाथा : रघुवंश का स्वामी=राम । मा० १.३८
रघुनाथु : रघुनाथ+कए । एकमात्र रघुवंश का स्वामी राम । 'कह रघुनाथु ।' मा० २.१४६.३
रघनायकु : रघुनाथ । मा० १.७५.८
रघुनायकु : रघुनाथु । मा० २.१३७.५
रघुपति : रघुनाथ । मा० १.८.५
रघुपते : रघुपति+सम्बोधन । मा० ५ श्लोक २
रघुपुंगव : रघुवंश में श्रेष्ठ = राम । मा० ५ श्लोक २
रघुपति : रघुपति । कवि० ६.३४
रघुवंश, रघुवंस : रघुओं का कुल । मा० २ श्लो० ३; १.४८.७
रघुबंसिन्ह : रघुबंसी+संब० (सं० रघुवंशिनाम् ) । रघुवंशियों । "रघुबंसिन्ह महुं जहँ कोउ होई ।' मा० १.२५३.१
रघुबंसी : वि.पु. (सं० रघुवंशिन्) । रघु के कुल की सन्तति । मा० १.२८४.४
रघुबर : रघुपुंगव । मा० १.६.६
रघुबरनि : रघुबर+संब० । रघुवरों= राम आदि चारों भाइयों (को)। 'नेकु बिलोकि धौं रघुबरनि ।' गी० १.२८.१
रघुबीर, रघुबीरा : रघुवंश के वीर पुरुष =राम (आदि)। मा० १.२१, ५०.८
रघुबीर : रघुबीर+कए । राम । मा० २.१४४.४
रघुबीरै : रघुवीर को राम को । 'हृदय घाउ मेरे पीर रघुबीर।' गी० ६ १५.
रघुराई : रघुराय । मा० १.४६.७
रघुराउ, रघुराऊ : रघुराजु (दे० राउ)=रामचन्द्र । मा० २.२६१, १२.३
_______________________________________________
901
रघुराजु : रघुराज+कए । रघुवंशी राजा । (१) रामचन्द्र । मा० १.१३.७ (२) दशरथ जी । 'राजसमा रघुराजु बिराजा ।' मा० २.२.१
रघुराय, रघुराया : (दे० राय) । रघुवंशी राजाराम (आदि) । कवि० ७.१३६  मा० १.२१०.७
रघुरैया : रघुराई । गी० १.२०.२
रघुवर्य : रघुवंश में श्रेष्ठ । विन० ५६.१
रघुसिंघ : रघु कुल में सिंह के समान वीर पुरुष एवं श्रेष्ठ । मा० १.२३४.३
रच, रचइ : आ.प्रए० (सं० रञ्जयति, रचयति>प्रा. रच्चइ)। बनाता-ती है; संवारता-ती है (चित्रित करता-ती है)। 'तप बल रचइ प्रपंचु बिधाता।' मा० १.७३.३
रचत : वकृ०० । रचता । कवि० ७.१७३
रचनाँ : रचना से । 'रचना रुचिरतां मुनि मन हरे।' मा० १.३२० छं०
रचना : (१) संस्त्री० (सं०) । बनाव, सजावट । 'देखत रुचिर बेष के रचना।' मा. ४.२.६ (२) वचन रचना, कथन-शैली, रीति । 'भक्ति बिबेक धर्म जुत रचना । मा० १.७७.५ (३) सृष्टि । 'मान हुँ जग-रचना बिचित्र ।' गी० २.५०.५ (४) कलात्मक निर्माण । 'श्रीनिवास पुर ते अधिक रचना बिबिध प्रकार ।' मा० १.१२६ (५) आडम्बर । 'मिटिग सब कुतरक के रचना ।' मा० १.११६.७
रचहिं : आ०प्रब० (सं० रञ्जयन्ति, रचयन्ति>प्रा० रच्चंति>अ. रच्चहिं) ।  बनाते हैं+ सजाते हैं । 'जन्म महोत्सव रहिं सुजाना ।' मा० १.३४.८ ।
रचहु : आ०मब० (सं० रञ्जयत, रचयत>प्रा० र च्चह>अ० रच्चहु) । सजाओ। 'रचहु बिचित्र बितान बनाई।' मा० १.२८७.६
रचा : भूकृ.पु । बनाया-संवारा। 'यह सँजोग बिधि रचा बिचारी।' मा० ३.१७.८
रचि : (१) कृ० । बनाकर । होइहि सोइ जो राम रचि राखा ।' मा० १.५२.७ (२) सजाकर-संवरकर । 'लछिमन रचि निज हाथ डसाए ।' मा० ६.११३
रचित : (१) भूकृ०वि० (सं.)। निर्मित । 'जनम अनेक रचित अघ दहहीं।' मा० १.११६.३ (२) सज्जित । 'कनक रचित मनि भव ।' मा० १.१७८.६
रचि पचि : गढ़ कर तथा सप्रयास प्रपञ्च करके; विस्तत रचना करके (पचि विस्तारे)। 'रचि पचि कोटिक कुटिलपन ।' मा० २.१८
रचिबे : भकृ०० । रचना करने । 'रचिबे को बिधि जैसे ।' हनु० ११
रचिसि : आ० --- भूक स्त्री०+प्रए । उसने रची। 'अस कहि चला रचिसि मग माया।' मा० ६ ५७.१
रचीं : भूक स्त्री०ब० । बनायीं। 'कहहिं बिरंचि रची कत नारी ।' मा० १.३३४.८
902
_______________________________________________
रची : भूक०स्त्री० । निर्मित की, सजाई । 'मंगल रचना रची बनाई।' मा०. १.२६६.६
रचु : आ०-आज्ञा-मए० । तू रच दे । 'आनि काठ रचु चिता बनाई।' मा०. ५.१२.३
रचे : (१) भक००० (सं० रचित)। बनाये । 'मंगलमय निज निज भवन लोगन्ह रचे बनाइ।' मा० १.२६६ (२) (सं० रञ्जित>प्रा० रचिय) । रंगे, उरेहे । 'कछुक अरुन बिधि रचे सँवारी।' कृ० २२
रचेउ : भूकृ००कए । सजाया। 'इहीं हिमाचल रचेउ बिताना ।' मा० १.६४.२
रचेन्हि : आ०-भूक००+प्रब० । उन्होंने रचा। 'जेहिं रिपु छय सोइ रचेन्हि उपाऊ ।' मा० १.१७०.८
रचेसि : आ०-भक००+प्रए०। उसने बनाया। 'मरन ठानि मन रचेसि उपाई ।' मा० १.८६.५
रचै : (१) रहिं । रचते हैं। 'पूजा को साजु बिरंचि रचे ।' कवि० ७.१४५ (२) भकृ० अव्यय । रचने, बनाने । 'लागे रचें मूढ़ सोइ रचना ।' मा० ५.२५.४
रच्छ : (१) आ०-प्रार्थना-मए० (सं० रक्ष)। तू रक्षा कर । 'हम कहुँ रच्छ राम नमामहे ।' मा० ७ १३ छं० २ (२) वि० (सं० रक्ष)। रक्षक । 'जच्छेस रच्छ तेहि ।' कवि० ७.११५
रच्छक : रक्षक । 'रच्छक कोटि जच्छपति के रे ।' मा० १.१७६.२
रच्छन : रक्षण । 'मुनि मख रच्छन दच्छ।' कवि० ७.११२
रच्छहीं : आ०प्रब० । रक्षा करते हैं । 'भट नगर चहुँ दिसि रच्छहीं।' मा० ५.३ छं० ३
रच्छा : सं०स्त्री० (सं० रक्षा)। बचाव । मा० १.६४
रच्छा-ऋचा : रक्षामन्त्र । 'लगे पढ़न रच्छा-ऋचा ऋषिराज बिराजे ।' गी०
रच्यो : रचे उ । 'सुभ दिन रच्यो स्वयंबर मंगलदायक ।' जा०म० ३
रज : (१) सं००+स्त्री० (सं० रजस्-नपु०) । धूलि । 'रज मग परी निरादर रहई।' मा० ७.१०६.११ (२) पराग । 'सरोज रज।' मा० २ दो १ (३) प्रकृति के त्रिगुण में अन्यतम रजोगुण । 'सत्त्व बहुत रज कछु रति कर्मा ।' मा० ७.१०४.३ (४) रजक, धोबी। 'तिय निदक मतिमंद प्रजा रज निज्न नय नगर बसाई।' विन० १६५.४
रजत : सं०० (सं.)। चांदी । मा० १.११७
रजतेज : (१) राजतेज = राजकीय प्रताप (२) रजोगुणी (क्रोधयुक्त) प्रताप । रावनु सो राजा रजतेज को निधानु भो।' कवि० ५.३२
_______________________________________________
903
रजधानिय, रजधानिनी : रजधानी । 'जन रितुराज मनोज-राज रजधानिय ।' पा०म० ८५
रजधानी : राजधानी । मा० १.२५.६
रजनि : सं०स्त्री० (सं०) । रात्रि । मा० १.२२६.२
रजनिकर : चन्द्रमा।
रजनिचर : निसाचर । मा० १.७ घ
रजनी : रात में । 'इहाँ बसब रजनी भल नाहीं।' मा० २.२८७.७
रजनी : रजनि । मा० १.१.७
रजनीकर : चन्द्रमा।
रजनीचर, रजनीचरा : निसाचर । मा० १.१७९.७; १.९५ छं०
रजनीस, रजनीसा : सं०पू० (सं० रजनीश) । चन्द्रमा । मा० ७.८०.५
रजपूत : सं०+वि०पू० (सं० राजपुत्र) । (१) राजकुमार (२) क्षत्रिय (३) शूरवीर । 'पवन को पूत रजपूत रूरो।' हनु० ३
रजपूतु : रजपूत+कए। क्षत्रिय । 'रजपूतु कही जोलहा कही कोऊ ।' कवि० ७.१०६
रजहिं : रज में । 'गुर पद रजहिं लाग छरु भारू ।' मा० २.२१५.७
रजाइ, रजाई : सं०स्त्री० (अरबी-रजा= सदिच्छा, ईश्वरेच्छा जो अनुकूल या प्रतिकूल हो सकती है)। (१) इच्छा+सम्मति+आदेश । 'निरखि बदनु कहि भूप रजाई ।' मा० २.३६.७ (२) सम्मति । 'दुख वह मोरे दास जनि, मानेहु मोरि रजाइ ।' गी० २.४७.१८ 'मेटि जाइ नहिं राम रजाई।' मा० २.६६.७
रजायस : (दे० आयस) । राजादेश, आज्ञा, अनुज्ञा । 'राम रजायस आपन नीका ।' मा० २.२६६.७
रजायसु : रजायस-+कए। आज्ञा, अनुज्ञा । 'रामहि देखि रजायसु पाई ।' मा० १.३५५.३
रजु : सं०स्त्री० (सं० रज्ज)। डोरी, रस्सी। ‘सोभा रजु मंदर सिंगारू ।' मा० १.२४७.८
रजोगुन : सं०० (सं० रजोगुण) । प्रकृति के त्रिगुण में अन्यतम जिसके कार्य दुःख तथा चंचलता हैं। मा० ७.१०४.५
रज्जी : (सं०) रज्जु में, रस्सी में । मा० १ श्लो० ६
रट, रटइ : आ.प्रए० (सं० रटति-रट परिभाषणे>प्रा० रटइ) । बार-बार बोलता है, अभ्यस्त उच्चारण करता है । 'राम राम रट बिकल भुआलू ।' मा० २.३७.१
रटत : वकृ.पु । रटता-रटते । 'चातक रटत तृषा अति ओही ।' मा० ४.१७.५
रटति : वकृस्त्री० । रटती= अभ्यस्त उच्चारण करती। रिटति रहति हरिनाम।' मा० ३.२६
904
_______________________________________________
रटान : सं० स्त्री० (सं० रटन)। (१) अभ्यस्त उच्चारण । 'चातकु रटनि घटें घटि जाई ।' मा० २.२०५.४ (२) निरन्तर ध्वनि । 'किंकिणी रटनि कटि तट रसालं ।' विन० ५१.६ (३) बकवास (काकरटंत)। 'तव कटु रटनि करउँ नहिं काना ।' मा० ६.२४.४
रटहिं : आ.प्रब० । रटते हैं, शब्द करते हैं। 'रटहिं कुभांति कूखेत करारा ।' मा० २.१५८.४
रटहु: आ०-आज्ञा--मए० । तू अभ्यस्त उच्चारण कर । 'रटहि नाम करि गान  गाथ ।' विन० ८४.३
रटहु : आ०मब० । रटते हो, अभ्यस्त उच्चारण करते हो। 'रटहु निरंतर गुन गन पांती।' मा० ७.२.३
रटि : प्रकृ० । (१) अभ्यस्त उच्चारण करके । 'राम राम रटि भोरु किय ।' मा० २.३८ (२) बकवास करके, निरर्थक बोलकर । 'पर अपबाद भेक ज्यों रटि रटि जनम नसावौं ।' विन० १४२.४
रटै : रटइ । 'रटै नाम निसिदिन प्रति स्वासा।' वैरा० ४०
रटो : (१) रटहु । अभ्यस्त उच्चारण करो। 'रसना निसि बासर राम रटो।' कवि० ७.८६ (२) भूक०कए० । रटा, जपता रहा । 'नाम रटो जम-पास क्यों जाउँ ।' कवि० ७.६२
रढ़ै : रटहिं (सं० रठन्ति -- रठ परिभाषणे>प्रा० रदंति>अ० रढहि) । अभ्यस्त उच्चारण करते हैं। 'बनरा 'जय राम' रढ़े।' कवि० ६.६
रत : वि० (सं० रत, रक्त>प्रा० रत्त)। (१) आसक्त । 'बिषय रत।' मा० ७.१२१.११ (२) तत्पर । 'ब्रह्मचरज रत ।' मा० १.१२६.२ (३) तल्लीन । 'मन क्रम बचन चरन रत होई।' मा० २.७२.८
रतन : रत्न । मा० १.२३.८
रतनाकर : सं०० (सं० रत्नाकर) । (१) रत्नों की खानि । (२) समुद्र । 'तीय रतन तुम्ह उपजिह भव रतनाकर ।' पा०म० ४४
रतनारे : वि०पू०ब० (सं० रक्त-नालिक>प्रा. रत्तनालिय)। लाल रेखाओं से युक्त कोयों वाले (नालिका-कमल की पंखड़ी का नतोदर भाग-कमलदल समान भीतर रक्त रेखायुक्त) । 'नव सरोज लोचन रतनारे ।' मा० १.२३३.४
रता : रत । 'सुख चाहहिं मूढ़ न धर्म रता।' मा० ७.१०२.२
रति : संस्त्री० (सं.) । (१) आसक्ति, राग, प्रेम । 'हरि हर बिमुख धर्म रति नाहीं। मा० १.१०६.१ (२) आनन्द, संभोग, काम केलि । 'चेरी सों रति मानी !' कृ० ४७ (३) शृङ्गार का स्थायी भाव । (४) भक्तिरस का स्थायी भाव= भगवत्प्रेम । “हरि पद रति रस बेद बखाना।' मा० १.३७.१४ (५) कामदेव की पत्नी । मा० १.८७ (६) रती । रत्ती।
_______________________________________________
905
रतिआतो : क्रियाति०पू०ए० । यदि प्रीति (रति) करता । 'राम नाम अनुराग ही जिय जो रतिआतो । स्वारथ परमारथ पथी तोहिं सब पतिआतो।' विन० १५१.५
रतिन : रती+संब० । रत्तियों, गुजाओं। 'रतिन के लालचिन प्रापति मनक की ।' कवि० ७.२०
रतिनाथ : कामदेव । मा० १.८४ छं०
रतिपति : कामदेव । मा० २.९०.८
रती : (१) रति । सुख चैन । (२) सं०स्त्री० (सं० रक्ति>प्रा० रत्ती) । गुञ्जा, गुजा की तौल, घुघची भर । 'काहू की रती न राखी, रावन की बंदि लागे अमर मरन ।' विन० २४८.३ (रावण ने देवों की सब सम्पत्ति छीन ली, रत्ती भर भी न छोड़ी और उनकी सारी चैन भी छीन ली।)
रत्न : सं०० (सं०) । हीरा आदि जवाहरात । मा० ७.२३.६
रत्यो : रति (काम पत्नी) भी । 'रत्यो रची बिधि, जो छोलत छबि छूटी।' गी० २.२१.१
रथ : सं०० (सं०) । स्यन्दन-वाहनविशेष । मा० १.१६५
रथकेतु : रथ की पताका । हनु० ५
रथनि, रथन्ह : रथ+संब० । रथों । रिथनि सों रथ बिदरनि बलवान की।' कवि० ६.४० 'ते तिन्ह रथन्ह सारथिन्ह जोते।' मा० १.२६६.५
रथहि : (छछे) रथ को । 'चले अवध लेइ रथहि निषादा ।' मा० २.१४४.२
रथांग : सं०० (सं०) । चक्रवाक, चकवा पक्षी । 'पिक रथांग सुक सारिका ।'  मा० २.८३
रथारूढ : रथ पर बैठा हुआ। मा० ६.८६.५
रथी : सं०+वि.पु. (सं० रथिन्) । (१) रथस्वामी। (२) रथारूढ । मा० १.२६६.८; ६.८०.१
रथु : रथ-+कए । 'खोज मारि रथु हाँकहु ताता ।' मा० २.८५.८
रद : सं०पू० (सं०) । दांत । मा० १.१४७.२
रदपट : सं०० (सं०) । दन्तच्छद--ओष्ठ । मा० १.२५२.८ रन ; सं०० (सं० रण)। युद्ध । मा० १.२५.५
रनधीर, रनधीरा : युद्धवीर, यद्ध में धैर्यपूर्वक स्थिर रहने वाला। मा० ६.४०%; १.१५३.४
रनभूमि : युद्ध क्षेत्र । मा० ६.१००.८
906
_______________________________________________
रनरस : युद्ध वीर रस- वीर रस के चार भेदों (युद्धवीर, दयावीर, दानवीर और धर्मवीर) में अन्यतम जिसका स्थायी भाव युद्धोत्साह होता है । युद्धोत्साह । 'रन-रस बिटप पुलक मिस फूला।' मा० २.२२६.५
रनरोर : वि० (सं० रण-रोख) । (१) युद्ध में कोलाहल मचाने वाला। (२) योद्धाओं को अतिशय रुलाने वाला । 'देव बंदी छोर रन-रोर केसरी किसोर ।' हनु० १५
रनिवास : सं०० (सं० राज्ञीवास>प्रा० रण्णिवास) । राजा का अन्त:पुर । मा० १.२६५.१
रनिवासहि : अन्तःपुर में। मिलीं सकल रनिवासहिं जाई ।' मा० १.३१८.७
रनिवासा : रनिवास । मा० १.३५६.५
रनिवासु, रनिवासू : रनिवास+कए । मा० १.३३५; ३३६.७
रनी : वि.पु. (सं० रणिन् । रणवीर । गी० ५.३६.३
रनु : रन+कए० । युद्ध । 'रिपु जनु रन जए।' जा०म०/० १७
रबि : सं०० (सं० रवि)। सूर्य । मा० १.११५
रबितनुजा : सूर्यपुत्री- यमुना नदी। मा० २.११२.२
रबिनंदनि, नंदिनी : यमुना नदी । मा० १.२.६
रबिमनि : सूर्यकान्त मणि । जिमि रबिमनि द्रव रबिहि बिलोकी ।' मा० ३.१७.६
रबिसुत : सूर्यपुत्र =अश्विनी कुमार (जो अत्यन्त सुन्दर माने गये हैं तथा देवों के वैद्य हैं)। गी० ७.१७.११
रबिसुता : यमुना नदी । गी० ७.१५.२
रबिसुवन : रबिसुत । गी० ७.८.१
रम रमइ : आ.प्रए० (सं० रमते>प्रा० रमइ) । रमता है, रत होता है, सुख मानता है । 'जेहि कर मनु रम जाहि सन तेहि तेही सन काम ।' मा० १.८०
रमन : सं०पू० (सं०) । (१) स्त्री का प्रेमी (जार) । (२) रमण करने वाला, रत रहने वाला । 'आकिंचन इंद्रिय दमन रमन राम इकतार ।' वैरा० २६ (३) पति । 'रमा-रमन' । मा० २.२७३.५
रमनीय : वि० (सं० रमणीय) | रम्य, मनोहर, रञ्जक, रमण योग्य । 'हरि अवनि रमनीय ।' गी० ७.१६.२ ।
रमा : संस्त्री० (सं.)। (१) (रमण देने वाली) विष्णु की शक्ति -लक्ष्मी । मा० २.२७३.५ (२) सीता (रामचन्द्र की महामाया शक्ति) । मा० ६.१०७ छ०
रमादिक : लक्ष्मी, उमा इत्यादि । जा०म० १३१
रमानाथ : लक्ष्मी-पति = विष्णु । मा० ७.२६
907

रमानिकेत, रमानिकेता : रमानिवास । मा० १.१२८.५
रमानिवास, रमानिवासा : लक्ष्मी (शक्ति) के निवास स्थान विष्णु, राम । मा० ३.१२.१; ७.८३ क
रमापति, रमापती : विष्णु । मा० १.३१७.३, ६.१२१ छं०
रमेउ : भूकृ.पु०कए० । रम गया, विनोदित हुआ। 'रमेउ राम मनु ।' मा. २.१३३.६
रमेस : (सं० रमेश)। (१) रमापति विष्णु । (२) सीतापति = राम । मा० ७.२३ छं० ४
रमेसु : रमेस+कए । विष्णु । 'सदा संकित रमेसु मोहि ।' कवि० ५.२१
रमैया : वि० + सं०० । जगत् में व्याप्त होकर रमने वाला=राम। 'तहाँ मेरो साहेब राख रमैया।' कवि० ७.५३
रम्य : रमणीय (सं०) । मा० १.४४.६
रम्यता : सं०स्त्री० (सं.) । रमणीयता, रञ्जकता। मा० १.२१२.५
रये : रए । रँगे । गी० १.११.४
रयो : भूकृ०० कए० । रंग हुआ, अनुरक्त । 'मन अनुराग रयो है।' गी० ६.११.४
रव : (१) सं०० (सं०) । शब्द, ध्वनि । मा० १.८६ छं० (२) (सं० रय)। वेग, रो। 'आवत देखि अधिक-रव बाजी। चला बराह मरुत गति भाजी।' मा० १.१५७.१
रवकारी : वि० (सं०) । ध्वनि करने वाला-वाले। 'नपुर चारु मधुर रवकारी।' मा० ७.७६.७
रवन : (१) रमन । 'जानत हो सब के मन की गति मदुचितपरम-कृपाल रवन ।'  गी० २.८.१ (२) उपपति, प्रेमी । 'कूबरी-रवन ।' कृ० ४०
रवनि : रवनी । स्त्री, पत्नी । 'गर्भ स्रवहिं अवनिप रवनि ।' मा० १.२७६
रवनिन्ह : रवनि+संब० । रमणियों, स्त्रियों। 'देखत खग निकर मग रवनिन्ह जुत ।' गी० ३.५.४
रवनी, रवनि : (१) सं०स्त्री० (सं० रमणी) । स्त्री, अङ्गना । 'गर्जत गर्भ स्रवहिं सुर-रवनो।' मा० १.१८२.५ (२) प्रिया, पत्नी। 'राम-रवनी को बटु कलि कामतरु है ।' कवि० ७.१३६
रवनू : रवन+कए । पति । 'बहुरि सोचबस भे सिय रवन ।' मा० २.२२७.१
रवा : वि० (फा०)। रमणीय, उत्तम, सार्थक, उपयुक्त । 'समुझेहिं भलो, कहिबो न रवा है।' कवि० ७.५६
रस : सं०० (सं०) । (१) रुचि, राग, प्रीति, वासना । 'बिषय रस रूखे ।' मा०. २.५०.३ (२) स्वाद । 'तुलसी भूलि गयो रस एहा।' वैरा० २८ (३) अमत । 'चंदकिरन रस रसिक चकोरी ।' मा० २.५६.८ (४) निचोड़, सार । 'तुलसी अधिक कहे न रहै रस गुलरि को सो फल फोरे ।' कृ० ४४ (५) मकरन्द, पुष्पसार । गुजत मंजु मत्त रस भृगा।' मा० १.२१२.७ (६) द्रव, स्निग्ध पदार्थ, जल । 'मनहुं प्रेम रस सानि ।' मा० १.११६ (७) स्नेह । 'सानी सरल रस मातु बानी ।' मा० २.१७६ छं० (८) काव्यरस :-शृङ्गार, वीर, करुण, अद्भुत, हास्य, भयानक, बीभत्स, रौद्र और शान्त । 'नव रस जप तप जोग बिरागा।' मा० १.३७.१० (8) व्यञ्जन रस :- मधुर, अम्ल, लवण, कट, कषाय और तिक्त । 'छ रस रुचिर बिजन बहु भाँती।' मा० १.३२६.५ (१०) खनिज औषध (अभ्रक, स्वर्ण, मण्डूर आदि) । 'रावन सो रसराज, सुभट रस सहित, लंक खल खलतो।' गी० ५.१३.२ (११) काव्य का भक्ति रस (जिसमें उक्त नवरसों का समावेश मान्य किया गया है)। हरि पद रति रस बेद बखाना ।' मा० १.३७.१४ (१२) (छह व्यञ्जन रसों के आधार पर) छह संख्या । दो० ४५८ (१३) स्थिति । 'सदा एकहि रस दुसर दाह दारुन दहौं ।' विन० २२५.३ (१४) थोड़ा, धीरे (सं० ह्रस्व>प्रालि रस्स) । 'रस रस सूख सरित सर पानी। मा० ४.१६.५
रसखानि : अधिक सरस, रसपूर्ण । रा०न०८
रसग्य : वि० (सं० रसज्ञ) । स्वाद जानने वाला-वाली । विन० १६७.३
रसन : रसना । जीभ । 'कहै कोन रसन मौन जाने कोइ कोई।' कृ० १
रसनाँ : जीभ से । 'रसनों निसिबासर राम रटो।' कवि० ७.८६
रसना : संस्त्री० [सं०) । (१) जीभ । 'गिरहिं न तव रसना अभिमानी।' मा० ६.३३.८ (२) स्वाद-ग्राहक इन्द्रिय। 'रसना बिनु रस लेत।' वैरा० ३ (३) कटिभूषण (सं० रशना) । करधनी । 'रसना रचित रतन चामीकर।' गी० ७.१७.५
रसभंग : काव्य या नाट्य में रसविरोधी तत्त्व (दोष) आ जाने से रसिक के रसा स्वाद में बाधा आती है उसे मूलत: 'रसभङ्ग' कहा जाता है। लक्षणा से विघ्न या त्रुटि आ जाने पर जो फल प्राप्ति या आनन्द में व्याघात होता है, उसे भी 'रसभङ्ग' कहा जाता है। (१) स्नेह में विच्छेद । 'लग्यो मन बहु भांति तुलसी होइ क्यों रस-भंग ।' कृ० ५४ (२) अपशकुन, अनर्थ, बड़ा ध्याघात । 'रावन सभा ससंक सब देखि महा रसभंग।' मा० ६.१३ ख
रसभंगू : रसभंग+कए । आनन्द एवं पूर्णता में महाव्याघात । 'राम राज रसभंग।' मा० २.२२२.७
रसभेद : (दे० रस) साहित्य शास्त्र में रसों के विविध प्रकार तथा मतान्तर से भक्ति आदि रसों की विविधता । 'भावभेद रसभेद अपारा ।' मा० १.६.१०
909
रसराज : श्रेष्ठ रस, रसों में उत्तम । (१) शृङ्गार रस (जिसका श्यामवर्ण माना गया है) । 'भ्रू पर मसि बिंदु बिराज.." रच्छक राखे रसराज ।' गी० १.२२.६ (२) रसेन्द्र =पारा । 'रावन सो रस राज सुभट रस सहित लंक खल खलतो।' गी० ५.१३.२
रसरीति : (१) काव्य रस की विशेष अभिव्यक्ति शैली-वैदर्भी, गोडी, पाञ्चाली। (२) स्वाद ग्रहण का ढंग। (३) स्नेह-+ भोगविलास की प्रणाली। 'मधुकर रसिक-सिरोमनि कहियत कोने यह रस रीति सिखाए।' कृ० ५०
रससिद्धि : संस्त्री० (सं.) । रसनिष्पत्ति । विभाग, अनुभाव तथा संचारीभाव के योग से रसिक के हृदय में व्यक्त स्थायी भाव (रति आदि) की रसात्मक (आनन्दरूप) परिणति । रस-परिपाका । ‘राम भगति रससिद्धि हित भयउ सो समउ गनेसु ।' मा० २.२०८
रसा : सं० स्त्री० (सं०) । पृथ्वी । मा० २.१७६.२
रसाइनी : वि.० (सं० रासायनिक)। आयुर्वेद के रसायन का ज्ञाता, रस चिकित्सक । रसाइनी समीर सून ।' कवि० ५.२५
रसातल : सं०पू० (सं.) । पाताल लोक । 'रसा रसातल जाइहि तबहीं।' मा० २.१७६.२
रसाल, रसाला : (१) सं०० (सं.)। आम्र। 'देखि रसाल बिटप बर साखा।' मा० १.८७.१ (२) सरस, रसयुक्त । 'कहत अनुज सन कथा रसाला ।' मा० ३.४१.४ (३) स्निग्ध, प्रेमयुक्त । ‘राम सिय सेवक सनेही साधु सुमुख रसाल। गी० ७.१.४ (४) मनोरम, रम्य । चिबुक अधर द्विज रसाल ।' गी० ७.३.४
रसिक : वि० (सं.)। (१) रसयुक्त । (२) रसग्राहक । (३) आसक्त होकर विलासमग्न । (४) प्रेमी, प्रेम का मर्मज्ञ। (५) विषयी, विषयलोलुप । (६) स्वाद लेने वाला-वाली । 'चंद किरन रस रसिक चकोरी।' मा० २.५६.८ (७) काव्य रस की अनुभूति से सम्पन्न सहृदय । 'कबित रसिक ।' मा० १.६.३ (८) मकरन्द+काव्यरस+प्रेम का आस्वादक । ‘मधुकर रसिक सिरोमनि कहियत कोने यह रसरीति सिखाए।' कृ० ५०
रसु : रस+कए०। (१) सार+प्रेम । 'बिलग होइ रसु जाइ।' मा० १.५७ (२) काव्यरस । 'मनहं बीर रसु धरे सरीरा।' मा० १.२४१.५ (३) निचोड़, अमतसार । 'बचन सुनत ससि रसु से।' मा० २.३०४.७ (४) निष्कर्ष+ निष्पत्ति, परिपाक । 'जान प्रीति रसु एतनेइ माहीं।' मा० ५.१५.७ (५) भक्ति रस । ‘राम प्रेम रसु कहि न परत सो।' मा० २.३१७.४ (६) आनन्द (भाव) । 'सो सकोच रसु अकथ सुबानी ।' मा० २.३१८.३
रसेस : सं०० (सं० रसेश)। रसों में श्रेष्ठ। (१) रसराज= शृङ्गार (२) पारा। (३) लवण । 'रुचिर रूप जल में रसेस व मिलि न फिरन की बात चलाई।' कृ० २५
910

रसोईं : रसोई में । 'भयउ रसोई भूसुर मांसू ।' मा० १.१७३.७
रसोई : (१) सं०स्त्री० (सं० रसवती>प्रा. रसवई) । पाकशाला । (२) पाकशाला में पकाने का कार्य । 'जौं नरेस मैं करौं रसोई ।' मा० १.१६८.५
रहँट : सं०० (सं० अरघट्ट>प्रा० रहट्ट) । बालटियों की शृङ्खला से बना यन्त्र विशेष जिससे सिंचाई का काम होता है। 'रहँट नयन नित रहत नहे री।' मा० ५.४६.२
रहँसि : पूक० । रभस-हर्षावेग से भरकर । 'बोलेउ राउ रहेसि मदु बानी।' मा० २.४.१
रहँसेउ : भूक०पू०कए । रभस-वेग से भर गया अथवा रहस-वेग से युक्त हुआ, उल्लसित हुआ । 'सुनि रहँसेउ रनिवासु ।' मा० २.७
रह: (१) रहइ । रहता है । 'लोचन जल रह लोचन कोना ।' मा० १.२५६.२ (२) रहउ । रहे । 'सदा सो सानुकूल रह मो पर ।' मा० १.१७.८ '
रह, रहइ, ई : आ.प्रए० (सं० रहयति = रहति >प्रा० रहइ)। (१) छूटता है। (२) बचा रहता है। 'जौं नहिं जाउँ रहइ पछितावा ।' मा० १.४६.२ (३) निवास करता है, स्थित रहता है। 'एहि बिधि जग हरि आश्रित रहई।' मा० १.११८.१ (४) रुकता-ती है । 'कहि देखा हर जतन बहु, रहइ न दच्छ कुमारि ।' मा० १.६२
रहउँ, रहऊ : आ०उए । रहता-ती हूं । रहूं । 'बरउँ संभु न त रहउँ कुआरी ।' मा० १.८१.५; २.५६.६
रहउ : आ०-संभावना--प्रए.। (१) रहे, रहने दे। 'रहउ चढ़ाउब तोरब भाई ।' मा० १.२५२.२ (२) यथा स्थित रहे । 'कुरि कुआरि रहउ का करऊँ ।' मा० १.२५२.५
रहत : वकृ०पु० । रहता-ते, रुकता-ते । 'उर अनुराग रहत नहिं रोके ।' मा० २.२१६.७
रहति, रहती : (१) वकृ०स्त्री० । रहती, रुकती, बचती । 'रहति न प्रभुचित चूक किये की।' मा० १.२९.५ (२) क्रियाति० स्त्री०ए० । (यदि, तो) रहती। होती जो अपने बस, रहती एक ही रस..'न लालसा रहति ।' विन० २४६.२
रहतु : रहत+कए । रहता । 'मरिबेई को रहतु हौं ।' कवि० ७.१६७ ।।
रहते : क्रियाति.पु.ब० । यदि''तो' रहते । 'जो पैहरि जन के ओगुन गहते। तो कत.. गोप गेह बसि रहते ।' विन० ६७.१-२
रहन : भक० अव्यय । रहने को। 'कोउ कह रहन कहि नहिं काहू।' मा० २.१८५.७
रहनि : सं०स्त्री० । रहने की क्रिया, रहने की रीति, लंग, रखरखाव । 'भरत रहनि समुझान करतूती।' मा० २.३२५.७
_______________________________________________
911
रहब : भक०० । रहना । 'दरसनु देत रहब मुनि मोहू ।' मा० १.३६०.७
रहम : सं.पुं० (अरबी) । दया । 'सब को भलो है राजा राम के रहम ही।' कवि० ६.८
रहस : सं०० (सं० रभस>प्रा० रहस-वेग)। हर्षा वेग, उल्लास । 'सजहिं सुमंगल साज, रहस रनिवासहिं ।' जा०म० १३०
रहसहि : रहस+प्रब० । उल्लसित होते हैं । 'सकल मन रहसहिं ।' पा०म० १२६
रहसि : क्रि०वि० (सं.)। एकान्त में । 'रहसि जोरि कर पति पग लागी ।' मा० ___५.३६.५
रहसी : भक०स्त्री० । हर्षा वेग से भर उठी । 'रहसी चेरि घात जन फाबी।' मा० २.१७.२
रहस्य : सं०पू० (सं.)। (१) मर्म, गुप्त तथ्य । 'यह रहस्य काहं नहिं जाना ।' मा० १.१६६.१ (२) तत्व+मर्म । 'राम रहस्य अनूपम जाना ।' मा० ७.६३.८
रहहिं, रहहीं : आ०प्रब० । (१) रहते हैं। 'खग मग मधुप सुखी सब रहहीं।' मा० १.६६.१ (२) रुकते हैं । 'रहहिं न रोके ।' मा० ६.५२.८ (३) रहें, रुकें। 'बचन मोरि तजि रहहिं घर ।' मा० २.४४
रहहुं : आ० --आशी:--प्रब० । रहें। 'सान कल कोसलपति रह समेत अनंत ।' मा० ६.१०७
रहहु : आ०मब० । रहो । मा० १.१७१.४; २.६१.३
रहा : भक००। (२) निवास किया, स्थित हआ। 'सकल भवन भरि रहा उछाहू ।' मा० १.१०१.६ (२) बचा। 'रहा एक दिन अवधि कर।' मा० ७ दोहा (३) रुका, विराम लिया। 'तदपि कहें बिनु रहा न कोई।' मा० १.१३.१ (४) छूट गया । (५) था। 'रहा प्रथम अब ते दिन बीते ।' मा० २.१७.६
रहि : (१) पू० । रह (कर) । 'रहि न जाइ बिनु किएँ बरेखी।' मा० १.८१.३ (२) रही । 'बिषया हरि लीन्हि न रहि बिरती।' मा० ७.१०१.१ (३) रहीं। 'मातु सब रहि ज्यों गुड़ी बिनु बाय ।' गी० ६.१४.३
रहिअ, ए : आ० भावा० । रहा जाय । इहाँ रहिअ रघुबीर सुजाना। मा० १.२१४.६
रहिअत : वकृ०भावा० । रहा जाता। 'रहिअत न राखे राम के ।' दो० १०२
रहिअहु : आo-आशी:-मब। तुम रहो। "रहिअह भरी सोहाग।' मा० २.२४६
रहिउँ : आ०-- भूक०स्त्री०+उए. ! मैं रही। ता तें अब लगि रहिउँ कुमारी।' मा० ३.१७.१०
912
_______________________________________________
रहिए : रहिअ । 'तुलसी रहिए एहि रहनि ।' वैरा० १७
रहित : भूकृ०वि० (सं.)। हीन, वियुक्त ।' मा० १.६
रहिबो : भकृ.पु०कए० । रहना (चाहिए) । 'तो लौ मातु आपु नीके रहिबो। गी० ५.१४.१ रहिये ; रहिए।
रहिहउँ : आ०भ० उए० । रहूंगा-गी। 'रहिहउँ मुदित दिवस जिमि कोकी।' मा० २.६६.४
रहिहहिं : आ०भ०प्रब० । रहेंगे । 'लखनु कि रहिहहिं धाम ।' मा० २.४६
रहिहि : आ०भ०प्रए । (१) रहेगा, छूटेगा । 'जो जिअत रहिहि बरात देखत पुन्य बड़ तेहि कर सही।' मा० १.६५ छं० (२) मानेगा, रुकेगा। ‘सो कि रहिहि बिनु सिव धनु तोरें।' मा० १.२२३.६
रहिहु : आ० - भूकृ.स्त्री०+मब० । (१) तुम रही हो। 'सती सरीर रहिहु बोरानी ।' मा० १.१४१.४ (२) तम थीं। रहिह उमा कैलास ।' मा० ७.६०
रहिहैं : रहिहहिं । 'जहाँ सजनी रजनी रहिहैं।' कवि० २.२३
रहिहौं : रहिहउँ । 'राम हौं कोन जतन घर रहिहौं ।' गी० २.४.१
रहीं : (१) रही+ब० । थीं। 'प्रथम गए जहं रहीं भवानी।' मा० १.८९.८. (२) स्थित हुई । 'एक टक रहीं।' मा० १.३४६.८
रही : भूक स्त्री० । (१) थी। 'गई रही देखन फुलवाई।' मा० १.२२८.७ (२) स्थित हुई । 'जोरि कर सन्मुख रही।' मा० १.८७ छं०
रहु : आo-आज्ञा-मए । तू ठहर, रुक जा। "झुकी रानि अब रहु अरगानी। मा० २.१४.७
रहें : रहने से । ‘रहें नीक मोहि लागत नाहीं।' मा० २.२८४.४
रहे : भूकृ०पु०ब०। (१) बसे , ठहरे। 'कछु दिन तहाँ रहे गिरिनाथा ।' मा० १.४८.५ (२) थे । 'चलीं तहाँ जहँ रहे गिरीसा।' मा० १.५५.८ (३) स्थित हुए । 'रहे प्रबोधहि पाइ।' मा० १.७३ (४) बचे। 'दंड द्वै रहे हैं रघु-आदित उवन के ।' कवि० ६.३
रहेउँ, रहेऊँ : आ० - भूकृ.पु+उए । मैं था। तब अति रहेउँ अचेत्त। मा०. १.३०; १.१८५.४
रहेउ, रहेऊ : भूकृ००कए । रहा । (१) स्थित रहा। 'तुम्हार पन रहेऊ। मा० १.७७.६ (२) बचा । 'रहेउ एक दिन अवधि अधारा ।' मा० ७.१.१
रहेसि : आo-भूकृ००+मए । 'तू रहा। 'बैठि रहेसि अजगर इव पापी।' मा० ७.१०७.७ (२) तू बच गया । 'जौं त जिअत रहेसि सुरद्रोही।' मा० ६.८४.४
_______________________________________________
913
रहेहु : (१) आ०-भ०+अनुज्ञा-मब० । तुम रहना, ठहरना। रहेहु जहाँ रुचि होइ तुम्हारी ।' मा० २.८२.५ (२) आ०-भूकृ००+मब० । तुम रहे। 'का चुप साधि रहेह बलवाना ।' मा० ४.३०.१
रहैं : रहहिं । मा० १.३२३ छं. १
रहै : रहइ । (१) रहता-ती है । 'सुनत धौर मति थिर न रहै।' मा० १.१६२.३ (२) रहना चाहिए । 'तुलसी न्यारे व रहै ।' वैरा० ४२
रहैगी : आ०भ० स्त्री०प्रए । बचेगी। 'हाथ लंका लाइहैं तो रहेगी हथेरी सी।' ____कवि० ६.१०
रहैगो : ०म०पू०प्रए । रहेगा । 'यों न मन रहेगो।' विन० २५९.२
रहो : रह्यो । रह गया, बचा । 'कहिबो न कछू मरि बोई रहो है।' कवि० ७.६१
रहौं : आ० उए । रहूं, निवास करूं। 'कछु दिन जाइ रहौं मिस एहीं।' मा०
रहौंगो : आ०म०० उए । रहूंगा। 'रघुबीर को ज़ तव तीर रहौंगो।' कवि० ७.१४७
रहो : रहहु । 'रहो आलि अरगानी ।' कृ० ४७
रहौगी : आ०भ०स्त्री०+मब० । रहोगी। गी० १.७२.३
रह्यो : रहेउ । (१) था। 'बास जहें जाको रह्यो।' मा० १.६६ छं० (२) बचा। ___रह्यो सो उभय भाग पुनि भयऊ ।' मा० १.१६०.३
राँक : रंक । दरिद्र, हीन । 'सकल सुख राक सो।' कवि० ५.२५
राँकनि : रंकाह । 'राकनि नाकप रीझि करे। कवि० ७.१५३
राँकु : रांक+कए० । 'राउ होइ कि राकु ।' गी० १.८६.३
राँड़ : सं०स्त्री० (सं० रण्डा)। विधवा (अनाथ स्त्री)। 'सहित समाज गढ़ रांड़ को सो भौडिगो।' कवि० ६.२४
राँडरोरु : (दे० रड़+रोर)। (१) रांड़ स्त्रियों का कलह-कोलाहल । (२) वि०पू० (सं. रण्ड-रोरुद>प्रा० रंडरोरुस)। एकाकी व्यर्थ रोने-चिल्लाने वाला (रण्ड = एकाकी पुत्र पत्नीहीन-रोरुद-अतिशय रोदनशील)। 'आपनी न बूझ न कहे को रांडरोरु रे ।' विन० ७१.१
राँधा : भूकृ०० (सं० राद्ध)। पकाया । 'बिबिध मृगन्ह कर आमिष राधा।' मा० १.१७३.३
राँधे : रांधने से, पकाने से । राधे स्वाद सुनाज ।' दो० १६७
राँध्यो : भूक.पु.कए० । पकाया हुआ। 'लंक नहिं खात कोउ भात संध्यो। कवि० ६.४
राइ : राई । राजा, श्रेष्ठ । 'जादवराइ ।' विन० २१४.२
914
_______________________________________________
राई : (१) राय । राजा, श्रेष्ठ । रघुराई, रिषिराई आदि । (२) संस्त्री० (सं० राजी>प्रा० राई) । श्रेणी, पङि क्त, समूह । बनराई, अंबराई आदि ।
राउ : राय-+कए। (१) राजा । 'दसरथ राउ।' मा० १.१६.६ (२) राजपद । 'राउ सुनाइ दीन्ह बनबासू ।' मा० २.१४६.७ (३) श्रेष्ठ । रघुराउ, मुनिराउ आदि ।
राउत : (१) सं०+वि०० (सं० राजपुत्र>प्रा० राउत्त) । राजकुलीन, नेता; नायक । 'गुह राउतहि जोहारे जाई ।' मा० २.१६१.७ (२) क्षत्रिय वीरपुरुष । 'राढ़उ राउत होत फिरि के जझै ।' विन० १७६.६
राउर : सं०० (सं० राजकुल>प्रा० राउल) । (१) राजपरिवार । 'राउर नगर कोलाहल होई।' मा० २.२३.८ (२) राजभवन । 'गे सुमंत्रु तब राउर माहीं।' मा० २.३८.३ (४) आपका (सम्मानार्थक प्रयोग-जैसे, सरकार का)। राजन राउर नाम जसु ।' मा० २.३
राउरि : राउर+स्त्री०। आपकी (सरकार की)। 'इहाँ न लागिहि राउरि माया ।' मा० २.३३.५
राउरे : ('राउर' का रूपान्तर) (सं० राजपुर>प्रा० राउर)। राजकीय, राजधानी । 'भट भारी भारी राउरे के चाउर से कोडिगो।' कवि० ६.२४
राऊ : राउ। (१) राजा । 'मन मति रंक मनोरथ राऊ ।' मा० १.१.६ (२) श्रेष्ठ । जैसे, मुनिराऊ।
राकस : सं०पू० (सं० राक्षस>प्रा० रक्खस) । निशाचर ।
राकसनि : राकस+संब०। राक्षसों (ने)। 'खाये हुतो तुलसी कुरोग राढ़ राकसनि ।' हनु० ३५
राका : सं०स्त्री० (सं.)। पूर्णिमा की रात्रि । मा० २.३२५.५
राकापति : पूर्णिमा का चन्द्रमा, पूर्ण चन्द । मा० ७.७८ ख
राकेस : राकापति (सं० राकेश) । मा० १.४.३
राकेसु : राकेस+कए । एक विशिष्ट पूर्ण चन्द्र । 'रामरूप राकेसु निहारी । मा० १.२६२.३
राख : (क) संस्त्री० (सं० रक्षा>प्रा. रक्खा>अ० रक्ख) । भस्म । 'राख को सो होम है।' विन० २६४.३ (ख) राखइ । (१) रक्षा करता है, बचाता है। ऐसेहुं दुख जो राख मम प्राना।' मा० ६.६६.१० (२) रक्षा करे, बचाये । "क्रोध भएँ तनु राख विधाता।' मा० १.२८०.५ (३) धारण करता है। राख सीस रिपु नाव ।' दो० ५२०
'राख, राखइ : आ०प्रए० (सं० रक्षति>प्रा० रक्खइ) । रक्षा करता है, बचाता है। 'जिमि बालक राखद महतारी।' मा० ३.४३.५
_______________________________________________
915
राखउँ : आ० उए० । (१) रोकता हं । 'सुमुखि मातु हित राखउँ तोही ।' मा. २.६१.८ (२) रोक रखू । 'राखउँ सुतहि करउँ अनुरोधू ।' मा० २.५५.४ (३) रखता हूं (बचाता हूं) । "इहाँ न पच्छपात कछु राखउँ ।' मा० ७.११६.१
राखत : वकृ०० । (१) स्थित करता। 'वन असोक महँ राखत भयऊ ।' मा. ३.२६.२६ (२) पालन करते । 'राजनीति राखत सुरत्राता ।' मा० ४.२३.१३ (३) रक्षा करते, बचाते । 'राखत नयन निपुन रखवारे ।' कृ० ५६
राखति : वकृ० स्त्री० । रखती, स्थित करती+रक्षित करती। 'कबहूं राखति लाइ हिये ।' गी० १.७.२
राखन : भकृ. अव्यय । रखने । (१) रोकने । 'राय राम राखन हित लागी।' मा० २.७८.१ (२) रक्षा करने । 'मुनि मख राखन गयउ कुमारा ।' मा. ३.२५.५
राखब : भकृ.पुं। रखना, बचाना । 'तात भांति तेहि राखब राऊ।' मा० २.१५२.६
राखबि : भकृस्त्री० । रखनी । 'मया राख बि मन ।' जा०म० १६८
राखहिं : आ०प्रब० (सं० रक्षन्ति>प्रा. रक्खंति>अ० रक्ख हिं) । (१) रक्षा करते हैं । 'राखहि निज श्रुति-सेतु ।' मा० १.१२१ (२) रोकते हैं। 'राखहिं जनकु सहित अनुरागा।' मा० १.३३२.२ (३) धारण करते हैं। 'अवधि आस सब राखहिं प्राना ।' मा० २.८६.८ (४) बचने देते हैं। 'जन अभिमान न राखहिं काऊ ।' मा० ७.७४.५
राखहुं : आo-आशीर्वाद-प्रब०। रक्षा करें। 'देव पितर सब..'राखहुं पलक नयन की नाई।' मा० २.५७.१
राखहु : आ०मब० । (१) रक्षा करो। 'कस न राम राखहु तुम्ह नीती।' मा० १.२१८.७ (२) बचाओ। 'सोउ दयाल राखहु जनि गोई।' मा० १.१११.४ (३) धारण करो। 'तनु राखहु ताता।' मा० ३.३१.५ (४) स्थित करो। 'राखहु सरन ।' मा० ७.१८.६ (५) रोक लो। 'राखहु राम कान्ह यहि अवसर ।' कृ० १८
राखा : (१) भूकृ०० । रक्षित किया। 'ईस्वर राखा धरम हमारा।' मा० १.१७४.२ (२) गुप्त कर लिया। 'रचि महेस निज मानस राखा।' मा० १.३५.११ (३) बचा दिया, छोड़ दिया। 'अब सो सुनहु जो बीचहिं राखा। मा० १.१८८.६ (४) स्थिर किया। 'तहाँ बेद अस कारन राखा ।' मा० १.१३.२ (५) राख इ । बचा सकता है, बचाता है। 'द्विज गुर कोप कहहु को राखा ।' मा० १.१६६.५
राखि : (१) कृ० । रख कर । स्थापित कर । 'चली राखि उर स्यामल-मूरति ।' मा० १.२३५.१ (२) सुरक्षित कर । 'सीतहि राखि गीध पुनि फिरा।' मा० ३.२६.१६ (३) छिपा कर । 'संकर साखि जो राखि कहाँ कछु ।' विन, २२६.६ (४) आ०-प्रार्थना-मए । तू रक्षा कर । 'कहैं तुलसीस राखि ।' कवि० ६.४२
राखिअ : आ.प्रए० (सं० रक्ष्यते>प्रा. रक्खीअइ) । रखा जाय, रखिए। (१) रोकिए। 'राखिअ अवध जो अवधि लगि ।' मा० २.६६ (२) स्थापित कीजिए । 'राखि अ तीरथ तोय तह ।' मा० २.३०६ (४) सुरक्षित कीजिए। 'राखिअ नारि जदपि उर माहीं। मा० ३.३७.६
राखिए, राखिये : राखिम । स्थापित कर बचाइए। 'संकर निज पुर राखिए।' दो २३६
राखिबे : भकृ.पु. (सं० रक्षितव्य>प्रा. रक्खि अध्वय)। बचाने, रक्षा करने । 'मख राखिबे के काज राजा मेरे संग दए।' कवि० १.२१
राखिबो : भकृ०पु०कए। रक्षा करना, बचना। 'मान राखि बो मागिबो।' दो० २८५
राखिसि : आ०-भूकृ०स्त्री०+प्रए। उसने रखी। 'राखिसि जतन कराइ ।" मा० ३.२६
राखिहि : आ०भ०प्रए० (सं० रक्षिष्यति>प्रा. रक्खि हिइ)। रखेगा-गी। 'हठि __राखें नहिं राखि हि प्राना।' मा० २.६८.२
राखिहैं : रखिहहिं । रक्षा देंगे। 'राखिहैं तव अपराध बिसारि।' मा० ५.२२
राखिहै : राखिहि । 'राखि है रामु तो मारिहै को रे।' कवि० ७.४८
राखिही : आ०भ०मब० । रखोगे (रोकोगे)। 'जो हठि नाथ राखि ही मोकहँ ।' गी० २.६.३
राखीं : भूकृ०स्त्री० । रखीं, स्थापित की। 'बस्तु सकल राखी नृप आगें ।' मा १.३०६.२
राखी : (१) राखि। रख कर । 'चलेउ हृदये पद पंकज राखी।' मा० ७.१९.५. (२) भूकृ० स्त्री० । रखी, स्थापित की। 'संकर सोइ मुरति उर राखी ।' मा०. १.७७.७
राखु : आ०-आज्ञा, प्रार्थना-मए०। (१) तू रक्षा कर राख को नर-नारी।" विन० ६३.४ (२) रहने दे, रोक ले। राखु राम कहुं जेहि तेहि भांती ।" मा० २.३४.८ (३) धारण कर । 'प्रभु कहेउ राख सरीरही।' मा० ४.१०. छं० १ (४) स्थापित कर । 'हृदय राखु लोचनाभिरामा ।' मा० ६.५६.६
राखें : क्रि०वि० । (१) रखने से, रोकने से। 'हठि राखें नहिं राखि हि प्राना । मा० २.६८.२ (२) प्रतिपालन करते हुए। 'लोकप करहिं प्रीति रुख राखें ।। मा० २.२.३
_______________________________________________
917
राखे : (१) भूकृ.पु.ब ० । रखे । 'राखे सरन जान सब कोऊ।' मा० १.२५.१ (२) रखे-ही-रखे । 'पिंजरा राखे भा भिनुसार ।' मा० २.२१५ (३) राखें । रखने से । 'लोक राखे निपट निकाई है।' गी० ५.२६.३ (४) रख कर । 'राखे रीति आपनी जो जोइ सोई की ।' कवि० ७.१२२
राखेउँ : आ०- भूक००+उए० । मैंने रखे, बचाये । 'राखेउँ प्रान जानकिहि लाई।' मा० २.५६.२
राखेउ : भूकृ.पु०कए । (१) रक्षित किया। 'मख राखेउ।' मा० १.२१६ (२) स्थित किया, रखा । 'जोगु भोग महँ राखेउ गोई ।' मा० १.१७.२
राखेसि : आ०-भक००+प्रए । उसने रखा, स्थापित किया । 'लै राखेसि गिरि खोह महुँ ।' मा० १.१७१ (२) रहने दिया। 'राखेसि कोउ न सुतंत्र।' मा० १.१८२ (३) उसने धरा, प्रस्तुत किया। दोना भरि भरि राखेसि पानी।' मा० २.८६.८
राखेहु : (क) आ०-भ०+आज्ञा, प्रार्थना+मब। (१) तुम स्थिर कर लेना। 'अब उर राखेहु जो हम कहेऊ ।' मा० १.७७.६ (२) तुम रक्षा करना । 'राखेह नयन पलक की नाईं।' मा० १.३५५.८ (ख) आ०-भूक००+ मब० । तुमने (छिपा) रखा। 'सो भुजबल राखेहु उर घाली।' मा० ६.२६.८
राखै : राखाइ । रख ले, रख सकता है। (१) रोक ले । मिटा सोच जनि राखे राऊ।' मा० २.५१.८ (२) बचा ले। 'के राखै के संग चल ।' दो० ५४४ (३) बचा सकता है। जाहि पालो चाहिए, कही घों, राखै ताहि को।' कवि० ७.१००
राखौं : राख उँ। रख', रहने दूं, बचाऊँ, धारण करूँ। 'राखौं देह नाथ केहि खांगें।' मा० ३.३१.७
राख्यो : राखेउ । 'जद्यपि है दारुन बड़वानल, राख्यो है जलधि गभीर धीरतर ।' कृ० ३१
राग : सं०० (सं.)। (१) रंग, वर्ण । 'सिय अंग लिखें धातु राग ।' गी. २.४४.४ (२) आसक्ति, विषयवासना । 'लोभ न छोभ न राग न द्रोहा।' मा० २.१३०.१ (३) प्रेम+रंग। 'उन्हहिं राग रबि नीरद जल ज्यों।' कृ० ३६ (४) संगीत की स्वरयोजना विशेष । 'सरस राग बाजहिं सहनाई।' मा० १.३४४.२ (५) संगीत में छह रागों, छत्तीस रागिनियों में अन्यतम । 'गावत गोपाल लाल नीके राग नट हैं।' कृ० २० (६) गीत, गेय पद । 'मारू राग सुभट सुखदाई ।' मा० ६.७६.६
रागा : राग, आसक्ति । तेहिं पुर बसत भरत बिन रागा।' मा० २.३२४.७
रागिन : रागी+संब० । रागियों, विषयी जनों। 'रागिन 4 सीठ।' कवि. ७.१४०
918
_______________________________________________
रागिहि : रागी को, विषयी जन को। 'रागिहि सीठ बिसेषि थलु ।' रा०प्र० २.६.१
रागी : वि०० (सं० रागिन्) । रागय क्त, विषयासक्त । 'राजा रंक रागी भो बिरागी।' कवि० ७.८३
रागु : राग+कए । आसक्ति, विषय-वासना । 'रागु रोषु इरिषा मद मोहू ।' मा०. २.७५.५
रागे : भूक.पुब ० । संगीत-राग अलाप उठे । 'गायक सरस राग रागे।' गी० ७.२.१
राघव : सं०० (सं०) । रघुवंशी= राम । गी० ५.१०.१
राघौ : राघव । पहिरावो राघो जू को।' कवि० १.१३
राचहीं : रचहिं । सजाते हैं । 'सुर रूरे रूप राचहीं।' कवि० १.१४
राचा : भूकृ.पुं० (सं० रक्त>प्रा० रच्चिअ)। (१) रंगा। (२) अनुरक्त हुआ। ___ 'सो बरु मिलिहि जाहिं मनु राचा ।' मा० १.२३६.८
राचेउ : राचा+कए० } 'मनु जाहिं राचेउ मिलिहि सो बरु ।' मा० १.२३६ छं०
राच्छस : सं०पू० (सं० राक्षस)। एक मानव जाति पहले रक्षा का कार्य करने से 'रक्षस्' कहलायी। उसकी सन्तान को राक्षस कहा गया । ये पहले लड़का में रहते थे, फिर विष्णु के कोप से पाताल चले गये। उस वंश की कन्या से विधवा मुनि का विवाह हुआ जिससे रावण आदि ने जन्म लिया अत: यह पूरा वंश. 'राक्षस' कहलाया । मा० ६.५४.५
राच्छसी : राच्छस+स्त्री० (सं० राक्षसी) । मा० ५.११.१
राच्यो : राचेउ । 'रुचि राच्यो न केहीं।' कवि० ७.३६
राछस : राच्छस । मा० ५.५७.११
राज : (१) राजा । मा० १.३०६ (२) श्रेष्ठ। मुनिराज । मा० २.५ (३) राज्य।  'नाहिन रामु राज के भूखे ।' मा० २.५०.३ (४) राजइ ।।
राज राजइ : आ०प्रए० (सं० राजति) । शोभित होता होती है। 'भृकुटी बिच तिलक रेख रुचि राजै ।' गी० ७.१२.२
राजकाज : राज्य प्रशासन का कार्य । 'जागै राजा राजकाज ।' कवि० ७.१०६
राजकाजु : राजकाज+कए । कवि० ७.६८
राजगृह : राजभवन । मा० २.१६६
राजघर : राजगृह । कवि० २.४
राजघाट : (१) राजकीय घाट । (२) बड़ा घाट । मा० ७.२६.३ .
राजडगरो : राजमार्ग, सीधी लम्बी-चौड़ी सड़क । 'गुरु कह्या राम भजन नीको, ___ मोहि लगत राजडगरो सो।' विन० १७३.५
राजत : वकृ०० । विराजमान । राजत लोचन लोल ।' मा० १.२५८
_______________________________________________
919
राजति : वक०स्त्री० । शोभित होती। 'पुरी बिराजति राजति रजनी ।' मा० १.३५८.३
राजधरम : राजा का कर्तव्य, राज्य का संविधान, राजनीति । 'राजधरम सरबसु एतनोई।' मा० २.२१६.१
राजधानी : सं०स्त्री० (सं०) । राज्यभूमि का मुख्य नगर जहाँ राजा रहता है। पा०म०/० ११
राजन : (१) सम्बोधन (सं० राजन् । हे राजा। मा० १.२६३.३ (२) राजनि। राजाओं। 'राजन के राजा।' कवि० १.६
राजनय : सं०० (सं.)। राजनीति । मा० २.२८८.४
राजनि, न्ह, न्हि : राजा+संब० । राजाओं । 'सिय के स्वयंबर समाज जहाँ राजनि को।' कवि० १.६
राजनीति, राजनय : संस्त्री० (सं.)। (१) राजप्रशासन की रीति । (२) कूटनीति । 'भरत न राजनीति उर आनी।' मा० २.१८६.६ (३) राजा के शासनोपाय साम, दान, दण्ड और भेद । 'राजनीति भय प्रीति देखाई।' मा० ३.२८.१२
राजपदु : राजपद+कए । राजा का पद, राज्याधिकार । 'नीति न तजिअ राजपदु पाएँ।' मा० २.१५२.३
राजपूतु : रजपूतु । राज्याधिकारी राजकुमार पुत्र । 'राजपूतु पाएहूं न सुखु लयितु है।' कवि० २.४
राजभंग : सं०० (सं०) । ज्योतिष में एक प्रकार का ग्रहयोग जिससे राज्य-प्राप्ति में बाधा आती है; (राजयोग का विलोम) राज्य-व्याघातक योगविशेष । 'राजभंग कुसमाज बड़ गत ग्रह चाल बिचारि ।' रा०प्र० ७.६.१
राजमग : सं०० (सं० राजमार्ग-दे. मग) । लम्बी-चौड़ी पक्की (राजकीय) सड़क । 'कुतरुक सुरपुर राजमग लहल भुवन बिख्याति ।' दो० १६
राजमद : राजा होने का अहंकार । मा० २.२२६.१
राजमदु : राजमद+कए । जरा सा भी राज्याभिमान । 'सब तें कठिन राजमदु भाई।' मा० २.२३१.६ ।
राजमराल, राजमराला : राजहंस । मा० १.१३४; ३.८.१
राजमरालिनि : राजमराल+स्त्री० (सं० राजमराली) । राजहंसी । गी० ३.७.२
राजमहिषी : सं०स्त्री० (सं.)। राजा की (बड़ी) रानी। गी० १.२.१६
राजमारग : राजमग । गी० ५.४२.२
राजरिषि : राजा होते हुए ऋषि, क्षत्रिय ऋषि (सं० राजषि) । गी० ७.३२.२
राजरोगु : राजरोग (सं०) कए० । राजयक्ष्मा, क्षय रोग, तपेदिक । कवि० ५.२५
राजहंस : हंसविशेष जो श्वेत होते हैं और चरण लाल होते हैं । गी० ५.४०.३
920
_______________________________________________
राजहिं : आ०प्रब० । सुशोभित होते-होती हैं। मंदिर महं सब राजहिं रानी।' मा० १.१६०.७
राजहि : राजा को । 'परी न राजहि नीद निसि ।' मा० २.३८
राजहीं : राजहिं । मा० १.३२५ छं० ४
राजाँ : राजा ने । 'राजाँ मुदित महासुख लहेऊ ।' मा० १.२४४.८
राजा : (१) सं०पू० (सं० राजन्) । प्रजार-रञ्जनकारी शासक । मा० १.१३०.२ (२) (समासान्त में) श्रेष्ठ ।
राजाधिराज : (सं०) राजाओं के ऊपर सम्पूर्ण प्रभुत्व-सम्पन्न महाराज सम्राट । गी० ५.५०.६
राजि, राजी : संस्त्री० (सं.) । श्रेणी, समूह । 'कुसुमित नव तरु राजि बिराजा।' मा० १.८६.६
राजिव : राजीव । मा० १.१८.१०
राजी : राजि । मा० १.३००.२
राजीव : सं०० (सं०) । कमल । मा० १.१४८.१
राजु, राजू : राज+कए । (१) राज्य । ‘राजु कि भूजब भरत पुर।' मा० २.४६ 'उलटहुं महि जहँ लगि तव राजू ।' मा० १.२७०.४ (२) राजा । 'मानहुँ राज ___ अकाजेउ आजू ।' मा० २.२४७.६
राजे : भूकृ००ब० । सुशोभित हुए, प्रकाशमान हुए । 'खल भए मलिन साधु सब राजे ।' मा० १.२६५.१
राजैं : राजहिं । गी० १.३१.३
राजै : राजइ।
राज्य : (१) सं०पू० (सं०) । एक शासक के अधीन जनसंख्या से युक्त भू-भाग। विन० ५०.५ (२) शासन। (३) राजा का कर्म ।
राड़ : राढ़। मूर्ख, कायर । 'गजगुन मोल अहार बल महिमा जान कि राड़।' दो. ३८०
राढ़ : विपु । (१) दुष्ट, क्रूर, निष्ठुर । 'खाये हुतो तुलसी कुरोग राढ़ राकसनि ।' हनु० ३५ (२) मूर्ख, कायर लोभी । 'लाज तोरि साजि साज राजा राढ़ रोषे हैं ।' गी० १.६५.१ (३) लङका का एक नाम भी था।
राढ़उ : राढ़ भी, कायर भी । 'राढ़उ राउत होत फिरि के जूझै ।' विन० १७६.६
रात, राता : वि०० (सं० रक्त>प्रा. रत्त) । (१) रंगा हुआ, रंगे हुए। (२) अनुरक्त । 'जिन्ह कर मन इन्ह सन नहिं राता।' मा० १.२०४.२ (३) आसक्त । 'चितवन सठ स्वारथ मन राता ।' मा० ६.८५.८ (४) लाल रंग का।
