242 
_______________________________________________
गुजा : सं०स्त्री० (सं०) । घुघची, रत्ती । गिरि समहोहिं कि कोटिक गुंजा।' 
___ मा० २.२८.५
गुजारहीं : गुजहिं (सं० गुंजा+रुवन्ति>प्रा० गुजारंति> अ० गुजारहिं)।  गुजा= गुञ्जन करते हैं । मा० ७.२६१ छं०
गुड : सं०पु० (सं.)। मधुर ध्वनि, मधुर ध्वनि का संगीत । 'राम सुजस सब  गावहिं सुसुर सुसारेंग गुड ।' गी० ७.१६.४ ।।
गुंडमलार : सं०० (सं० गुण्डमल्लार-गुण्ड=मधुर तान+मल्लार= राम  विशेष) । गोंडमलार नगम का संगीत राग । गी० ७.१९.४
गुच्छ : सं० पुं० (सं०) । स्तवक, गुच्छा । 'गुच्छ बीच बिच कुसुमकली के ।' मा०  १.२३३.२
गुड़ी : सं०स्त्री० (सं० गुडिका>प्रा० गुड्डिया>अ० गुड्डी । पतंग, पंग)। 'जनु ___ बाल गुड़ी उड़ावहीं ।' मा० ३.३० छं०
गुढ़ि : पूक० (सं० घुटित्वा-घुट परिवर्तने>प्रा० घुडिअ>अ० घुडि) । उलट  पुलट कर, घोट-पीट कर, संवार कर । गढि गढ़ि छोलि छाजि कुंद की सी  भाई बातें ।' कवि० ७.६३
गुण : सं०० (सं०) । वस्तु का विशेष धर्म । मा० ५.श्लो० ३ दे० गुन
गुणग्राम : गुण समुह । मा० ३.११.१६
गुणनिधि : गुणों का सागर, सर्व गुण सम्पन्न, कल्याण गुण युक्त । मा० ६.श्लो० २
गुणगार : कल्याण गुणों के आगार । मा० ७.१०८.४
गुथए : भूकृ०पू०ब० (सं०
प्रथिता:>प्रा० गुत्थविया) । गुम्फित, पोहे हुए । 'बचन  प्रीति गुथए हैं।' गी० ६.५.२
गुदरत : वकृ०० (अरबी-गुदर वेवफा)। उपेक्षा या अवज्ञा करते, कृतघ्न ___ होते । 'मिलि न जाइ नहिं गुदरत बनई।' मा० २.२४०.५
गुदरि : पू० कृ० । कृतघ्नता करके । 'प्रभु सों गुदरि निबर्यो हौं ।' बिन० २६६.४
गुदारा : सं० । पहला खेवा (?) (सं० गोदारण =हन्न) लंगर । भर भिलुसार ___ गुदारा लागा।' मा० २.२०२.७
गुन : गुण । (१) रूप-रस आदि द्रव्य-धर्म । (२) माया (प्रकृति) के तीन गुण  -सत्त्व, रजस् और तमस् । 'माया गुन गोपार ।' मा० १.१९२ (३) तीन संख्या (त्रिगुण के आधार पर) दो० ४५६ (४) वैष्णव मन में ब्रह्म के कल्याण गुण सत्य संकल्पता, सत्य कामता, क्षधापिपाखाहीनता, अजरामरता, सर्वकर्तता, सर्वज्ञता, व्यापकता, अन्तर्यासिता आदि। 'नेति नेति कहि जासु गुन करुहिं निरंतर गान ।' मा० १.१२० (५) विशेषता । 'सुनि गुनभेदु समुझि हहिं साधू ।' मा० १.२१.३ (६) शुभ लक्षण । 'कहहु सुता के दोष गुन ।' मा० १.६६  २. 
_______________________________________________
243 
(७) लाभ पुष्टि आदि । 'अद्भुत सलिल सुनत गनकारी।' मा० १.४३.२ (८) गणितीय गुणन-दुगुन आदि (९) दया, ज्ञान, वैराग्य, श्रद्धा आदि मानवीय उदात्त धर्म । 'ग्यान बिराग सकल गुन जाहीं ।' मा० १.११६.६ (१०) वस्तु का अपरिहार्य धर्म । 'जलज जोंक जिमि गुन बिलगाहीं।' मा० १.५.५ (११) रस्सी, धागा, डोरी । 'नाथ एव गुनु धनुष हमारें।' मा० १.२८२.७ (१२) ब्राह्मण के नव सात्त्विक धर्म-शम, दम, तप, शोच, क्षमा, सरलता, ज्ञान, विज्ञान, आस्तिकता। 'नव गुन परम पवित्र तुम्हारें।' मा० १.२८२.७ (१३) अच्छाई । 'बिधि प्रपंच गुन अवगुन साना ।' मा०१.६.४ (१४) चारित्रिक उदात्तता आदि । 'करन चहउँ रघुपति गुन गाहा।' मा० १.८.५ (१५) निष्क लङ्कता, शुद्धता आदि । 'साक बनिक मनि गन गुन जैसे ।' मा० १.३.१२ (१६) काव्य गुण --श्लेष, प्रसाद, समता, समाधि, माधुर्य, ओजस्, सुकुमारता अर्थव्यक्ति, उदारता और कान्ति । 'कबित दोष गुन 
बिबिध प्रकारा।' मा० १.६.१० /गन,
गुनइ : (सं० गुणति-गुण आमन्त्रणे>प्रा० गुणइ-सोच बिचार करना, निर्णय खोजना, मन में तर्क-वितर्क करना या उधेड़ बुन करना, उलझन को मन में सुलझाने का प्रयास करना) आ०प्रए । सोच विचार करता है। 'अस मन  गनइ राउ नहि बोला ।' मा० २.४५.३ गुनउँ,
ऊँ : आ.उए० (सं० गुणामि, प्रा० गुणमि>अ० गुणउँ) (१) सोच बिचार  करता हूँ। 'समुझउँ सुनउँ गुनउँ नहिं भावा ।' मा० ७.११०.५ (२) गुण-दोष पर विचार करता हूं। 'एहि बिधि अमिति जुगुति मन गुनऊँ ।' मा०  ७११२.११
गुनउ : गुण भी । ‘गुनउ बहुत कलिजुग कर।' मा० ७.१०२
गुनकारी : वि.पु. (सं० गुणकारिन्) । लाभकारी (दे० गुन) मा० १.४३.२
गुनखानी : सभी गुणों का उत्पत्ति स्थान । गुणरूपी रत्नों का आकार। मा.  १.१४८.३
गनगन : गण समह। मा० १.३५८.६
गुनगाथा : गुण कीर्तन । गुणों का आख्यान । मा० १.४२.७ गुनगान,
ना : गुण कीर्तन । मा० १.१६६.१
गनगायक : गण कीर्तन करने वाला-वाले। मा० १.३००.५
गुनगाहक : वि० (सं० गुण ग्राहक) । दोषों की उपेक्षा कर केवल गुणों का लेने  वाला।
गुनकहकताई : (दे० गाहकताई) गुण ग्राहिता । मा० ६.२४.५ 
244 
_______________________________________________
गुनगाहकु : गुन गाहक+कए । अनन्य गुण ग्राही । मा० १.२६८.३
गुनग्य : वि० (सं० गुणज्ञ) । गुणों का ज्ञाता, विद्वान् । मा० ४.२३.७ 
नाही : वि.पु. (सं० गुण ग्राहिन्) । गुन गाहक । 'मधुकर सरिस संत गुन  ग्राही।' मा० १.१०.६ ।
गुनत : व०कृ.पु० (सं० गुणन् >प्रा० गुणंत) । (१) सोच विचार करता-करते ।  'सिथिल सनेहँ गुनत मन माहीं।' मा० २.२६२.२ (२) गुणन (गणित)  करता-ते । 'हनत गुनत गनि गुनि हनत जगत जोतिषी काल ।' दो० २४६
गुनति : गुनत+स्त्री० । सोच बिचार करती। कृ० ६०
गुनद : वि० (सं० गुणद)। गुणदायक, लाभकारी। 'बिबुध धारि भइ गुनद __ गोहारी ।' मा० २.३१७.३
गुनधाम : सभी गुणों से सम्पन्न, कल्याणकारी गुणों से युक्त। .
गुनधामा : गुनधाम । मा० ६.१७.६
गुननि : गुन+संब० । गुणों (से) । 'कालकर्म गुननि भरे।' मा० ७.१३.छं० २
गुननिधि : (१) गुनाकर । गुण सम्पन्न । मा० ५.१७.३ (२) पौराणिक कथा में एक  ब्राह्मण का नाम । 'कवनि भगति कीन्ही गुननिधि द्विज ।' विन० ७.३
गनमंदिर : गुणधाम मा० १.१८६.छ०
गुनमय : वि० (सं० गुणमय) । (१) गुणरूप, गुणों का मूर्तरूप+ (२) सूत्ररूप =  सदाचारादिरूप धागों से पूर्ण । 'साधु चरित सुभ चरित कपासू । निरस बिसद  गुनमय फल, जासू ।' मा० १.२.५
गुनमई : गुनमय+स्त्री० । गुण युक्त= त्रिगुणात्मिका । 'जा की विषम माया  गुनमई ।' विन० १३६.४
गुनरहित : प्रकृति के तीन गुणों से परे (फिर भी कल्याण गुण युक्त) । निर्गुण  (+सगुण); विरुद्धनानाधर्माअय= ब्रह्म। वैरा० ४ (२) काव्य के गुणों से  शून्य । 'सब गुनरहित कुकबिकृत बानी।' मा० १.१०.५
गुनरासी : (दे० गुन रहित) । गुणों का पुञ्ज । सर्व कल्याण गुणामय । 'चिदानंदु  निर्गुन गुन रासी ।' १.३४१.६ गुनवंत,
ता : वि.पु. (सं० गुणवत्>प्रा० गुणवंत)। गुण युक्त । मा०  ७.९८.६
गुनवान : गुनवंत । हनु०८
गुनवारि : वि०स्त्री० । गुणों वाली, कल्याण गुण सम्पन्न । 'स्यामधन गुनवारि छवि  मनि मुरलि तान तरंग।' कृ. ५४ 
_______________________________________________
245 
गुनह : सं०पु० (फा० गुनाह ) । अपराध, दोष । 'गुनह लखन कर हम पर रोषू ।' 
___ मा० १.२८१.५
गुनहिं : गुणों में । 'जब तजि दोष गुनहिं मनु राता ।' मा० १.७.१ गुनहु,
हू : आ०मब० (सं० गुणत>प्रा० गुणह>अ० गुणहु) । समझो, मानो। 
__'जनि मन गुनह मोहि करि कादर ।' मा० ६.६.७
गुनाकर : गुणों की खानि; गुणपूर्ण । मा० १.१७.८
गुनागार : गुनधाम । मा० ३.४६
गुनानीत : वि० सं० गुणातीत)। माया के त्रिगुण से परे। 'गुनातीत सचराचर  स्वामी ।' मा० ३.३६.१
गुनानी : गुन+कब० (सं०
गुणा:>प्रा० गुणाणि) । गुण समूह । 'राम अनंत 
__ अनंत गुनानी ।' मा० ७.५२.३
गुनि : पूकृ० (सं० गुणित्वा>प्रा० गुणिअ>अ० गुणि)। (१) सोच बिचार करके ।  'सुनि गुनि कहत निषादु ।' मा० २.२३४ (२) गणना में गुणनफल निकाल  कर । 'हनत गुनत गनि गुनि हनत जगत जोतिषी काल ।' दो० २४६
गुनिन : गुनिए । 'देखिअ सुमिअ गुनिअ मन माहीं।' मा० २.६२.८
गुनिए : आ० कव०प्रए० (संगण्यते>प्रा० गुणीअइ) । विचारिए, समझिए । 'मेरे  जान और कछु न मन गुनिए।' कृ० ३७
गनित : वि० (सं० गुणित) । गुना । 'कोटि गुनित ।' गी० २.६.१
गुनिन्ह : गुनी+संब० । गुणीजनों (से) । 'पूंछेउँ गुनिन्ह रेखतिन्ह खाँची।' मा०  २.२१.७ गुनय,
ये : गुनिअ, गुनिए।
गुनिहि : गुणी को । गनिहि गनिहि साहिब लहै ।' विन० २७४.२
गनी : (दे० गुन) वि.पुं० (सं० गुणिन्) । (१) गुण युक्त । मा० ३.२१.११  (२) भूकृ० स्त्री० । समाकी, सोच-बिचार ली । 'नीके मन गुनी मैं ।' कवि०  ७.२१
गुनु : गुन+कए । (१) विशेषता+ (२) डोरी । 'नाथ एक गुनु धनुष हमारें।'  मा० १.२८२.७
गुप्त : गुप्त । 'गुपुत प्रगट जहँ जो जेहि खानिक ।' मा० १.१.८
गुप्त : भूकृ०वि० (सं०) । छिपा हुआ (रक्षित) ; निगूढ । 'गुप्त रूप अवतरेउ मेभु ।' मा० १.४८ क
गुमान : सं.पु. (फा० गुमान् = शक) । सन्देह । 'ग्यानी भगत सिरमनि त्रिभुवन  पति कर जान । ताहि मोह माया नर पावर करहिं गमान ।' मा० ७.६२ क इसका अभिमान अर्थ में भी हिन्दी प्रयोग होता है । 
246 
_______________________________________________
गुमानी : दिपु । अभिमानी (संशयाल) । 'लोभी जसु यह चार गुमानी ।' मा०  ३.१७.१६
गुमानु : गुमान+कए। अभिमान । 'कलपांत न नास गुमानु असा।' मा०  ७.१०२.छं.
गुर : (१) गुरु । आचार्य । 'गुरगृहं बसहं राम तजि गेहू।' मा० २.५०.४  (२) भारी। धीरज धरम धर निधरहू तें गुर धुर घरनि धरत को।' गी० ६.१२.२ (३) बृहस्पति । 'गुर सन व हे उ करिअ प्रभु सोई ।' मा० २.२१७.८  (४) सं०० (सं० गुड) । मधुर पदार्थ विशेष । गुर
कल : सं०पु० (सं० गुरुकुल) । गुरु वंश, गुरु का आश्रम जहाँ शिक्षस कार्य होता  है। 'राजकुल>राउर' के समान 'गुरु' के अर्थ में भी इसका प्रयोग देखा जाता है। 'तात, तात बिनु बात हमारी। केवल गुरवुल कृपा संभारी।' मा०  २.३०५.५
गुरजन : (सं० गुरुजन) बड़े वयस्क लोग- माता-पिता, अग्रज आदि। मा०  १.२४८
गुरतिय : (सं० गुरु स्त्री) गुरु पत्नी । मा० २.३२०
गुरदछिना : सं०स्त्री० (सं० गुरुदक्षिणा) । शिक्षा, मन्त्र आदि ग्रहण के अनन्तर  आचार्य को दिया जाने वाला धन आदि । मा० ६.५८.४
गुरु : सं०+वि० (सं.)। (१) आचार्य । 'बंदउं गुरु पद पदुम परागा।' मा०  १.१.१. (२) वयस्क जन, अपने से बड़े । 'गीधु मानो गरु, कपि भालु माने मीत
के :' कवि० ७.२४ (३) भारी। 'बंध बर कपि बिभीषन गुरु गलानि गरत ।' दिन० १३४.५ (४) महान, बड़ा, आदरणीय । 'तुलसी गुरु लघुता लहत ।' दो० ३६० (५) पिता-माता । 'गुरु गिरा... राज्य त्यक्त ।' विन० ५०.५ (६) श्रेष्ठ, उत्तम । प्रति छांह बि बि साखि दै प्रति सों कहै गुरु होरि ।' गी० ७.१८.१ (७) बृहस्पति । वचन सुनत सुर गुरु मुसुकाने ।' मा २.२१८.१ (८) बहस्पति दिन । 'सुदि पांचे गुरु दिनु ।' पा०म० ५ (8) गुर  +कए गृड़ । 'मीजो गुरु पीठि ।' बिन० ७६३
गुरुता : सं०स्त्री० (सं.)। भारीपन । 'करहु चाप गुरुता अति थोरी।' मा०.  १.२५७.८
गुरुदिनी : सं+वित्री० (सं० गुर्विणी) । भिणी स्त्री । “गुर बिनी सुकुमारि  सियमनि ।' गी० ७.२६.२
गरू : गरु । अपवृष्ट गरु । कोटि कुटिलमनि गुरू पढ़ाई ।' मा० २.२७.६
गुवि : वि०स्त्री० (सं०
गुव:) । (१) भारी, गरुई । 'डिगति उवि अति गुवि ।" 
_______________________________________________
247 
कवि० १.११ (२) गौरव शालिनी, महती। 'निगम आगम गुवि ।' विन० 
१५५
गुलाम : सं०० (अरबी- गुलाम) । लड़का, सेवक, भृत्य, पाल्य । पालितदास ।  'महाराज को सुभाउ समझत मनु मुदित गुलाम को।' कवि० ७.१४ (२) (दास-प्रथा में) क्रीत-पाल्य । 'साहही को गोतु गोतु होतु है गुलाम  को।' कवि० ७.१०७
गुलामनि : गुलाम+संब० । गुलामों= पालित पुत्रों या पाल्य अनुचरों। 'काम  रिपु राम के गुलामनि को कामतरु।' कवि० ७.१६७
गुलामु : गुलाम+कए । अनन्य पाल्य । 'हौं गुलाम राम को।' कवि० ७.७०
गुलाल : सं० । लाल अबीर, रोली । गी० २.४७.१६
गुलुक : सं०पु० (सं० गुरुफ) । टखना, पैर की ग्रन्थियाँ जो चरण पीठ के ऊपर  दोनों ओर होती हैं। 'चरनपीठ उन्नत नतपालक, गूढ़ गुणक, जंघा कदली  जाति ।' गी० ७.१७.८४
गुसाई : गोसाईं। स्वामी । विन० १४३.१
गुहं : गृहने । 'गाउँ जाति गहँ नाउँ सुनाई ।' मा० २.१९३.८
गृह : सिंगरीर का निषादराज मा० २.१०२.१
गहाँ : गहा में । “गिरिबर गहां बैठ सो जाई ।' मा० ४.६.५
गहा : सं०स्त्री० (सं०) । कन्दरा । मा० ४.१२
गहिबे : भूकृ०० (सं० गुफितव्य>प्रा० गुहिअव्वय)। गूंथने, पोहने । 'तेहि ___ अनुराग ताग गुहिबे कहँ मति मृगनय नि बुलावौं ।' गी० १.१८.२
गहौं : आ० उए० (सं० गुफामि>प्रा० गुहमि> अ० गुहउँ)। गुह दू, पोहूं। 'उबटौं ___ न्हाहु गृहौं चोटिया बलि ।' कृ० १३
गंगेहि : गूंगे को, मूक को, वाणीहीन व्यक्ति को । 'भा जनु गूगेहि गिरा प्रसादू ।'  मा० २.३०७.४
गूढ़ : वि० (सं०) । गुप्त, रहस्यमय, दुर्बोध, सामान्यतः अज्ञेय । मा० १.३० ख
गूढ़उ : गुप्त भी। 'गूढ़उ तत्त्व न साधु दुरावहिं ।' मा० १.११०.२
गढ़ा : गढ़ । मा० १.४७.४
गढाचि : सं० स्त्री० (सं० गूढाचिषु ) । गुप्त ज्योति, अन्तर्यामी रूप से सर्वव्यापक  ब्रह्मज्योति । विन० ५३.६
गढ़ार्थवित : वि० (सं० गूढार्थविद्) । गुप्त पदार्थों का ज्ञाता=अन्तर्यामी=सर्वज्ञ ।  विन० ५४.५ 
248 
_______________________________________________
गूदा : सं०पु० (सं० गोर्द>प्रा० गोछ गुछ)। मस्तिष्क की लुगदी, भेजा। ___'श्रोनितसों सानि सानि गूदा खात सतुआ से ।' कवि० ६.५०
गून : वि.पु. (सं० गुण्य>प्रा० गुण्ण) । गुणनीय, गुना, गुणित । 'अंक रहे दस ___ गून ।' दो० १०
गूल : सं०० (फा०) (१) जालसाजी (मकर-फरेब), छलना । (२) मूख (अहमक) ___ गाल गूल गपत ।' विन० १३०२
गूलरि : सं०स्त्री० । उदुम्बर वृक्ष । गलर फल का वृक्ष जिसके फल के भीतर उड़ने  वाले छोटे कीड़े (भुनगे) रहते हैं । ‘गूलार फल समान तव लंका।' मा०  ६३४.३
गध्र : सं०० (सं.) गीध । विन. ४३.६
गृहे : घर में । 'बालक बृन्द बिहाइ गृहूँ ।' मा० २.८४
गृह : सं०० (सं०) । घर । मा० १.३८.८
गृहकाजु : (दु० काज)। घरेलू काम । मा० २.११४.२
गृहकिकरी : सं०स्त्री० (सं०) । घरेलू काम काज करने वाली दासी । मा० १.१०१
गृहपसु : सं०पू० (सं० गृहपशु)। घरेलू पालतू पशु-कुत्ता (आदि) । 'लोलुप  भ्रम गृह-पतु ज्यों जहँ-तहँ सिर पदत्रान बज ।' विन० ८६.३
गृहपाल : सं०पु० (सं.)। गृहपति, परिवार का स्वामी । विन० १३६८
गृहादी : घर, वृक्ष इत्यादि मूर्त पदार्थ । 'बालक भ्र महिं न भ्रमहिं गृहादी।' मा०  ७.७३.६
गृहासक्त : वि० (सं०) गृहस्थी में संलग्न+पत्नी में अनुरक्त = रागयुक्त । मा०  ७.७३ क
गृही : वि० सं० गृहिन्) । गृहस्थ, गृहस्वामी, गाहर्थ्य नामक आश्रम में स्थित, ___ दारधर्म का पालन करने वाला। मा० २.१७२ गेंड
आ : सं०० (सं० गेन्दुक>प्रा. गेंडअ) । तकिया, सोते में सिर के नीचे __रखने वाला
उपधान : 'करत गगन को गेंडुआ सो सठ तुलसीदास ।' दो० ४६१
गे: (१) गए । 'प्रात क्रिया करि गे ग र पाहीं।' मा० १.३३०.४ (२) भविष्य  दर्थक विकारी शब्द-पु.बहु० । 'आवहिंगे' इत्यादि ।
गेरु : सं०० (सं० गैर =गरिक>प्रा. गेर=गेरिअ) । पर्वत से निकलने वाली 
__ लाल खड़िया । मा० ३.१५.१
गेहँ : घर में । 'नपु गयउ कैकई गेहें।' मा० २.२४
गेह : सं०० (सं०) । घर । मा० १.७८
गेहा : गेह । मा० १.६२.५
गेहिनी : सं०० (सं०) । गृहिणी, पत्नी, गृहस्वामिनी । विन० ५८.७ 
_______________________________________________
249 
गेहु,
हूँ : गेह+कए० । 'गर गहँ बसहं राम तजि गेह ।' मा० २.५०.४
गै : गइ। (१) गई। बीती। 'मरुछा गै बहोरि सो जागा ।' मा० ६.८४.३  (२) खोई हुई। 'गै मनि मनहं फनिक फिरि पाई।' मा० २.४४.३  (३) (सहायक क्रिया) । खेलत रहा सो होइ गै भेदा ।' मा० ६.१८.३
गया : गाय । 'हेरि कन्ह गोबर्धन चढ़ि गया।' कृ० १६
गहहिं : गाइहैं (सं० गास्यन्ति>प्रा० गाइहिति>अ० गाइरिहि)। गायेंगे, कीर्तन  करेंगे । 'नारमादि जस गैहहिं ।' मा० ५.१६.५
गैहैं : गाइहैं । 'कबि कुल कीरति गैहैं।' गी० १.५०.३
गैहै : आ०भ०प्रए० (सं० गास्यति>प्रा० गाइहिइ) । गायेगा, कीर्तन करेगा।  'तुलसीदास पावन जस गैहै ।' गी० ५.५०.६ ।।
गेहौं : आ०भ० उए० (सं० गास्यामि>प्रा० गाहिनि -गाइहिमि >अ० गाइहिउँ  >गाइहउँ.>गाइहौं) । गाऊँगा। गाऊँगी। 'रसना और न गैहौं ।' विन०  १०४.३
गोंड़ : सं०० (सं० गोण्ड) । शूद्र जाति विशेष । 'गोंड़ गवार नेपाल महि ।'  दो० ५५६
गो : सं०पु+स्त्री० (सं.)। (१) गाय । “गो द्विज हितकारी।' मा०  १.१८६.छं १ (२) इन्द्रिय । 'माया गुन गो पार ।' मा० १.१६२ (३) पृथ्वी। 'गो खग, खे खग, बारि खग ।' दो० ५३८ (४) गयो । गया। 'बंक गढ़ लंक सो ढका ढकेलि ढाहि गो।' कवि० ६.२३ (५) बीता । 'न कूदिबे को पलु गो।' कवि० ४.१ (६) समाप्त हआ। 'औरनि को कल गो।' कवि० ४.१ (७) भविष्य सूचक बिकारी शब्द-पु०ए० । 'टूट्यो सो न जुरैगो।' कवि० १.१६ (८) रूप में बदला, परिणत होकर समाप्त हो गया । 'सब होइ न गो।'  मा० ६.१११.१५
गोइ : पूकृ० (सं० गोपित्वा>प्रा. गोविअ>अ० गोवि)। गुप्त रखकर, छिपा  कर । 'राखेउँ कछु नहिं गोइ।' मा० ७.१२३ ख
गोइयाँ : संपूब० । खेल के साथी जो एक पाली में साथ-साथ विपक्ष पाली के  विरुद्ध खेलते हैं। 'गभि गनि गोइयाँ बांटि लये ।' गी० १.४५.१
गोइहि : आ०भ०प्रब० (सं० गोपिष्यन्ति>गोविहिति>अ० गोविहिहिं) ___छिपाएंगे । निरखि नगर नर नारि बिहंसि मुख गोइहहिं ।' पा०म० ५७
गोई : भूकृस्त्री०बहु । छिपाईं, रक्षित की। ‘फनिकन्ह जनु सिर मनि उर गोईं।'  मा० १.३५८.४
गोई : (१) गोइ। छिपा कर । 'लोचन ओट बैठु महु गोई ।' मा० २.३६.६ 
250 
_______________________________________________
ही छिपायी। 
(२) भक०स्त्री० (सं० गोपायिता>प्रा० गोविआगोविई)। हि 
'ऐसिउ पीर बिहंसि तेहिं गोई।' मा० २.२७.५
गोऊ : आ० अज्ञा मए । तू छिपा रख। 'कृपिन ज्यों सनेह सो हिये सुमेह गोऊ।'  गी० २.१६.३
गोए : भकृ०० (सं० गोपित>प्रा० गोविय) ब० । छिपाये । 'जे हर कमल हृदय ___महुं गोए ।' मा० १.३२८.५
गोकुल : सं०० (सं०) (१) गो समूह (२) मथुरा मण्डल का एक भू-भाग ।  कृ. ४२
गोखुरनि : गोखुर+संब० । गाय के खुरचिह्नों (में) । 'कुंभज के किंकर बिवल  बूड़े गोखुरनि ।' हनु० ३८
गोगन : इन्द्रियगण विन० २६१.३
गोधात : सं०० (सं०) । गोवध, गोहत्या मा० ६.३२ २
गोचर : सं०० (सं०) । गो-इन्द्रियों के विचरण की वस्तु =विषय । 'इन्द्रिय  बोध्य पदार्थ । प्रत्यक्ष । 'लोचन गोचर सुकृत फल ।' मा० २.१०६
गोठ : सं०पू० (सं० गोष्ठ>प्रा० गोट) । खरिक, गायों का निवास स्थान, गायों का  बाड़ा, ब्रज। मा० २.१६७.५
गोड़ : सं० । पैर । 'गड़त गोड़ मानो सकुच पंक महं।' गी० २.६६.३
गोड़ान : गोड़+संब० । पैरों । 'कमठ की पीठिजा के गोड़नि की गाड़े मानो।'  हनु० ७
गोड़िए : आ.-कवा०-प्रए० । खोदिए, कुदाल से संवारिए । 'तुलसी विहाइ के  · बबूर रेंड गोड़िए।' कवि० ७.२५
गोड़ियाँ : सं०स्त्री०ब० । बच्चों के सुन्दर कोमल पैर (गोड़)। 'छोटी-छोटी 
___ गोड़ियाँ अंगुरियाँ छबीली छोटीं।' गी० १.३३.१
गोत : सं०० (सं० गोत्र प्रा. गोत्र) । वंश परम्परागत जाति जो पूर्व पुरुष के नाम  से चलती है।
गोतीत : गोपर (सं.)। इन्द्रियातीत, अतीन्द्रिय । 'अविगत गोतीत चरित पुनीतं ।'  मा० १.१८६.छं० ३
गोतु : गोत + कए । एक ही गोत्र । ‘साह ही को गोतु गोतु होत है गुलाम को।' __कवि० ७.१०७
गोतो : सं००कए० (अरबी-गोतः) । डुबकी । 'ज्यों मुदमय बसि मीन बारि  तजि उछरि भभरि लेत गोतो।' विन० १६१.३।
गोद : संस्त्री० । कोड़, गोदी, अंकवार, अङ कपाली । मा० १.७२.६
गोदहि : गोदा-गोदावरी को । 'पंचवटी गोदहि प्रनाम करि।' मा० ३.११.२
गोदावरि : गोदावरी । मा० ३.३०.५
गोदावरी : सं० स्त्री. (सं.) । दक्षिण की एक नदी । मा० ३.१३ 
_______________________________________________
251 
गोधन : सं०५० (सं०) । पालित पशु-समूह । 'दूध दधि माखन भो, लाखन गोधन  . धन ।' कृ० १६
गोप : सं०० (सं.)। ग्वाला । कृ० १७
गोपद : गाय का ख़र, खुरका चिह्न (जिस में वर्षा जल भर जाता है) । 'गोपद जल  बड़हिं घट जोनी।' मा० २.२३२.२
गोपर : वि० (सं०) गो=इन्द्रिय से परे, अतीन्द्रिय । मा० ३.३२ छं० २
गोपार : गोपर । इन्द्रिय बोध से पार =परे । 'माया गुन गो पार ।' मा० १.१६२ गोपहिं आ०प्रब० (सं० गोपायन्ति>प्रा० गोप्पंति>अगोप्पहि)। छिपाते हैं ।  प्रेम प्रमोद परस्पर प्रगटत गोपहिं ।' जा०म० ८५
गोपाल : सं०० (सं.)। (१) ग्वाला, अहीर, पशुपालक । (२) इन्द्रियों का 
___ स्वामी कृष्ण, गोचारक अवतारी ब्रह्म । कृ० ४ गोपिकनि गोपिका+संब० । गोपिकाओं । 'गोपिकनि पर कृपा अतुलित कीन्ह ।' 
विन० २.४.३
गोपिका : गोपी । विन० १०६.४
गोपित : भूकृ० (सं०) । गृहित, छिपाया, तोपदिया । 'खनि गर्त गोपित बिराधा ।'  विन० ४३.५
गोपी : सं०स्त्री० (सं०) । ग्वालिन । कृ० १७ कृष्ण भक्तिमत में 'गोपी भाव' एक  महा भाव है जिसे उपलब्ध कर भक्त अपने को गोपीवत् कृष्ण की प्रेमिका मान  कर मधुर-रति में लीन रहता है।
गोप्यमपि : (सं.) गोप्यम्+अपि । गोपनीय भी। ‘गोप्यमणि सज्जन करहिं  प्रकाश ।' मा० ७.६६ ख
गोबर : सं०पू० (सं० गोमय>प्रा० गोवर) । गाय-भैस का पुरीष । दो० ७३
गोबर्धन : सं०० (सं० गोवर्धन) । ब्रजमण्डल में एक पर्वत । कृ० १६
गोविद : सं०० (सं० गा विन्दते इति गोविन्दः) । गायों को प्राप्त करने वाला+  इन्द्रिय धारण कर अवतीर्ण होने वाला=इन्द्रियाधीश । कृष्ण । परमात्मा ।  मा० ३.३२.छं० २ .
गोमति : सं०स्त्री० (सं० गोमती) । एक नदी । मा० २ १८८.८
गोमती : गोमती नदी में । 'सई उतरि गोमती नहाए।' मा० २.३२२.५
गोमर : सं०० (सं.) । गाय मारने वाला, गोमांसव्यवसायी । 'कामधेनु धरनी,  कलि गोमर ।' विन० १३६.६ ।
गोमाय : संपु० (सं० गोमाय) । सियार । मा० ६ ७८ छं०
गोमुख : क्रि०वि० (सं०) । गाय के सम्मुख, गाय की ओर । ‘देखि हैं हनुमान गोमुख  नाहरनि के न्याय ।' विन० २२०.७ 
252 
_______________________________________________
गोयो : भूक००कए० (सं० गोपितम>प्रा. गोविअं>अ० गोवियउ) ।  छिपाया। 'मैं निज दोष कछु नहिं गोयो।' वि० २४५.४
गोर : वि०० (सं० गौर>प्रा० गोर) । गौरवर्ण । रान० १२
गोरख : सं०० (सं० गोरक्ष>प्रा. गोरकख)। योगी गोरखनाथ जो हठयोग  प्रणाली के प्रचारक तथा नाथपंथ के प्रवर्तक थे। 'गोरख जगायो जोगु ।' कवि०  ७.८४
गोरस : सं०पु० (सं.) । दही, दूध आदि । (मुख्यतः) दही । कृ०३
गोरसहाई : वि०स्त्री०ब० (सं०
गोरस-धान्य:>प्रा० गोरसहाईओं>अ० गोरस  हाईई)। ग्वालिने । गोरस रखने वाली स्त्रियाँ । ग्वालिनी गोरसहाई ले-ल  आईं बावरी दाँवरी घर-घर तें ।' कृ० १७
गोरी : वि०स्त्री० (सं० गौरी>प्रा० गोरी)। गौरवर्णा । 'गोरी सोभा पर तन  तोरी।' कवि० १.१४ ।
गोरे : 'गोर' का रूपान्तर । गौरवर्ण । 'सहज सुभाय सुभग तन गोरे ।' मा०  २.११७५
गोरो : गोर+कए । 'गोरो गरूर गुमान भरो।' कवि० १.२०
गोरोचन : सं०पु० (स्त्री)। एक प्रकार का सुगन्धित माङ्गलिक द्रव्य जो उत्तम  गाय के पेट से निकलता है । मा० ७.७७.५
गोलक : संपु० (सं.)। (१) गोला। (२) आँख की पुतली । पलक विलोचन  गोलक जैसें ।' मा० २.१४२ १
गोला : गोलक (प्रा० गोलअ) । तोप आदि से फेंका जाने वाला गोलाकार प्रहरण !  मा० ६.४६ छं०
गोली : सं०स्त्री० (सं० गोलिका)। (१) बच्चों का विशेष खिलौना। गोली  भौंरा चक डोरि ।' गी० १.४३.३ (२) बन्दुक आदि का छोटा गोला । गोली  बान सु मंत्र सर ।' दो० ५१६
गोवति : वकृस्त्री० (सं० गोपायन्ती>प्रा० गोवंती)। छिपाती । 'सचि गात  गोवति कमठी ज्यों।' कृ० ६०
गोसांई : गोसाईं। मा० २.२६७.४
गोसाँई : गोसाईं। मा० २.२५१.२
गोसाई: गोसाईं। मा० २.६४
गोसाई : सं०+वि०पु० (सं० गोस्वामी>प्रा. गोसामी) । पालक, स्वामी  (इन्द्रियों पर प्रभुता रखने वाला) । मा० १.५६.२
गोसुत : बछड़ा, बछड़े । कृ. १८ गोहारि,
री : सं०स्त्री० । (१) रक्षा। 'कीनि गोहारी आनि ।' दो० ५३६  (२) रक्षक, शरण । 'विबुध धारि भइ गुनद गोहारी।' मा० २.३१७.३
गौं : ग। (१) अवसर, दाँव । 'जो हम तजे पाइ गौं मोहन ।' कृ०६ (२) गम 
_______________________________________________
253 
चाल, गति । 'चलत मत्त गज गौं हैं।' गी० १.६३.३ (३) लक्ष्य, धागा 
'गौं है तकत सुभौंह सिकोरे ।' गी० ३.२.४
गौड़मलार : गुडमलार । राग विशेष । 'गावै सुहो गोंडमलार ।' गी० ७.१८
गौतम : सं.पु० (सं०) । एक मुनि == अहल्या के पति =शतानन्द मुनि के पिता = ___जनकवंश के पुरोहित । मा० १.२१०
गौन : गवन । कवि० ७.४४
गौनु : गवनु । मा० २.१६०
गौने : गवने । गये । 'समउ केलि गृह गौने। गी १.१०७.३
गौर : वि० (सं.) । गौरवर्ण, उज्ज्वल । मा० १.७२
गौरव : सं०० (सं०) । नहत्त्व, गरिमा । मा० २.१३२.८
गौरि : गौरी । मा० १.१५
गौरी : सं०स्त्री० (सं.)। पार्वती ।
गौरीनाथ : शिव जी । कवि० ७.१६६ गौरीस,
सा : सं०० (सं० गौरीश)। शिव । मा० ६.२८
ग्याता : वि.पु. (सं० ज्ञात, ज्ञाता)। जानकार, विद्वान्, ज्ञानवान् । मा०  मा० २.१४३.२ ।।
ग्याति : सं०स्त्री० (सं० ज्ञाति) । बन्धु-बान्धव, भाई बन्धु, वंश सम्बन्धी । मा०  १.२१४
ग्यान : सं.पु. (सं० ज्ञान)। (१) बोध, प्रत्यय । 'रूप ग्यान नहिं नाम बिहीन।'  मा० १.२१.४ (२) चेतनगुण =चैतन्य या संवेदन । ग्यानधन' आदि । (३) शास्त्रीय बुद्धि । 'कहब ग्यान बिग्यान बिचारी।' मा० १.३७.६ (४) योग साधना से साक्षात्कार । 'सदगुर ग्यान बिराग जोग के ।' मा० १.३२.३ (५) ज्ञाननिष्ठा जो भक्तिरूप होती है। ग्यानगम्य जय रघुराई ।' मा०  १.२११ छं० (६) विवेक । 'उपजा ग्यान बचन तब बोला ।' मा० ४.७.१५
ग्यानगम्य : वि० (सं० ज्ञानगम्य)। स्वसंवेदनसिद्ध, ज्ञाननिष्ठा (भक्ति) की  अपरोक्ष अनुभूति से प्राप्य (ऐन्द्रिय बोध से अप्राप्य)। 'ग्यान-गम्य जय  रघुराई ।' मा० १.२११ छं.
ग्यानधन : घनीभूत ज्ञानरूप, चैत-यमय, संवेदनों के आधार । मा० ६.१११ छं०
ग्यानदृष्टि : योगी की अपरोक्षानुभूति, दिव्यदृष्टि जो अदृश्य को भी दृश्य बनाती  है। मा० ६.५७ ६
ग्यानवंत : वि.पुं० (सं० ज्ञानवत)। ज्ञानी, योगजनित परसाक्षात्कार तथा शास्त्रीय  ज्ञान-सम्पन्न, परमतत्त्व का द्रष्टा । पयानवंत कोष्टिक मह कोऊ। जीवनमुक्त सकत जग सोऊ ।' मा० ७.५४.४ 
254 
_______________________________________________
ग्यानातीत : ऐन्द्रिय प्रत्ययों से तथा शास्त्रीय ज्ञान से पर। 'माया गुन ग्यानातीत  अमाना।' मा० ७.१६२.६
ग्यानिन्ह : ग्यानी+संब० (सं० ग्यानिनाम्) । ज्ञानियों । जो ग्यानिन्ह कर चित  अपहरई ।' मा० ७.५६.५
ग्यानी : ज्ञानी ने । 'बैठत सकल कहेउ गुर ग्यानीं ।' मा० १.२४७.१
ग्यानी : ग्यानवंत (सं० ज्ञानिन्) । मा० १.२२.७ ग्यानु,
न : ग्यान+कए । विवेक, समझ । 'भाबी बसन ग्यानु उर आरा ।' मा०  १.६२.७ (२) आत्म साक्षात्कार, परमात्मानुभूति । ‘भएँ ग्यान बरु मिट न मोहू ।' मा० २.१६६.३ (३) व्यावहारिक वस्तु बोध । 'रहा न ग्यानु न धीरजु लाजा ।' मा० २.२७६.७ (४) अपरोक्षानुभूति, प्रकृतिपुरुषविवेक । ' सोहन राम पेम बिनु ग्यानू ।' मा० २.२७७.५ (५) शास्त्रीय बोध । 'लखि गति ग्यानु बिरागु बिरामे ।' मा० २.२६२.१
ग्रंथ : सं०० (सं०) । प्रबन्धात्मक शब्दरचना । शास्त्र । मा० ७.१२२.१४ ग्रंथनि,
न्हि : ग्रंथ+संब० । ग्रन्थों (मैं ने आदि) । 'सृष्टि हेतु सब ग्रंथनि गाये।'  मा० ५.५६.३ 'सुर दुर्लभ सब ग्रंथन्हि गावा।' मा० ७.४३.७
ग्रंथि : सं०स्त्री० (सं०) । (१) गांठ, जोड़। 'जड़ चेतनहिं ग्रंथि परि गई।' मा०  ७.११७.४ (२) मानसिक उलझन, भावग्रन्थि । 'भ्रमित पुनि समुझि चित प्रथि अभिमान की।' विन० २०६.४ (३) विवाह आदि में जोड़ी जाने वाली गाँठ;  गठबन्धन
प्रथिबिधि : संस्त्री० । वर-वधु के वस्त्रों में बांधी जाने वाली वैवाहिक रीति ।  पा०म० १३२
ग्रंथित : भूकृ० (सं.)। ग्रन्धिविधि से बँधे हुए। 'ग्रथित चूनकी पीत पिछोरी।'  गी० १.१०५.३ प्रस,
असइ : (सं० ग्रसति--- ग्रस अदने>प्रा० गसइ>अ० ग्रसइ-खाना, निगलना, घेरना, पकडना-ग्रासयति-ग्रस ग्रहण) । आ.प्रए० । पकड़ता है,  निगलता या घेरता है । 'ग्रसइ राहु निज संधिहि पाई ।' मा० १.२३८.१
प्रसत : वकृ०० । घेरते, ग्रास करते, निगलते । मा० ५.३६
प्रसन : (१) सं०० (सं.)। निगलना । 'मानहुं ग्रसन चहतहहिं लंका।' मा०  ५.५५.८ (२) वि० । निगलने वाला। 'संसय सर्व ग्रसन उरगादः ।' मा०  ३.११६
प्रससि : आ०मए० (सं.)। तू निगल या घेर । 'ग्रससि न मोहि कहा हनुमाना।'  मा० ५.२.६ 
_______________________________________________
255 
प्रसि : पूर्व० । ग्रस्त करके, निगलकर । 'जन बन दुरेउ ससिहि ग्रसि राहू ।' मा०  १.१५६.५
प्रसित : भूकृ० । आवत, निगला हुआ, ग्रस्त । 'कलिमल ग्रसित बिमूढ़ ।' मा०  १.३० ख
असिहि : आ०भ०प्रए० । ग्रस्त करेगा, निगलेगा। 'ग्रसिहि न केकइ करतब राहू ।'  मा० २.२०६.४
प्रसे : भूकृपुब० । निगल लिये । 'लोभ असे सुभ कर्म ।' मा० ७.६७
असेउ : भूकृ००कए० । निगल लिया। 'संसय सर्प असेउ मोहि ताता।' मा०  ७.६३.६ (डसने से तात्पर्य है)
असं : असइ । कवलित करता है। 'बदनहीन सो ग्रस चराचर ।' विन० १११.३
प्रस्यो : ग्रस्यो। 'झषराज ग्रस्यो गजराज ।' कवि० ७.८
ग्रह : सं०पू० (सं०) । (१) सूर्यादिनवग्रह । मा० १.१६० (२) देवविशेष जो  आवेश में लेता है । 'ग्रह ग्रहीत पुनि बान बस।' मा० २.१८० (३) धूमकेतु,  पुच्छल तारा । 'जथा प्रसिद्ध अधम ग्रह केतू ।' मा० ७.१२१.२० /ग्रह,
ग्रहइ : (सं० गृह जाति>प्रा० गहइ>अ० ग्रह इ-पकड़ना, बोध प्राप्त  करना, ग्रहण या धारण करना) आ०प्रए । ग्रहण वरता है। 'ग्रहइ प्रान बिनु - बास असेष ।' मा० १.११८.७
ग्रहीत : भूकृ० (सं० ग्रहीत)। पकड़ा हुआ । 'ग्रह ग्रहीत पुनि बात बस ।' मा०  २.१८०
प्राम : संपु (सं.)। (१) समूह । 'जग मंगल गुन ग्राम राम के ।' मा०  १.३२.२ (२) बस्ती । 'ग्राम बासु नहिं उचित ।' मा० २.८८
ग्रामदेबि : ग्राम पूज्य देवी (ग्राममातृका) । मा० २.८.५
ग्रामनर : ग्राम्य जन, ग्रामीण । 'ग्रामनर नागर ।' मा० १.२८.६
प्रामा : ग्राम । मा० १.१४.४
ग्राम्य : वि० (सं.)। ग्रामीण, ग्राम सम्बन्धी । गिरा ग्राम्य सियराम जस ।' मा०  १.१० ख
प्रास : सं०० (सं०) । कवल । 'चंडकर मंडल-ग्रास-कर्ता ।' विन० २५.२
प्राह : सं०० (सं०) मगर । विन० २६०.२
ग्रीव : ग्रीवा
प्रीवा : सं०स्त्री० (सं०) । गला, कण्ठ । मा० १.१४७.१
प्राषम : संपु (सं० ग्रीष्म) । वसन्त के अनन्तर आने वाला गरमी का ऋतु  विशेष । मा० १.४२.४ ग्लानि,
नी : गलानि (सं.)। अवसाद, हर्षनाश । मा० १.१८४.४ 
236 
_______________________________________________
ग्वाल : सं०० (सं० गोपाल>प्रा० गोपाल) । अहीर । कृ० १८ ग्वालि,
लो : सं०स्त्री० (सं० गोपाली>प्रा. गोवाली) । ग्वालिन । कृ० ५
ग्वालिनि : ग्वाली। क० ४ 
घंट : सं०० (सं०) । वाद्यविशेष । 'चले मत्त गज घंट बिराजी।' मा० १.५०.२
घंटा : घंट । मा० १.३०१.१
घंटि : संस्त्री० (सं० घण्टा=घण्टिका>प्रा० घंटा घंटिआ>अ० घंटी =घंटि)।  छोटा घंटा । मा० १.३०२.७.
घई : सं०स्त्री० । गर्व, कुण्ड, गहरा प्रवाह का आवर्त । 'थके बचन पर न सनेह  सरि, पर्यो मानो घोर घई है।' गी० २.७८.३
घट : सं०० (सं०) । (१) घड़ा, कलश । 'सजे जबहिं हाटक घट नाना ।' मा०  १.६६.३ (२) शरीर । 'जय जय अबिनासी सब घट बासी।' मा०  १.१८६ छं० Vघट
घटइ : (१) (सं० घटते-घट चेष्टायाम्>प्रा० घट्टइ-होना) आ०प्रए ।  होता है, घटना में प्रकट होता है, आ पड़ता है। 'दारुन दोष घटइ अब मोही।' मा० १.१६२.४ (२) (सं० घट्टते-~घट्ट चलने >प्रा० घट्टइ-कम होना) आ०ए० । कम होता है, क्षीण होता है । 'घटइ बढ़इ बिरहिनि दुखदाई ।'  मा० १.२३८.१
घटउ : आ०प्रए० संभावना (सं० घट्टताम् >प्रा० घट्टउ) । चाहे क्षीण हो जाय ।  'घटउ सकल बल देह । दो० ५६३
घटकर्ण : कुम्भकर्ण । रावण का भाई । विन० २८.५
घटज : कुम्भल, अगस्त्य मुनि । मा० २.२६७.२
घटजोनी : घटज (सं० घटयोनि) । मा० १.३ ३
घटत : वकृ००। (१) (सं० घटयत्) ? करता, सम्पन्न करता। 'घटत न काज  पराए।' विन० २०१.१ (२) क्षीण होता । 'घटत न तेज ।' क० २६
घटति : घटत+स्त्री० । क्षीण होती। राम दरि माया बढति, घटति जानि मन  माह।' दो० ६६ 
_______________________________________________
257 
घटन : वि.पु. धिंटित करने वाला, निर्माताः। 'अप्पटित घटन सुघट बिघटन ।'  विन० ३०.२
घटना : सं०स्त्री० (सं.) । रचना, क्रिया, चेष्टा, सृष्टि । अथट घटना सुघट ।'  विन० २५.८
घटनि : घटा+संब० । घटाओं, मेघमालाओं । 'सांवरे बिलोकें गर्व घटत घटनि  के।' कवि० २.१६
घटब : भक०० (सं० घटितव्य>प्रा० घट्टिअन्व) । (मुझे) करना (होगा)। 
___ 'सब बिधि घटब काज मैं तोरे।" मा० ४.७.१०
घटसंभव : घटज (सं.) । अगस्त्य मुनि । मा० ७.३२.७
घटहुं : मा० संभावना--प्रब० । चाहे क्षीण हो जायें। 'श्रवन घटहुं पुनि दृग घटहुँ ।'  दो०५६३
घटा : सं-स्त्री. (सं.)। समूह, यूथ । (१) हस्तिसमूह । 'चितवत मनहुं मगराज  प्रभु गजराज घटा निहारि के।' मा० ३.१८ छं० (२) मेघसमूह । 'मानहुं जलद घटा अति कारी।' मा० ६.१३.५ (एकाको प्रयोगों में 'मेषसमूह' अर्थ  ही चलता है-दो घटनि)
घटाइ : पूक. । कम करके । 'कहेगो घटाइ को। 'कवि० ७.२२
घटाटोप : सं०पु० (सं.)। घटाओं का आडम्बर, मेघ समूह के समान सधन साज  सज्जा । 'घटाटोप करि चहुं दिसि घेरी ।' मा० ६.३६.१०
घटि : (१) पूक । कम होकर, तुच्छ होकर । 'चातकु रटनि घटें घटि जाई ।'  २.२०५.४ (२) कम या कमी । 'कहेहूं तें कछु दुख घटि होई ।' मा० ५.१५.५
घटित : भूकृ०वि० (सं०) । गढ़ा हुआ, गढ़े हुए । 'हाठक घटित जटित मनि कटि  तट रट मंजीर।' गी० ७.२१.११
घटिहि : आ०भ०ए० (सं० घटिष्यते, घट्टिष्यते>प्रा० घट्टिहिइ)। (१) कम __ पड़ेग। घटिहि न जग नभ दिन दिन दूना ।' मा० २.२०६.२ (२) घटित  करेगा, सम्पादित करेगा। 'सो सब भांति घटिहि सेवकाई।' मा० २.२५८.५
घटिहै : घटिहि । क्षीण हो जायगा । 'घटिहै चपल चित चाय ।' विन० २२०८ .
घटु : घट+कए। घड़ा । विष रस भरा कनक घटु जैसें ।' मा० १.२७८.८.
घट : कम होने से । 'चातकु रटनि घटें घटि होई ।' मा० २.२०५.४
घटे : भूकृ०००० । कम हुए, क्षीण हो गये। मिटे घटे तमीचर तिमिर भुवन  के।' कवि० ६.३
घट : घटइ । (१) कम पड़े, क्षीण हो। 'कबहुं घटै जनि नेहु ।' मा० ७.४६  (२) हो, घटित हो । 'सपने नृप कहें घट बिन बध ।' पिन० १२२.२ 
258 
_______________________________________________
घटेगी : आ.भ.स्त्री०ए० । कम होगी। 'घटें घटेगी आनि।' दो० २७६
घट्टा : सं०५० (सं० घट)। विशाल जमाव, संघर्षपूर्ण धावनशील समूह, भीड़  भाड़ । 'प्रलय काल के जनु धनघट्टा ।' मा० ६.८७.२
घट्ठा : सं०० (सं० घृष्टक >प्रा० घट्टअ) । कठोर घर्षण से जनित मोटा कठिन . . धब्बा । 'कमठ कठिन पीठि घट्टा पर्यो मंदर को।' कवि० ६.१६ ।।
घट्यो : भूक ००कए । किया। 'घट्यो तो न सहाय ।' गी० ६.१४.२
धन : (१) सं०० (सं०) । मेघ । 'प्रलय काल के जनु घन घट्टा' मा० ६.८७.२  (२) लोहे का बड़ा हथोड़ा। 'अनलदाहि पीटत घनहि ।' मा० ७.३७ (३) वि० पुजीभूत, राशीभूत । 'सत चेतन धन आनंद रासी।' मा० १.२३.६ (४) धना, अविरल । 'गय उ दरि धन गहन बराह ।' मा० १.१५७.५  (५) मूर्त, साकार । 'गुनागार धन बोध । मा० ६.४८ ख
धनघोर : वि० (सं०) । घनीभूत घोर, अतिशय धोर, मेघाडम्बरवत् आवरण  कारी । 'पाप संताप घन-घोर संसृति ।' विन० ११.८ घननाद,
दा : मेघनाद= रावणपुत्र । मा० ७.६७, ६.५१.५
घनस्याम : सं०+वि०पू० (सं० घनश्याम) । (१) काला बादल । राम धनस्याम  तुलसी पपीहा ।' विन० १५.५ (२) मेघ के समान श्याम वर्ण । मार  २.११३.५
घनस्यामा : घनस्याम । मा० १.१६२.३
घनहि : घन से, बड़े हथौड़े से । 'पीटत धनहिं ।' मा० ७.३७
घनहि : मेघ को। 'निदरि धनहि धर्मरहिं निसाना । मा० १.३०१.२
घना : धन । (१) ठोस, सुदृढ । 'कनक कोट......... 'सुदगयतना घना।' मा०  ५.३ छ० १ (२) प्रचुर, अधिक । 'गजादि खल तारे घना।' मा० ७.१३०  छं. १
घनी : धना+स्त्री०। (१) अधिक । दुदुभी बाजहिं घनी।' मा० १.३१७ छं.  (२) संघर्षयुक्त अविराल । निसाचर अनी । कसमसात आई अति धनी।'  मा० ६.८७.१
घनु : धन+कए । एक मेघ । 'भूषित उड़गन तड़ित धनु ।' मा० १.३१६
घने : 'घना' का रूपान्तर (ब०) । अधिक, अविरल । 'अनेक पर्व सुमन घने ।'  मा० ७.१३ छं० ५
धनेरा : वि.पुं० (सं० घनतर>प्रा० घणयर)। अतिशय घना, अधिकतर;  अत्यधिक 'नगर कोलाहल भयउ घनेरा।' मा० ६.४६.६ (घन के सभी अर्थ) ।
धनेरी : वि०स्त्री० (सं० घनतरा>प्रा० घणयरी) । अत्यधिक । तेहि सीता पर  प्रीति घनेरी।' मा० ५.४०.८ (घन के सभी अर्थ) 
_______________________________________________
25 
घनेरे : 'धनेरा' का रूपान्तर । (१) प्रचर तथा सघन-संघर्ष युक्त अविरल । 'चले  मत्त गजजूथ घनेरे । मा० ६.७९.३ (२) बहुसंख्यक । 'जे आचरहिं ते नर न  घनेरे।' मा० ६.७८.३
घनेरो : घनेरा+कए । अत्यन्त घना । तिन्ह सों प्रेम घरो।' विन० १४३.३ ।
धने : घनहि । मेघ को। भयो जातक राम स्याम सदर धनै ।' गी०. ५.४०.४ ।
घनो : धना+कए० । प्रचर, अधिक । 'हाटकू पिधिलि चलो घी सो घनो।' कवि  ५.२४
घमंड : सं.पु । (१) घमड़ना, गर्वारेक से घुमड़ने-घेरने की क्रिया, आवरणकारी  आडम्बर या आटोप। 'धन घमंड गरजत नभ घोरा।' मा० ४.१४.१ (२) उत्साहतिरेक, समारोह, अतिशय उल्लास । 'भूप भवन घर घर घमंड ।'  गी० १.४६.४
घमंड : घमंड+कए । अद्वितीय आडम्बरपूर्ण घेरा । 'सावन घन घमंडु जन  ठयऊ ।' मा० १.३४७.१
घमोई : सं०० (सं० गत्) । (१) तृण विशेष जो बांस के समान होता है।  (२) बांस की ही जाति का वनस्पति विशेष । 'बाँस बंस सुत भयहु घमोई।'  मा० ६.१०.३
'घर : सं०पू० (१) (सं० घर =गृह>प्रा० घर) । मा० १.७५.३ (२) (सं० घट  >प्रा. घड) । घड़ा । 'करि पुटपाक नाक-नायक हित, घने घने घर घलतो।'  गो० ५.१३.२ (यहाँ घर रूपी घट का श्लेष है)
घरजायऊ: घर जाया भी। 'घरजायऊ है घर को।' कवि० ७.१२२
'घरजाया : सं०० (सं० घर जात>प्रा० घर जाय) । घर में ही पैदा हुआ सेवक।
'घरनि : (१) घरनी। पत्नी । 'जपत सादर संभु सहिति घरनि ।' विन० २४७.२.  (२) घर+संब० । घरों (में) । 'जग जगदीस घर-घरनि धनेरे हैं।' विन०  १७६.२
घरनी : सं०स्त्री० (सं० गृहिणी>प्रा० घरिणी) । पत्नी 'सवहिं गर्भ रजनीचर  घरनी।' मा० ५.३६.७
घरन्यो : घरनीभी। 'घरन्यो बरदा है।' कवि० ७.१५५
घरफोरी : वि०स्त्री० (सं० घरस्फोटी>प्रा० घडफोडी+घरस्फोटी>प्रा.  घरफोडी)। घर (परिवार) में फूट डालने वाली+घडे फोड़ने वाली  (बेशऊर)-~-दासी । 'घरेहु मोर घरफोरी नाऊँ ।' मा० २.१७.३
घरबसी : वि०स्त्री० (सं० गृहोषिता) । घर बैठी, उपपति के घर जाकर रहने  वाली या घरजाई दासी (एक प्रकार को गाली) । दुष्ट, नीच । 'डारि दै घरबसी लकुटी बेगि कर तें।' कृ० १७  तुलसी सन्दकीम 
घरबात : सं०त्री० (सं० ग्रहवार्ता>प्रा. धरवता>अ० घरवत्त)।-घरेल-आजीविका,  कृषि या वाणिज्य के उपकरण, जीवन साधन । 'घरबात घरे खुरपा खरिया।'  कवि०७ ४६
धरिक : घरी+इक । एक घड़ी, घड़ी भर । 'परिक बिलंब कीन्ह बट छाहीं।" 
___ मा० २.११५.३
धरिनि : घरनि । मा० २.२८५.२
धरिनी : घरनी। मा० २.१००.६
घरी : (१) घरी+ब० । घड़ियाँ । 'मान हुं मीच घरी गनि लेई ।' मा० २.४०.२  (२) घरी+अधिकरण कारक । घड़ी में । "केहि सुकृती केहि घरी बसाए।'  मा० २.११३.२
घरी : संस्त्री० (सं० घटी>प्रा० घडी) । दिन का सातवां भाग, दण्ड । 'घरी  पंच गइ राति ।' मा० १.३५४ (२) प्रतीक्षा (का समय) । “घरी करो हम जोही।' कृ० ४१ (३) अवसर । 'घरी कुघरी समुझि जिय देखू ।' मा.  २.२६.८
घरोक : परीक । घड़ी भर, थोड़ी देर । 'परिखो पिय छाहें घरीक हटाढ़े।' कवि०.  २.१२
घर : घर+कए । “घरुन सुगम बन बिषमु न लागा।' मा० २.७८.५
घरें: घर में । 'घरबात घरें खरपा खरिया। कवि० ७.४६
धरो : सं०पु०कए । (१) (सं०
घट:>प्रा० घडो)। मिट्टी का घड़ा । (२) घर  +कए० । वृक्ष आदि के आस-पास बनाया हुआ मिट्टी का घेरा। बिगरत मन  संन्यास लेत, जल नाचत आम घरो सो।' विन० १७३.४ ।।
घरौंधा : सं०० । बच्चों के खिलवाड़ का घर जो धूल से थोड़ी देर के लिए बनाया  और साँझ होते ही बिगाड़ दिया जाता है । 'बापुरो बिभीषनु घरौंधा हुतो बालु  को।' कवि० ७.१७
धांशु : सं०० (सं.)। उष्ण किरणों वाला सूर्य । विन० २८.६
घलतो: क्रियाति०पू०ए० । यदि तो नष्ट कर देता। 'घने घने घर घलतो।  गी० ५.१३.२.
धरि : सं०स्त्री० (सं० गह्वर ?) । फलों या फलियों का गुच्छा (प्रायः कदली  फल-स्तवक के अर्थ में चलता है; आम्रफल-गच्छ आदि अर्थ भी प्रचलित हैं)।  'हेम बौर मरकत घवरि लसत पाटमय डोरि ।' मा० १.२८८
घसीटन : भक० (संघर्ष+इट गतौ) । घसीटने, घिसते हुए भूमि पर खींचने, घर्षण--  पूर्वक चलाने । 'लगे घसीटन धरि धरि झोटी।' मा० २१६३.७ 
_______________________________________________
26R 
ale 
घहरात : वकृ०पू० । घर ध्वनि करते, लहराते, वज्र ध्वनि करते । 'घहरात  जिमि पबिपात गरजत जन प्रलय के बादले।' मा० ६.४६ छं० घाउ,
ऊ : घाय+कए । (१) आघात । 'अस कहि पर निसस्नहिं घाऊ।' मा०  १.३१३.७ (२) चोट, मार । 'हतहिं कोपि तेहि घाउ न बाजा।' मा० ६.७६.८ (३) चोट से होने वाला क्षत (घाव)। 'हृदय घाउ मेरे पीर रघुबीर ।' गी.  ६.१५.१
घाएँ : घात में, लक्ष्य बनाकर, दांव लगाये हुए। 'संकर साखि रहेउँ एहि घाएँ ।' 
__ मा० २.२६२.५
घाए : घाएँ (सं० धाते>प्रा० धाए)। चोट में, प्रहार में। 'ओडिअहिं हाथ 
___ असनिहुं के घाए।' मा० २.३०६.८ घाट,
टा: सं०० (सं० घट्ट) । जलावतार, जलाशय में उतरने का मार्ग ।' मा०  १.३६ मा० ३७.४
घाटारोहु : सं.पु०कए० (सं०
घट्टारोध:>प्रा० घट्टारोहो>अ० घट्टारोहु) । घाट  के चारों ओर घेराबन्दी । 'कीजिअ घाटारोहु ।' मा० २.१८६
घाटि : पूछ । घटकर (कम, हीन) । हम तुम्ह सन कछु घाटि ।' मा० ७.६६ ख
'घाटू : घाट+कए । एक (उत्तम) घाट । 'रघुबर कहेउ, लखन भल घाटू ।' 
___ मा० २.१३३.१ घात;
ता : सं०स्त्री. (सं० घात>प्रा० घत्ता>अ० घत्त)। (१) लक्ष्य, साधना,  निशाना '। 'चुकइ म घात मार मुठभेरी।' मा० २.१३३.४ (२) प्रहार (सं० पु०) । 'उर लात घात प्रचंड लागत ।' मा० ६.६८ छं० (३) वध । 'करहिं बिप्र गुर घात ।' मा० ७.६६ (४) संहार। 'देखि भालु कपि निज दल पाता।'  मा० ६.६८.१५ (५) घातक । 'घात चंद्र जियें जानु ।' दो० ४५६ ।
'घातक : वि० (सं०) । विनाशकारी। 'भ्राता कुंभकरन रिपु घातक ।' गी० ६.३.२
घातिनी : (समासान्त में) वि०स्त्री० (सं.)। विनाश करने वाली जैसे, बीर.  घातिनी । मा० ६.५४.७
घाती : (समासान्त में) (१) वि०० (सं० घातिन्) । विनाशकारी, घातक । ‘या  कुठारु कुठित नपघाती।' मा० १.२८०.१ (२) पतनकारी, अधोगतिदायी।  'ते जड़ जीव निजात्मक घाती।' मा० ७.५३.६ ।।
'घानी : घानी में । 'मारि दहपट दियो जम की घानी ।' कवि० ६.२०
'घानी : संस्त्री० (सं० ग्रहणी) । तेल के कोल्हू में एक बार में डाला जाने वाला  तिल आदि; उसके ग्रहण की मात्रा या तोल । (२) तिल डाले जाने वाला कोल्हू का भाग । 'समय तोलिक यंत्र, तिल समीचर निकर, पेरि हारे सुभट घालि घानी।' विन० २५.७ ('ग्रहणी' शब्द मूलतः आंत के प्रारम्भिक अंस के 
262 
_______________________________________________
.: अर्थ में है जो आमाशयगत भोजन को लेकर आंतों में प्रेरित करता है। उसी  का लाक्षणिक प्रयोग कोल्हू के उस भाग के लिए होता है जिसमें पेरने वाली  वस्तु डाली जाती है।) घाम,
मा : सं०० (सं० धर्म>प्रा० घम्म) । (१) धूप, ऊष्मा । 'मध्य दिवस  अति सीत न घामा ।' मा० १.१६१.२ (२) ताप, क्लेश ! 'सुमिरे त्रिबिध घाम  हरत।' विन० २५५.१
घामु : घाम+कए० । 'घोर घाम हिम बारि बयारी।' मा २६२.४
घाम : घाम को । “चल्यो सूरतरु तकि तजि घोर घाम ।' गी० ५.२५.४
घामो : घाम भी। करत छाँह घोर घामो।' विन० २२८.२
चार्य : घावों से, चोटों या वणों से । 'घुमत घायल धायें घने हैं।' कवि० ६.३६
घाय : सं०५० (सं० घात>प्रा० घाय)। (१) चोट, व्रण, क्षत । 'मनहुं घायः  महुं माहुर देई ।' मा० २.३५.३ (२) प्रहार । 'मुएहि घालत घाय।' विन.. - २२२.३
धानि : घाय+संब० । घावों (से) । 'धन पायनि अकुलान्यो ।' गी० ३.८.२
घायल : वि०पु० (सं० घातवत् >प्रा० घाइल)। व्रणयुक्त, आहत, क्षतविक्षत ।  - 'कछु मारे कछु घायल ।' मा० ६.४७
घाल : (समासान्त में) घालक । 'घरघाल चालक कलहप्रिय ।' पा०म०ई० १३  Vघाल
घालइ : (प्रा० घलह- फेंकना, नष्ट करना, भीसना) आ०प्रए० ।  (१) नष्ट-भ्रष्ट कर डालता है । 'धरि सब घालइ खीसा।' मा० १.१८३ छं०  (२) संकटग्रस्त करता है । जिमि कपि ल हि घालइ हरहाई ।' मा० ७.३६.२
चालक : वि० । विनाशक । 'उपजेहु बंस अनल कुल घालक ।' मा० ६.२१.५
चालकु : घालक+कए । अकेला ही विनाशकारक । 'कुटिल काल वस निज कुल  घालकु।' मा० १.२७४.१
घालत : वकृ०० (प्रा० घल्लंत) । डालता, छोड़ता (मारता)। 'मुएहि घायत  घाय।' विन० २२०.३
घालति : धलित+स्त्री० । बिगाड़ती, नष्ट करती, अस्त-व्यस्त करना । 'घने कर  घालति है धने घर घालि है।' कवि० ७.१२०
चालसि : आ०मए० । (प्रा० घरूलसि) । तू मिटा, नष्ट कर (मिटाता है) । 'जनि  घालसि कुल खीस ।' मा० ५.५६ क
चालहिं : आ.प्रब० (प्रा० घल्लंति>अ० घरलहिं) । मिटाते हैं । 'आपु गए अरु  घालहिं आनहिं ।' मा० ७.४०.५
'घाला : भूकृ०० (प्रा० घहिल अ) । नष्ट किया, बिगाड़ डाला । 'चित्रकेतु क र ६रु  .उन्ह घाला ।' मा० १.७६.२ 
_______________________________________________
263 
घालि : पू० (प्रा० घल्लिय>अ० घल्लि)। (१) डालकर। 'कबहुं पालने घालि  झुकाव ।' मा० १.२००.८ (२) घाते या पासंग के बराबर करके । 'बिभीषन  घालि नहिं ता कहुं गर्न ।' मा० ६.६४ छं०
घालिहै : आ० म०प्रए० (प्रा० धल्लिहिइ) । नष्ट करेगा-गी। 'बानरू बड़ी बलाइ  घने घर घालिहै।' कवि० ५.१०
घाली : (१) भूक०स्त्री० । डाल दी, छोड़ दी। 'राम सेन निज पाछे घाली।' __ मा० ६.७०.६ (२) घालि । डालकर (छिपाकर) । 'सो भुजबल राखेह उर घाली ।' मा० ६.२६.८ (३) डालकर । ‘गयउ तुम्हारेहिं कोछ घाली।' मा०  ७.१८.२
घालें : घालने से, छोड़ने से (मारने से) । 'भलो न घालें घाड ।' दो० ४२४
घाले : (१) भकृ०पुब० । नष्ट किये, उखाड़ फेंके । 'थप थिर के कपि जे घर  घाले ।' हनु० १७ (२) घालें। मिश्रण से, डालने से, ओत-प्रोत करने से ।  'अब देह भई पट नेह के घाले ।' कवि० ७.१३३
घालेसि : मा० भूकृ००+प्रए । उसने नष्ट कर डाला । 'घालेसि सब जग बारह  बाटा ।' मा० २.२१२.५
घालेहि : आ०-भू०पु+मए । तूने नष्ट किया। 'केहि के बल घालेहि बन  खीसा।' मा० ५.२१.१
घाले : (१) घालइ (२) भकृ० अव्यय । घालने, नष्ट करने । 'घाल लिए सहित 
__ समुदाई ।' मा० १.१७४.१
घालो : भूकृ.पु०कए० । बिगाड़ा, नष्ट किया। 'जाहि घालो चाहिए, कही धौं,  राखे ताहि को।' कवि० ७.१००
घास : सं०० (सं०) । पशु खाद्य तृण । बर० ५९
घासी : घास । तृण, चारा । विन० २२.८
घाहैं : संस्त्री०ब० । घाटियां, कुण्ड । 'धारै बान, कूल धनु, भूषन जलचर, भंवर  सुभग सब घाहैं।' गी० ७.१३.३
घिन : सं०स्त्री० (सं० घणा>प्रा० घि >अ. घिण)। जुगुप्सा । 'काल चाल  हेरि होति हिथे घनी घिन ।' विन० २५३.२
धिनात : वकृ०० । घृणा करता-ते । 'जो पै अधिक धिनात।' विन० २१७.६
घिय : सं०० (सं० घृत>प्रा० घिय) । घी । 'पिघले हैं आँच माठ मानो घिय  के ।' गी० ४.१.२
घी : घिय । 'सोइ आदरी आस जाके जिय बारि बिलोबत घी की।' कृ. ४३
घीय : घी। विन० २६३.३ 
264. 
_______________________________________________
- 
- 
घुटरुवनि : (घटुरुबा=पैरों का घुटना, लान)-घुटुरुवा+संब० । घुटनों (से)।  'आँगन फिरत घुटुरुवनि धाए।' गी० १.२६.१
घुन : सं.पु. (सं० घुण) । एक क्षुद्र कीट जो अन्न, काष्ठ आदि के भीतर ही जन्म  पाता और उसी को खाता है (घुन पैदा होने की क्रिया 'घुनना' कहलाती है)।  'कीट मनोरथ दारु सरीरा । जेहि न लाग घुन, को अस धीरा ।' मा० ७.७१.५
घुनाच्छर : (धुन+अच्छर) लकड़ी को धुन काटता-खाता है तो अकस्मात् कभी.  कभी अक्षर का आकार बन जाता है, इसे 'घुणाक्षर' कहते हैं। इसी प्रकार अनायास कोई काम बन जाय तो वहाँ 'घुणाक्षर न्याय' से काम होना कहा जाता  है-दे० न्याय । 'होइ धुनाक्षर न्याय जौं पुनि प्रत्यूह अनेक ।' मा० १.११८ व
घुनिए : आ०कवा०प्रए । घुन लगने की-सी स्थिति में रहा जाय, मन में जर्जर  होकर जिया जाय । 'सुमिरि सुमिर बासर निसि घुनिए ।' कृ.० ३७
धुरबिनिआ : वि० घरे में दाना चुगने वाला, मलराशि में अन्न बीनने वाला।  'तुलसी मन परिहरत नहिं घुरबिनिमा की बानि ।' दो० १३
घुरघुरात : व.पुं० । घुमधुर ध्वनि करता। 'धुरुधुरात हय आरो पाएँ ।' मा०  १.१५६.८
घुर्मरहि:: आ०प्रब० । घूम रहे हैं+घुमड़ रहे हैं+तरङ्गाकार गति लेते हैं। निदरि  घनहिं घुमरहिं निसाना ।' मा० १.३०१.२
घुमि : पू० । चतकर खाकर । 'घुमि धुमि घायल महि परहीं।' मा० ६.६८.६
घुमित : भूकृ० (सं० पूर्णित) । चकराया हुमा। 'धूमित भूतल परेउ तुरंता।' ___ मा० ६ ६५.८ 
घट : सं०पु । मुखावरण । 'का घूघट मुख मूदहु अबला नारि ।' बर० १७
घूटक : घूट+एक । एक घूट भर । 'लेत जो पूंटक पानि ।' दी० २८७
घूघरवारे : वि०पू०ब० । घुघराले, छल्लेदार । 'कच घुघरवारे।' मा० १.२३३.४
घटी : सं०स्त्री० । घुट्टी। (शिशुओं को दी जाने वाली औषधि) । 'लोच न सिसुन्ह  देहु अमिय घूटी।' गी० २.२१.२
घूमत : वकृ.पु. (सं० घूर्णत्>प्रा० घुम्मत) । घूमता, घूमते । 'घूमत घायल  घाय घने हैं।' कवि० ६.३६
घूमि : पूर्व० (सं० पूर्णित्वा> घुम्मिअ>अ० घुम्मि) । घूमकर, चक्कर या पछाड़  खाकर । 'भूमि परे भट धूमि कराहत ।' कवि० ६.३२
धूर : सं०पु । कूड़े का ढेर, मल राशि । 'चाहत अहारन पहार दारि घर ना।'  कवि०७.१४८
घृत : सं०० (सं०) । घी। मा० १.४.४