तुलसी शब्द-कोश 
1121 
सोहाहि,
हीं : आ०प्रब०। (१) रुचते हैं, रुचती हैं। 'जाहि न रघुपति कथा 
सोहाहीं।' मा० ७.५३.५ (२) शोभित होते हैं । 'मंगल सकल सोहाहिं न __ कैसें ।' मा० २.३७.७
सोहिले : सं०+वि.पुं० (सं० शोभावत् >प्रा० सोहिल्ल)। (१) सुन्दर, शोभा  सम्पन्न, माङ्गलिक (२) मङ्गल गीत, जन्मोत्सव गीत (सोहर)। 'भयो सोहिलो  सोहिले भो जनु सृष्टि सोहिले सानी।' गी० १.४.७
सोहिलो : सं०+वि.पु.कए० । सोहर गीत, बधाई गीत । गी० १.२.१-४
सोहिहै : आ०म०प्रए। सुशोभित होगा, फबेगा । 'को सोहिहै और को लायक ।'  गी० १.७०.५
सोही : सोही+ब० । सुशोभित हुई । मा० २.१२१.१
सोही : भूक०स्त्री० । सुशोभित हुई। 'प्रभु असीस जनु तनु धरि सोही।' मा०  २.३.३
सोहे : भूकपुब० (सं० शोभित>प्रा० सोहिय) । सुशोभित हुए । 'रेख कुलिस  ध्वज अंकुस सोहे।' मा० १.१६६.३
सोहैं : सोहहिं । 'लीन्हें जयमाल कर कंज सोहैं जानकी के ।' कवि० १.१३
सोहै : सोहइ । (१) शोभा दे रहा है । 'आगे सोहै सांवरो कुवँरु ।' कवि० २.१५  (२) शोभा पा सकता है । 'दीप सहाय कि दिनकर सोहै।' मा० २.२८५.५  (३) रुचता है, रुचे । 'कोन कृपालुहि सोहै।' विन० २३०.२
सौं : सौह । 'सुन मैया तेरी सों करौं ।' कृ०८
सौंघाई : सं०स्त्री. (सं० समता)। बाजार भाव की मन्दी (महंगाई का विलोम)।  "एक कहहिं ऐसिह सौंघाई । सठहु तुम्हार दरिद्र न जाई ।' मा० ६.८८.३ (यहाँ  वस्तु की प्रचुरता का भी तात्पर्य है)।
सौंधे : वि.पु.ब. (सं० समर्घ>प्रा० समाघ>अ० सर्वग्घ)। सस्ते, मन्दे, अल्प  मूल्य से प्राप्य । 'महंगे मनि कंचन किए सौंघे जग जल नाज ।' दो० १४६
सोंज : सं०स्त्री० । घरेल सामग्री (बर्तन-भाडे आदि) । 'एक करै धौंज, एक कहैं काढ़ी ___ सौंज ।' कवि० ५.१८
सोपि : समपि (अ० सर्वधि) । समाति कर । मा० ६.६ सौंपिए,
ये : आ.कवा०प्रए। सौंपा जाय, दीजिए। 'यह अधिकार सौंपिये  औरहि ।' विन० ५.४
सौंपी : भूक०स्त्री० । समपित की, भार संभालने की व्यवस्था दी। 'सौंपी सकल  मातू सेवकाई ।' मा० २.३२३.२
सौंपु : आ०-आज्ञा-मए० (सं० समर्पय>प्रा० समप्प>अ० सर्वप्पु)। तू समर्पित  कर दे । 'अजहं एहि भौति ले सौंपु सीता ।' कवि० ६.१७
सौंपे : भूकृ००० । समर्पित किये। सौंपे भूप रिषिहि सुत ।' मा० १.२०८ 
1122 
तुलसी शब्द-कोश 
सौंपोसि : आ०-भकृ०० +प्रए० । उसने समर्पित किया। 'सौंपोसि मोहि  तुम्हहि गहि पानी ।' मा० ६.६१.१५
सौंपेहु : (१) आ०- भूकृ००+मब० । तुमने समर्पित किया। 'तात न रामहि ___ सौंपेहु मोही।' मा० २.१६०.५ (२) भ०-+आज्ञा+मब० । तुम समर्पित  करना । 'सौंपेहु राजु राम के आएँ ।' मा० २.१७५.८
सौंप्यो : भूकृ००कए । समर्पित किया । गी० १.१०६.४
सौंह : सं०स्त्री० (सं० शपथ>प्रा० सवह) । कसम, सौगन्द । 'मार खोज ले सौंह  करि।' दो० ४०६
सौंहें : सौंह+ब० । कसमें । 'कहत हों सौहें किए।' मा० २.२०१ छं.
सौहौं : क्रि०वि० (सं० संमुखम् >प्रा० संमहं। सामने । 'तोहि लाज न गाल  बजावत सौंहौं ।' कवि० ६.१३
सो : संख्या (सं० शतम>प्रा. स>अ० सउ)। 'पांचहि मारि न सो सके।'  दो० ४२८
सौंदर्ज : सौंदर्य । मा० १.३२७.८
सौंदर्य : सं०पू० (सं०) । सुन्दरता, रमणीचता, कमनीयता । विन० ६१.६
सौगुन : सयगुन । जा०म०छं० ५
सौगुनी : वि०स्त्री० (सं० शतगुणा) । गी० २.४७.३
सौच : सं०० (सं० शौच) । स्नान पूर्व दैनिक कृत्य (दन्तमज्जन आदि)। मा०  २.६४.३
सौति : सवति । कवि० २.३ सौतुक,
ख : सं+वि.पु० । प्रत्यक्ष, यथार्थ । 'सपनो के सौतुक, सुख सस सुर  सींचत देत निराइ के ।' गी० ५.२८.६ 'देखौं सपन कि सौतुख ससिसेर सहि ।'  पा०म०६६
सौदा : सं-पु. (तुर्की) । क्रय-विक्रय । 'सुहृद समाज दगाबाजिही को सौदा सूत ।'  विन० २६४.२
सौध : सं०पु (सं०) । (सुधा=चूने से बना तथा पुता हुआ) विशाल भवन ।  मा० २.६६.३
सौभग : सं०० (सं०) । सुभगता, सौन्दर्य । मा० ३ श्लोक २
सौभागिनी : वि.स्त्री०ब० । सहागिनें, सौभाग्य वतियां, सधवाएं, पतिवानियाँ। ___ 'सौभागिनी बिभूषन हीना।' मा० ७.६६.५
सौभाग्य : संपु.। (१) सोहाग (सुभगाया भावः सौभाग्यम्)। (२) (सं०  सुभगस्य भावः सौभाग्यम् ) सौन्दर्य = सोभग । सकल सौभाग्य संयुक्त ।' विन. ६१.७ (३) (सं० सुभागस्य भावः सौभाग्यम् ) उत्तम भाग्यशीलता । 'निज सौभाग्य बहुत गिरि बरना।' मा० १.६६.८  सुलसी शब्द-कोश 
1123 
सौमित्रि : सं.पु. (सं०) । सुमित्रा पुत्र लक्ष्मण । मा० २.१२२
सौरज : सं०० (सं० शौर्य) । शूरता, वीरता । मा० ६.८०.५
सोरभ : सं०० (सं०) । (१) आम्रवृक्ष । 'सौरभ पल्लव मदनु बिलोक ।' मा०  १.८७.५ (२) सुगन्ध । सुरभि सौरभ धूप दीप बरमालिका ।' विन० ४८.२
स्तव : सं०० (सं०) । स्तोत्र, स्तुति , प्रार्थना-पद । मा० ३.४.२३
स्थ : वि० (सं.)। स्थित । मा० १ श्लोक २
स्थिति : संस्त्री० (सं०) । अवस्था, उपस्थिति । विद्यमानता । मा० १ श्लोक ५
स्पृहा : सं०स्त्री० (सं.)। इच्छा, लालसा । मा० ५ श्लोक २
स्फुरत् : वकृ० (सं.)। देदीप्यमान, लहराता-ती। मा० ७.१०८.६
स्पंदन : सं०० (सं.)। रथ । मा० ६.४३.८
स्पंदनु : स्यंदन+कए० । 'स्यंदन मंजि सारथी मारा।' मा० ६.८३.५
स्यानो : सयानी। चतरा । कवि० ७.१३३
स्याम : (१) वि० (सं० श्याम)। आकाशवर्ण । 'स्याम सारस जुग मनों ससि स्रवत  सुधा सिंगारु ।' कृ० १४ (२) संपु । श्री कृष्ण ।
स्यामतन : श्याम शरीर वाला । रा०प्र० ४.४.२
स्थामता : सं०स्त्री० (सं० श्यामता) नीलिमा । मा० ६.१३.६
स्याममई : वि० (सं० श्याममय) । श्यामरूप, कृष्ण से तदाकार, श्री कृष्ण से एकी  भूत । 'उड़ि न लगे हरि संग सहज तजि, न गए सखि स्याममई ।' कृ० २४
स्यामल : वि० (सं० श्यामल) । श्यामवर्ण । मा० ७.५.८
स्यामसुदर : श्री कृष्ण (श्याम होते हुए सुन्दर) । कृ० ३०
स्यामा : (१) स्याम । श्यामवर्ण । 'नील कंज तनु सुदर स्यामा।' मा० ६.५६.६  (२) सं०स्त्री० (सं० श्यामा) । एक श्यामवर्ण की शुभसूचक चिड़िया । 'स्याम बाम सुतर पर देखी।' मा० १.३०३.७ (३) वयः सन्धि में स्थित सुन्दरी किशोरी; तप्त काञ्चन के ये रूप वाली (जो ग्रीष्म में शीतल और शीत में उष्ण स्पर्श वाली हो); षोडशी । तिन्ह के संग नारि एक स्यामा।' मा०  ३.२२.८
स्यों : अव्यय । सहित । तेहि उर क्यों समान विराट बपु स्यों महि सरित सिंधु  गिरि भारे ।' कृ० ५७
स्योकाई : सेवकाई । हन० १२ स्रक,
ग : सं०स्त्री० (सं० स्त्रक, स्रग्) । पुष्पमाला, माला । 'स्रक चंदन बनितादिक  भोगा।' मा० २.२१५.८ 'स्रग महं सर्प बिपुल भयदायक ।' विन० १२२.३  मा० १.३५५.२, ३५६.३
स्रम : श्रम । पसीना । 'हम सों कहत बिरह सम जैहै गगन कूप खनि खोरे ।' क. 
1124 
तुलसी शब्द-कोश 
समकन : श्रमकन । स्वेद बिन्दु । गी० ७.१८.५ 
समित : श्रमित । विन० १७०.६  'स्रव,
स्रवद : आ०प्रए० (सं० स्रवति>प्रा. सवड>अ० स्रवइ)। चूता या  बहता है, बहाता है, टपकाता है 'जनु स्रव सैल गेरु के धारा ।' मा० ३.१८.१
स्त्रवत : वक००। (१) टपकता-ते, बहता-ते । 'स्रवत नयन जल जात ।' मा०  ७.१ (२) टपकाता-ते । 'स्रवत प्रेमरस पयद सुहाए।' मा० २.५२.४
वन : श्रवन । कान । 'सवन सुजस सुनि लीजै ।' कृ० ४६
नवननि : स्रवन+संब० । कानों (में, से) । 'लागि स्रवननि करत मेरु की बतकही।'  गी० ७.६.३ प्रहि,
हीं : (१) आ० प्रब० । बहाते-ती हैं । 'मन भावतो धेन पय स्रवहीं।' मा.  ७.२३.५ (२) गिरते हैं, च्युत होते हैं। 'स्रवहिं आयुध हाथ ते।' मा०  ६.७६ छं०
लवे : सवइ । (१) चुलाती है, टपकाती है, प्रवाहित करती है। कोमल बानी संत  की सर्व अमृतमय आइ । वैरा० १९ (२) चाहे चुलाए, बहाये । 'बिधु बिषु  चवै सवै हिमु आगी।' मा० २.१६६.२
स्रष्टा : वि.+सं०पू० (सं.)। सृष्टिकर्ता, विधाता । विन० ५३.७
स्त्राद्ध : श्राद्ध ।
त्राद्ध : स्राद्ध+कए । 'स्राद्ध कियो गीध को।' कवि० ७.१५
तुति : श्रुति । वेद । 'कहि न सकत स्रुति सेस उमाबरा।' क० २१
सवा : सं०पू० (सं० सव) । यज्ञ का उपकरण (पात्र) विशेष जिससे घी आदि  अग्नि में डाला जाता है । 'चाप वा सर आहुति जान ।' मा० १.२८३.२
लेनी : नी । गी० ७.१५.२
स्रोत : सं०० (सं० स्रोतस्) । स्रोता, प्रवाह । विन० १८.४
स्व : वि०+सं० (सं.)। (१) आत्मा । (२) आत्मीय, अपना । 'चलहिं स्व धर्म  निरत श्रुति नीती।' मा० ७.२१.२ (३) स्वमति-बिलास ।' मा० ७.१५.६  (४) धन-जैसे, सर्वस्व ।
स्व: : अव्यय (सं.) । स्वर्ग, अन्तरिक्ष । मा० ३ श्लोक १
स्वक : वि० (सं०) । स्वकीय, अपना । मा० ३.४.१६
स्वकर : अपना हाथ । मा० १.२१३.२
स्वछंदचारी : वि० (सं.)। (१) मनमाना आचरण करने वाला। (२) निरपेक्ष  होकर सर्वत्र गति रखने वाला सर्वतन्त्र स्वतन्त्र=परमेश्वर । विन० ५६.४.
स्वच्छता : संस्त्री० (सं०) । शुद्धता, निर्मलता । मा० १.३६.५  तुलसो शब्द-कोश 
1125 
स्वतंत्र : वि० (सं.)। स्ववश, स्वाधीन, अन्यापेक्षारहित । 'सदा स्वतंत्र एक  भगवाना।' मा० ६.७३.१२
स्वदक : वि० (सं० स्वदृक्) । स्वयं द्रष्टा, आत्म द्रष्टा, स्वयं ही सब कुछ देखने  वाला, सर्वज्ञ परमात्मा । विन. ५७.४
स्वधामद : अपना धाम (विष्णु लोक आदि) देने वाला । मा० ३.४ छं०
स्वपच : सं०० (सं० श्वपच) । कुत्ते का मांस पकाने (खाने वाला) चाण्डाल ।  मा० ७.१००.५
स्वपचादि : स्वपच आदि अधम जाति वाले । मा० ७.१३० छं० १
स्वपच्छ : सं०० (सं० स्वपक्ष)। (१) अपना मतवाद । (२) अपना पंख । 'सठ  स्वपच्छ तव हृदय बिसाला । सपदि होहि पच्छी चंडाला ।' मा० ७.११२.१५
स्वप्रान : अपने प्रान (जीवन) । मा० ५.३०.८
स्वबस : वि० (सं० स्ववश) । (१) आत्माधीन, स्वाधीन, स्वतन्त्र (जिसे बाहर से  किसी की अपेक्षा न हो; माया पराधीन न होकर स्वेच्छा से सब कुछ कर सकता हो); सर्वथा आत्मस्थ । 'स्वबस अनंत एक अबिकारी ।' मा० ६.७३.११ (२) अपने अधीन, अपने वश में। कीन्हे स्वबस सकल नर नारी ।' मा०  १.२२६.५
स्वभक्त : अपना भक्त । मा० ३.४ छं०
स्वमति : अपनी बुद्धि । मा० १.१२१.४
स्वयं : अव्यय (सं०) । स्वतः । मा० ६.१०४ छं०
स्वयंवर : सं०० (सं० स्वयंवर) । कन्या द्वारा स्वयं ही वर चुनने की प्रथा; उसका  अवसर; वर चयन हेतु सभा । मा० १.४१.१
स्वयंवरु : स्वयंबर-+कए । 'सीय स्वयंबर देखिअ जाई ।' मा० १.२४०.१
स्वयंसिद्ध : वि० (सं.)। अनायास सफल ; बिना प्रयास के ही अपने आप पूर्ण ।  'स्वयंसिद्ध सब काज ।' मा० ६.१७
स्वर : सं०० (सं.)। (१) कण्ठध्वनि, नाद । 'गदगद स्वर ।' मा० ७.१०७  (२) संगीत के स्वर= षड्ज, ऋषभ, गान्धार, मध्यम, और पञ्चम, धैवत और निषाद । इनके तीन भेद-मन्द्र, मध्य और तार । इनकी तीन गतियाँ द्रुत, विलम्बित और मध्य लय । इन सबकी योजन से गीत में आरोह  अवरोह बनते हैं । 'गारी मधुर स्वर देहि ।' मा० १.६६ छं०
स्वरूप : सं०० (सं.)। (१) एकरूप, तदात्म, तद्रूप, अभिन्न । 'विभुं व्यापकं  ब्रह्म-वेदस्वरूपं ।' मा० ७.१०६.१ (२) आत्मा का रूप, आत्मतत्त्व । 'कर्म कि होहिं स्वरूपहि चीन्हें ।' मा० ७.११२.३ (३) यथार्थ परिचय । 'राम स्वरूप जानि मोहि परेऊ ।' मा० १.१२०.२ 
1126 
तुलसी शब्द-कोश 
स्वर्ग : सं०० (सं.)। (१) सद्गति (नरक का विलोम)। 'नरक स्वर्ग अपवर्ग  निसेनी।' मा० ७.१२१.१० (२) दुःख स्पर्श रहित अखंड सुख । 'तन सम बिषय स्वर्ग अपबर्गा ।' मा० ७.४६.७ (३) सात ऊर्व लोक । भूः, भुवः, स्वः, महः, जनः, तपः और सत्यम् । 'सात स्वर्ग अपवर्ग सुख।' मा० ५.४  (४) देवलोक ।
स्वर्गउ : स्वर्ग भी। 'स्वर्गउ स्वल्प अंत दुखदाई।' मा० ७.४४.१ (यहां देवलोक से ___तात्पर्य है-पुण्य क्षीण होने पर स्वर्ग से पतन होता है)।
स्वनं : सं०पू० (सं० स्वर्ण) । सुवर्ण, काञ्चन । हनु० २
स्वल्प : वि० (सं०) । अत्यन्त अल्प । मा० ७.२८
स्वल्पउ : स्वल्प भी; लेशमात्र भी। यहि स्वल्पउ नहिं ब्यापिहि सोई।' मा०  ७.१०६.७
स्वांग : सं०पू० । (१) अभिनय, नाटक (वेष परिवर्तन द्वारा स्वरूपावच्छादन) ।  'सारदूल को स्वांग करि कूकर की करतूति ।' दो० ४१२ (२) प्रहसन, हास्य  विनोद की रूपसज्जा । 'चढ़े खरनि बिदूषक स्वांग साजि ।' गी० ७.२२.८
स्वागत : सं०० (सं०) । शुभागमन, आदरणीय व्यक्ति के आने में मार्ग की सुख  सुविधा । 'स्वागत पूछि पीत पट प्रभु बैठन कह दीन्ह ।' मा० ७.३२ स्वाति,
ती : संस्त्री० (सं.)। एक नक्षत्र जिसमें बरसने वाले जल से चातक  तृप्त होता है, सीपी में मोतो, केले में कपूर, बाँस में वंशलोचन और सर्प में  विष उत्पन्न होते हैं--- ऐसी कवि प्रसिद्धि है । मा० २.५२; १.२६३६
स्वाद : (१) सं०पू० (सं.)। रस । 'सीतल अमल स्वाद सुखकारी ।' मा०  ७.२३.८ (२) रसग्रहण । 'स्वाद तोष सम सुगति सुधा के।' मा० १.२०.७.  (३) स्वादु । स्वादयुक्त । 'रधेि स्वाद सुनाज ।' दो० १९७
स्वादित : भूकृ०वि० (सं०) । स्वाद पाया हुआ, रसतृप्त । 'बस जो ससि उछंग  सुधा स्वादित कुरंग।' विन० १९७.१ स्वादु,
दू : (१) स्वाद+कए। 'किमि कबि कहै मूक जिमि स्वादू ।' मा०  २.२४५.६ (२) वि.पु. (सं० स्वादु) । सरस, सुस्वादयुक्त । 'मधु सुचि  सदर स्वादु सुधा सी।' मा० २.२५०.१ ।। स्वान,
ना : सं०० (सं० श्वन्=श्वान) । कुत्ता । मा० ७.१०६.१५, ६.१०२.७.
स्वानु : स्वान+कए० । 'बलवान है स्वान गलीं अपनीं ।' कवि० ६.१३
स्वन्तः : अव्यय (सं०) । अपना अन्तःकरण, अन्तरात्मा । 'स्वान्तः सुखाय ।' मा०  १ श्लो० ७ ‘स्वान्तस्तप.शान्तये ।' मा० ७.१३० उपसंहार श्लोक ।
स्वामि : वि०पू० (सं० स्वामिन ) स्वामी । पालक आदि । मा० १.१५.४
स्वामिनि : वि०स्त्री० (सं० स्वामिनी) । पालिका, प्रभु । मा० २.२१.६
स्वामिभक्त : वि० (सं०) । स्वामी के प्रति अनन्य भावना वाला । मा० ६.२४.३  तुलसी शब्द-कोश 
1127 
स्वामी : वि.पुं० (सं.) । स्वत्वधारी, प्रभु । मा० ७.६३
स्वयंभू : सं०० (सं० स्वायंभुव)। स्वयंभू =ब्रह्मा के पुत्र (मनुविशेष)। मा०  १.१४२.१
स्वारथ : सं०० (सं० स्वार्थ) । अपना प्रयोजन (स्व+अर्थ)। परहित रहित  उद्देश्य या विषय । 'स्वारथरत परिवार बिरोधी।' मा० ७.४०.४ (२) परमार्थ  विरोध विषय या प्रयोजन (अर्थकाम)।
स्वारथी : वि.० (सं० स्वाथिन) । अपना ही प्रयोजन (अर्थ काम) सिद्ध करने  वाला (परमार्थ तथा परोपकार से रहित)। मा० ६.११०.२
स्वारथ : स्वारथ-+कए० । मा० २.२५४.५ स्वास,
सा : सं०० (सं० श्वास) । मुख तथा नासिका से आने जाने वाला प्राण  वायु । मा० ५.४६ क 'रट नाम निसि दिन प्रति स्वासा ।' वैरा० ४०
स्वासु : स्वास+कए० । एक श्वास । कवि० ५.२२
स्वाहा : अव्यय (सं०) । हवन करते समय कहा जाने वाला वैदिक मन्त्र (पुराणों  में स्वाहा को अग्नि पत्री कहा गया है)। कवि० ५.७
स्वेद : सं०० (सं०) । पसीना । मा० २.११५
स्व : सोइ । वही । 'सजान ससील सिरोमनि स्व।' कवि० ७.३४ स्व
हैं : सोइ । आ.भ.प्रब० । सोएंगे। निलज प्रान सुनि सनि सुख स्वैहैं।' गी०  ६.१७.३  ह 
हंकरावा : भूकृ.पु. । बुलवाया। मेघनाद कहुं पुनि करावा ।' मा० १.१८२.१
हंकारा : सं०० (सं० हक्का-कार>प्रा. हक्कार)। बुलावा, आमन्त्रण । 'गुर ___ बसिष्ट कहँ गयउ हकारा।' मा० १.१९३.७
हकारि : पू० । बुलवा (कर) । 'जाचक लिये हकारि ।' मा० १.२९५
हंकारी : भूक०स्त्रीब० । बुलवायीं, बुलायीं । 'पुनि धीरज धरि कुअरि हकारी ।'  मा० १.३३७.६
हंकारी : (१) भूकृ०स्त्री० । बुला ली। 'राज करत एहिं मृत्यु हकारी । मा०  ६.४२.५ (२) हकारि । बुलवाकर । 'दिए दान बहु बिप्र हकारी।' मा०  २.६.४ 
1128 
तुलसी शब्दकोश 
हकार : भूक०० ब० । बुलवाए, पुकारे, आमन्त्रित किये। पुनि करुनानिधि भरतु  हंकारे।' मा० ७.११.४
हसत : वकृ०० (सं० हसत्>प्रा. हसंत)। हंसता, हँसते । मा० ६.११८.२
हसनि : सं०स्त्री० । हंसने की क्रिया। 'हंसनि मिलनि बोलनि मधुर ।' दो० ४०६
हंसब : भकृ.पु (सं० हसितव्य>प्रा० हसिअव्व) । हँसना । मा० २.३५.५
हसहि : आ०प्रब० । हँसते हैं (थे) । 'आवत निकट हँसहिं प्रभु ।' मा० ७.७७
हंसा : भूकृ०० । हास कर उठा । 'हंसा दससीसा ।' मा० ६.२४.६
हसाइ : कृ० । हंसी करवा कर (उपहसनीय होकर) । 'ख्वहीं न पठावनी के ह्रहों  न हसाइ के ।' कवि० २.६
हसाई : हँसाइ । अपनी हंसी करवा कर । 'तो पनु करि होतेउ न हँसाई ।' मा०  १.२५२.६
हैसि : पूकृ० । हकर सा० ६.३२.६
हेसिबे : भकृ०० । हंसने, उपहास करने । 'हसिबे जोघ हँसें नहिं खोरी ।' मा० 
हसिहहिं : आ०भ०प्रब० (सं० हसिष्यन्ति>प्रा० हसिहित>अ० हसि हिहिं) । हंसेंगे  परिहास करेंगे । 'हँसिहहिं कुर कुटिल कुबिचारी।' मा० १.८.१०
हसिहहु : आ०भ०मब० (सं० हसिष्यथ>प्रा० हसि हिह>अ० हसिहिह)। हंसोंगे,  उपहास करोगे । 'हसिहहु सुनि हमारि जड़ताई।' मा० १.७८.४
हसिहै : आ०भ०प्रए० । हंसेगा, उपहास करेगा। 'जग हसिहै मेरे संग्रहे ।' विन०  २७१.३
हँसी : सं० स्त्री० । परिहास । 'हँसी करहहु पर पुर जाई ।' मा० १.६३.१
हंसें : हंसने से, परिहास करने से । 'हसिबे जोग हसें नहिं खोरी।' मा० १.६.४
हसे : भूक००० । हास कर उठे । मा० ६.६१ छं०
हसेउ : (दे० हसेउ) । मा० ६.२६.२ (पाठान्तर)।
हंसेहु : (१) आ० - भूकृ००+मब० । तुमने परिहास किया । 'हमहि हंसे हु सो  लेहु फल ।' मा० १.१३५ (२) भ०+आ०मब० । तुम परिहास करना ।  'बहुरि हँसेहु मुनि कोउ।' मा० १.१३५
हंस : हँसहिं । हँसते हैं । 'हंसे राघो जानकी लखन तन हेरि हेरि ।' कवि० २.१०
हसैहौं : आ० भ० उए । हँसाउँगा, उपहास कराऊँगा। 'परबस जानि हस्यो इन  इंदिन निज बस हा न हँसंहौं।' विन० १०५.३
हँस्यो : भूक००कए। (१) हंसा । 'हँस्यो कोसलाधीस।' मा० ६.६६ (२) हंसा  गया, परिहासास्पद किया गया। 'परबस जानि हस्यो इन इंद्रिन ।' विन १०५.३  तुलसी शब्द-कोश 
1129 
ह: (समासान्त में) । वि०पू० (सं० हन । घातक, विनाशक । 'क्लेश हैं।'  विन० ४६.५
हंकारहीं : प्रा०प्रब० । पुकारते हैं, बुलाते हैं। 'आराम रम्य पिकादि खग रव जन  पथिक हंकारहीं।' मा० ७.२६ छं०
हंता : वि०पू० (सं० हन्त) । घातक, नाशक । 'त्रास-हंता।' विन० ५५.६
हतार : हंता (प्रा.) । विन० २८.४
हंस : सं०पू० (सं०) । (१) पक्षिविशेष जो मानस सरोवर वासी प्रसिद्ध है। 'मुनि  मन मानस हंस निरंतर ।' मा० ७.३५.७ (२) सूर्य । 'हंस-बंसु दसरथ जनकु।'  मा० २.१६१ (३) आत्मा । (४) परमहंस साधु, जीवन्मुक्त अवधूत ।
हंसकमारी : हंसपुत्री हंसी । मा० २.६०.५
हंसगवनि : वि०स्त्री० (सं० हंसगमना)। हंस के समान चाल वाली। मा०  २.६३.५
हंसा : हंस । मा० ३.३०.१२ हंसिनि,
नी : हंसी । मा० २.१२८
हंसी : हंस+स्त्री० (सं.)। मराली । मा० २.३१४.८  Jह,
हइ : अहइ । है । 'हइ तुम्ह कह सब भांति भलाई ।' मा० २.१७४.६
हई : भूक स्त्री० (सं० हता>प्रा० हई) । मारी हुई। 'बैद मरजाद मानौं हेतुबाद  हई है।' गी० १.८६.३
हउँ : महउँ । हूं। 'समझत हउँ नीकें । मा० २.१७७.६
हए : भूकृ००ब० (सं० हत>प्रा० हय)। (१) मारे, आहत हुए। 'बडु रोग __ बियोगन्हि लोग हए ।' मा० ७.१४ छं० (२) ताडित किये बजाए । 'नभ अरु  नगर निसान हए।' गी० १.३.१
हगि : पू० । विष्ठा करके । 'काग अभागें हगि भयो।' दो० ३८४
हजारी: वि०० (फा० हजार) । हजार वाला। 'बिनु हाथ भए हनि हाथ  हजारी।' कवि० ६.५
हटकहु : आ०मब० । रोको, टोको (हटाओ), वजित करो । 'तुम्ह हटकहु जो चहहु  उबारा ।' मा० १.२७४.८
हटकि : (१) पूक० । हटककर, परे हटाकर । मा० ३.३७ ख (२) भर्सका करके,  डॉट कर । 'सकल सहि हाठि हटकि तब बोलीं बचन सक्रोध ।' मा० १.६३
हटके : भूक.पुं०ब० । रोके, वजित किये । 'बिहंसि हिये हरकि हटके लखन राम ।' __ गी० १.८५.३
हटक्यो : भू.पु०कए । रोका । 'सपनेहुं न हटक्यो ईस ।' विन० २१६.३
हटत : वकृ.पुं० । हटकता, रोकता, निषेध करता । 'लालच लघु तेरो लखि तुलसी  तोहि हटत ।' विन० १२६.४ 
1130 
तुलसी शब्द कोश 
हटि : हटकि । रोककर । 'नयन नीरु हटि मंगल जानी।' मा० १.३१६.१
हट्ट : सं०० (सं०) । हाट, बाजार । मा० ५.३ छं० १
हठ : सं०पू० (सं०) । दुराग्रह, धृष्टतापूर्ण आग्रह, दूसरे की बात न मानने वाली  शटता (कहीं-कहीं स्त्रीलिङ्ग प्रयोग भी किया है)। 'ए बालक असि हठ भलि  नाहीं।' मा० १.२५६.२
हठनि : हठ-+संब० । हठों (से) बराबर हठ करके। हठनि बजाइ करि दीष्ठि  पीठि दई है।' कवि० ७.१७५
हठसीस : वि० (सं० हठशील) । हठीला, हठ प्रकृति, दुराग्रही। मा० ७.१२८.३
हठि : पू० । हठ करके, आग्रहपूर्वक । 'हठि फेरु रामहि जात बन ।' मा०  २.५० छं.
हठी : वि.पुं० (सं० हठिन) । आग्रही, हठशील । कवि० ६.३७
हठोले : हठी । हाँकि हने हनुमान हठीले ।' कवि० ६.३२
हठीलो : वि.पु.कए ० । हठी, तत्पर । हनु० ११
हठे : हठ से (हठ करके) । 'हठे दुख पहहु ।' पा०म० ५६
हडावरि : सं०स्त्री० (सं० हड्डावलि) । अस्थि पञ्जर । कवि० ६.५१
हत : वि० (सं.)। मारा हुआ। (१) हीन । 'हत भागी।' मा० ५.१२.६  (२) (समासान्त में) । श्रीहत । 'विचार-हत ।' दो० ३४६ हत,
हतइ : हत+प्रए० । मारता है, मार डालता है, मार सकता है । 'प्रभु  ताते उर हतइ न तेही।' मा० ६.६६.१३
हत: हत+उए । मार डालता हूं, मारता हूं। 'हत न तोहि अधम अभिमानी।'  मा० ६.२४.११
हतब : हत+भकृ०० । मारना (होगा); मार जायगा (मारूंगा) । 'सो मैं हतब  कराल कुपाना ।' मा० ६.४२.७
हतमागी : वि०स्त्री. (सं० हतभाग्य) । भाग्य की मारी, अभागिनी। मा०  ५.१२.६
हतभाग्य : वि.पु. (सं.)। भाग्य का मारा, अभागा । मा० ७.१०७.१
हतहि : हत+प्रब० । मारते हैं। 'हतहि कोपि तेहि घाउ न बाजा।' मा०  ६.७६.८
हतहु : हत+मब० । मार डालो। 'बेगि हतहु खल ।' मा० ६.७१.१२
हति : (१) हत+कृ० । मार कर, नष्ट कर । जिमि ससि हति हिम उपल  बिलाहीं।' मा० ७.१२२.१६ (२) आहत करके । ‘रोवहिं नारि हृदय हति पानी।' मा० ६.७२.५ (३) हुती थी। 'महाराज बाजी रची, प्रथम न हति । विन० २४६.४  तुलसी शब्द-कोश 
1131 
हती : हत+स्त्री० । मारी । 'एक तीर तकि हती ताड़का ।' गी० १.५२.६
हते : भूक००० । मारे, मारे गये । 'इहाँ हते सुर मनि दुखदाई।' मा०  ६.११६.११
हतेउ : हत+भूकृ.पु०कए । मारा, मार डाला । 'प्रथमहिं हतेउ सारथी तुरगा।'  मा० ६.६२.१
हतेसि : आo-भूक००+प्रए० । उसने मार डाला । 'बालि हतोसि मोहि मारिहि ___ आई।' मा० ४.६.८
हते : हतइ । 'सनमुख हतै गिरा-सर पैना।' वैरा० ४६
हतो : हत्यौ । मारा । जेहिं हतो सीस-दस ।' विन० २०४.३
हतों : हतउँ । मारू, मार डालू। 'हतो न खेत खेलाइ खेलाई ।' मा० ६.३५.११
हत्यो : हतेउ । 'लीला हत्यो कबंध ।' मा० ६.३६
हथवांसह : हयवास+मब० (सं० हस्तवंश)। हाथ की लग्गी से (धार में)  चलाओ। 'हाथवांसह बोरहु तरनि ।' मा० २.१८६
हथसार : सं०स्त्री० (सं० हस्तिशाला>प्रा० हत्थिसाल>अ० हत्थिसाल)। हाथी  का आवास । 'हाथी हथसार जरे घोर घोर सारहीं।' कवि० ५.२३
हथा : हाथ (सं० हस्तक>प्रा. हत्था) । 'अपनो ऐपन निज हथा।' दो० ४५४  (यहाँ हाथ की छाप से तात्पर्य है ।)
हथेरी : सं०स्त्री० (सं० हस्ततल>प्रा० हत्थयल)। हथेली, हाथ की गादी  (चिकना करतल) । 'हाथ लंका लाइहैं तो रहैगी हथेरी सी।' कवि० ६.१०
हव : सं०स्त्री (अरबी) । सीमा । 'कायर कर कपूपतन की हद ।' कवि० ७.१  हन,
हनह : आ०प्रए० (सं० हन्ति>प्रा० हणइ)। मारता है, मार सकता है।  'लछिमनु हनइ निमिष महं तेते।' मा० ५.४४.७
हनत : वकृ०० । मारता, मारते । (१) प्रहार करत, आयुध से आहत करता।  'एकहि एकु हनत करि क्रोधा।' मा० ६६५.६ (२) मारते ही (क्षण) । 'मष्टि प्रहार हनत सब भागे।' मा० ५.२८.८ (३) चोट करके मिटाता। 'हनत  गुनत गुनि गुनि हनत ।' दो० २४६
हनहि : मा०प्रब० । (सं नन्ति>प्रा० हणंति>अ० हहिं)। मारते हैं, तडित ____ करते हैं (बजाते हैं) । 'सुर हनहिं निसाना ।' मा० १.३०६.४
हनि : पू० । (सं० हत्त्वा>प्रा० हणिअ>अ० हणि)। (१) मारकर । 'बिस्वजयी  भृगुनायक से बिनु हाथ भये हनि हाथ-हजारी।' कवि० ६.५ (२) ताडित कर  (बजाकर)। 'हनि देव दुदुभि हरषि बरषत फूल ।' गी० १.६६.३
हनिय : आ० कवा०प्रए० । मारिए, मारा जाय। 'बलि जाउं हनिय न हाय।'  विन० २२०.७ 
1132 
तुलसो शब्द-कोश 
हनी : भूक०स्त्री० । (१) मारी। 'मुठिका एक महाकपि हनी ।' मा० ५.४.४  (२) तडित की (बजायी) । 'दु'दुभि हनी ।' मा० १.३२७ छं० ४
हनु : सं०स्त्री० (सं.) । ठुड्ढी, चिबुक । गी० ७.१७.१३ हनुमंत,
ता : सं०० (सं० हनुमत् >प्रा. हमुमंत)। हनुमान जी। मा० ४.३;  ५.७.४ 
हनुमत : हनुमंत (सं० हनुमत्) । 'हनुमत जन्म सुफल करि माना।' मा० ४.२३.१२
हनुमदादि : (सं.)। हनुमान् इत्यादि (वानरगण) । मा० ७.८.२ हनुमान,
ना : हनुमंत । मा० ५.२; १.१७.१०
हनुमानू : हनुमान-+कए० । मा० १.७.७
हन : हनुमान (प्रा० हणुव) । मा० ५.४४
हनुमंत : हनुमंत । मा० ६.५०.२
हनूमान : हनुमान । मा० ५.१
हने : भूकृ०० ब०। (१) मारे, मार डाले । 'प्रबल खल भुजबल हने ।' मा०  ७.१३ छं. १ (२) ताडित किये (बजाये) । 'हरषि हने गहगहे निसाना।'  मा० १.२६६.१
हनेउ : भूक००कए । आहत किया, हत किया । 'दामिनि हनेउ मनहुं तर तालू ।'  मा० २.२६.६
हनेसि : आo-भूकृ.पु+प्रए। उसने मारा। 'हने सि माझ उर गदा ।' मा०  ६६४.८
हने : हनइ । मा० ६.६४ छं.
हन्यो : हनेउ । 'तब मारुत सुत मुठिका हन्यो।' मा० ६.६५.७
हबि : संपु+स्त्री० (सं० हविष्-नपुं०)। (१) हव्यः हवन सामग्री जो  यज्ञ की आग में डाली जाती है । कवि० ५.७ (२) हविष्यान्न, यज्ञापित नैवेद्य  (का शेष खीर आदि) । यह हबि बाँटि देहु नृप जाई ।' मा० १.१८६.८
हबूब : सं०० (अरबी)। धूल उड़ाने वाला वातचक्र, बवडंर, अंधड़ । 'बानी झूठी  साची कोटि उठत हबूब है। कवि० ७.१०८
हम : (१) सर्वनाम-उब० (सं. अस्मद्>प्रा० अम्ह)। मा० १.६२.३  (२) अहंकार, आपा, अपने की अनुभूति । 'हम लखि, लखहि हमार, लखि हम  हमार के बीच ।' दो०१६ हमरि,
रो : हमारी । हमरि बेर कस भएह कृपिनतर ।' विन ० ७.२
हरिऔ : हमारी भी। 'हमरिओ' बनि गई है।' गी० २.३४.४
हमरें : हमारे यहाँ । 'हमरें कुसल तुम्हारिहिं दाया ।' मा० ७.५.४
हमरे : हमारे । मा० १.१८१.५
हमरेउ : हमारा भी, हमारे भी । 'हमरेउ तोर सहाई।' मा० १.१८४ छं.  तुलसी शब्द-कोश 
1133. 
हमरेहि : हमारे ही। 'सो जनु हमरेहि माथे काढ़ा ।' मा० १.२७६.३
हमरो : हमारो । 'हमरो मन मोहैं।' कवि० २.२१
हम-हम : अव्यय (सं. अहमहमिका-स्त्री.)। मैं ही करलू-पारों की प्रवृत्ति,  पहले 'मैं ही' वाली अहंकार भावना । 'हम-हम करि धन धाम संवारे।' विन०  १९८.२
हमहि : हमको, हमारे प्रति । 'कबहुं कृपाल हमहि कछु कहहीं।' मा० ७.२५.२
हमहुं : (१) हमने भी। हमहुं सुनी कृत पर तिय चोरी ।' मा० ६.२२.५  (२) हमारे द्वारा भी । 'हमहं कहनि अब ठाकुर सोहाती।' मा० २.१६.४  (हमारे द्वारा भी कहनी होगी)।
हमहू : हम भी। हमहू उमा रहे तेहि संगा।' मा० ६.८१.२ हमार,
रा : (१) वि० सर्वनाम (सं. अस्मदीय>अ० अम्हार, महार) । मा०  १.९६; ७७.२ (२) ममत्व, विषयों के प्रति हमारापन, अपनेपन की भावना ।  दे. हम-दो०१६ हमारि,
री : हमार-+स्त्री० (अ० अम्हारि, री) । मा० २.११, १.८१.५
हमारे : (१) हमारे में। 'नाथ एक गुन धनुष हमारें।' मा० १.२८२.७  (२) हमारे पास, हमारे यहाँ (हम को)। होउ नास नहिं सोच हमारें।' मा०  १.१६६.७
हमारे : वि० सर्वनाम (दे. हमार)। मा० १.६२.८
हमारो : हमारा+कए। हमारा । कवि० १.१२
हमैं : हमहि । हम को। 'हमैं पूछिहै कोन ।' दो० ५६४
हय : सं०पु० (सं०) । अश्व, घोड़ा। मा० २.१४२.८
हयगहें : अश्वशाला में । मा० १.१७१.८
हयसाला : संस्त्री० (सं० हयशाला)। वाजिशाला, घड़सार, तबेला। मा०  ६.२४.१३
हयो : भूक०कए० (सं०
हत:>प्रा० हओ>अ० हयउ) । मारा (गया) । 'बल  तुम्हारे रिपु हयो।' मा० ६.१०६ छं.
हर : (१) सं०० (सं.)। शिव । मा० २.२३१ (२) (सं० हल) कृषि का  उपकरण-विशेष । 'न तु और सबै बिष बीज बए, हर हाटक कामदुहा नहि क। कवि० ७.३३ (३) (समासान्त में) वि०पू० (सं०) । हरने वाला, नाशक, दूर करने वाला । त्रिविध सूल-हर ।' कृ० २१ (४) हरइ । हरण करता है।  हटाता है, मिटाता है। जिमि दिनकर हर तिमिर निकाया।' मा० ६.५२.७ 'हर, हरइ,
ई : मा०प्रए० (सं० हरति>प्रा. हरइ)। हरण करता है।  (१) संहार (प्रलय) करता है। जो सुजि पाल इ हरइ बहोरी। मा० २.२८२.२ (२) निरस्त करता है, मिटाता है । 'हरह पाप कह बेद पुराना।' 
1134 
तुलसी शब्द-कोश 
ह 
र 
मा० १.३५.१ (३) छीनकर ग्रहण करता है। हर सिष्य धन सोक न हरई।' 
मा० ७.६६.७
हरउ : आ०-प्रार्थना-प्रए० (सं० हरतु>प्रा. हरउ) । हर ले, दूर करे । 'हरउ  भगत मन के कुटिलाई ।' मा० २.१०.८
हरको : भक०स्त्री० । हट की, रोकी । 'कलिकाल की कुचाल काहू तो न हरकी।  कवि० ७.१७०
हरख : हरष । विन० १४३.४
हरखाने : हरषाने । गी० १.८६.६
हरगिरि : शिवजी का पर्वत=कैलास । मा० ६.२५.१
हरण : वि.पु. । हरने वाला। मा० ६ श्लो० १; विन० १०
हरत : वकृ००। (१) निरस्त करता-करते। 'हरत सकल कलि कलुष गलानी।'  मा० १.४३.३ (२) छीन लेता-लेते। 'हरत मनोहर मीन छबि प्रेम पिआसे नन ।' मा० १.३२६ (३) संहार करता। पालत सृजत हरत ।' मा०  ५.२१.५
हरता : वि० (सं० हत-हर्ता)। हरण कर्ता, संहारक । कवि० ७.१४६
हरतार : हरता । 'करतार भरतार हरतार ।' हनु० ३०
हरति : वकृ०स्त्री०। (१) निरस्त करती। (२) छीन लेती। हरति बाल रवि  दामिनि जोती।' मा० १.३२७.३ (३) संहार करती। 'जो सजति जगु  पालति हरति ।' मा० २.१२६ छं०
हरद : सं०स्त्री० (सं० हरिद्रा) । हलदी । मा० १.२६६.८ हरन,
ना : हरण । (१) सं०पू० । अपहरण । 'सीता हरन ।' मा० ३.३१ पुनि  माया सीता कर हरना।' मा० ७.६६.६ (२) भक अव्यय । हरने, निरस्त करने । 'सो अवतरेउ हरन महि भारा।' मा० ६.६.८ (३) वि.पु.।  हरणशील, हरने वाला। 'तारन तरन हरन सब दूषन ।' मा० ७.३५.६
हरनहार : वि०पू० । हरने वाला, निरस्त करने वाला । 'हरनहार तुलसी की  पीर को।' हनु० १० (२) संहारकर्ता। हरनि,
नी : वि०स्त्री० । हरणशीला, निरस्त करने वाली । ‘मंगल करनि कलि  मल हरनि तुलसी कथा रघुनाथ की।' मा० १.१० छं० 'स्वमति बिलास त्रास  दुख हरनी।' मा० ७.१५.६
हरनिहार : हरनहार । संहारकर्ता। 'हर से हरनिहार जपें जाके नाम ।' गी०  ५.२५.२
हरनू : हरन+कए । एकमात्र हरने वाला, नाशक । 'कहत सुनत दुख दूषन  हरनू ।' मा० २.२२३.१  तुलसी शब्द-कोश 
1135 
हरपुरी : (१) शिव-नगरी-कैलास। (२) काशी । विन० २२.६
हरवा : हार । 'चंपक हरवा अंग मिलि अधिक सोहाइ।' बर० १२
हरष : (१) सं०० (सं० हर्ष>प्रा० हरिस) । प्रसन्नता, आह्लाद । मा० १.२२८  (२) हरषद । 'पुनि पुनि हरष भसुडि सुजाना ।' मा० ७.१२४.१ 'हरष, हरषइ,
ई : आ०प्रए० (सं० हर्षति>प्रा० हरिसइ)। प्रसन्न होता है,  पुलकित होता है। 'देखि चरित हरषइ मन राजा।' मा० १.२०५.८%  ६.६७ छं०
हरषत : वकृ००। (१) प्रसन्न होता-होते । मा० २.३०६.१ (२) पुलकित  (रोमाञ्चित) होता-होते । 'पुनि पुनि हरषत गातु ।' मा० १.८१
हरषवंत : वि० (सं० हर्षवत् >प्रा० हरिसवंत)। पुलकित, हर्षयुक्त, प्रसन्न । मा०  १.१६४ हरहि,
हीं : आ०प्रब० (सं० हर्षन्ति>प्रा० हरिसंति>म० हरिसहिं) । पुलकित  (प्रसन्न) होते हैं । मा० ७.३६.४; १.३२५ छ०४
हरषा : भूक०० । प्रसन्न हुआ । 'सुर को समाजु हरषा ।' कवि० ६.७  'हरषा,
हरषाइ : हरषद (हरष+प्रए०)। प्रसन्न (रोमाञ्चित) होता-ती है ।  'नाउनि मन हरषाइ सुगंधन मेलि हो ।' रान० १८ हरषाइ,
ई : पूकृ० । प्रसन्न (पुलकित) होकर । 'सुनत चलेउ हरषाइ।' मा०  ७.१०, १.७३.७
हरषाऊं : मा० उए । प्रसन्न होता हूं (था) । 'बालचरित विलोकि हरषाऊँ ।' मा०  ७.७५.३
हरषाती: वकृ०स्त्री०। प्रसन्न (पुलकित) होती। मा० १.११३.७ हरषान,
ना : भूकृ.पुं० । प्रसन्न (पुलकित) हुआ। मा० ७.३ ग; ७.६३.३
हरषानी : भक०स्त्री०ब० । प्रसन्न (पुल कित) हुईं। 'तासु बचन सुनि सब  हरषानी ।' मा० १.२२३.८
हरषानी : भूक स्त्री० । प्रसन्न (पुलकित) हुई। मा० ७.५२.८
हरषाने : भूकृ००ब० । प्रसन्न (पुल कित) हुई । मा० ७.४७.८
हरषानेउ : भूक.पु०कए० । प्रसन्न (पुलकित) हुआ । 'राउ हरषाने उ ।' जा०म०  ११७
हरषाय : हरषाइ । मा० १.१५८ (पाठान्तर)। हरषाहि,
हीं : हरहिं । 'देखि कटकु भट अति हरषाहीं।' मा० ३.१८.८
हरषि : पूकृ० । प्रसन्न (पुल कित) होकर । 'हरषि चलेउ प्रभ ।' मा० ७.२
हरषित : वि० । हर्षयुक्त । मा० ७.३
हरषिहै : आ०म०ए० (सं० हर्षिष्यति>प्रा० हरिसिहिइ)। प्रसन्न (पुलकित)  होगा । 'प्रभु गुन सुनि मन हरषिहै।' विन० २६५.४ 
1136 
तुलसी शब्द कोश 
हरषी : भूकृ०स्त्री०ब० । प्रसन्न (पुल कित) हुई। 'देखि मातु सब हरषीं।' मा० 
हरषी : (१)भूक०स्त्री० । प्रसन्न (पुलकित) हुई । 'हरषी सकल मर्कट मनी ।' मा०  ६.८६ छं० (२) हरषि । 'नभ ते भवन चले सुर हरषी।' मा० ५.३४.८
हरषु : हरष+कए. । अद्वितीय हर्ष । 'हरषु बिरह अति ताहु ।' मा०७.४
हरषे : भूक००ब० । प्रसन्न (पुलकित) हुए। मा० ७.४.८
हरउ : भूक.पु.कए । प्रसन्न (पुलकित) हुआ । 'देखत हनूमान अति हरषेउ ।'  मा० ७.२.१
हरव्यो : हर उ । 'हरष्यो हिय हन मानु ।' कवि० ६.३०
हरस : हरष । गी० ६.२२.४
हरहाई : वि०स्त्री० । हरहट गाय आदि जो अपना गोल छोड़ कर खेत चरने निकल  जाती और रक्षक को देखते ही भागकर गोल में छिप जाती है। जिमि कपि  लहि घालइ हरहाई। मा० ७.३६.२ हरहि, ही आ०प्रब० । हरण करते हैं, मिटाते हैं, निरस्त करते हैं । मा० ७.७४ ख  २.६१.२
हरहि : हर को, शिव को । 'परिछन चली हरहि हरषानी ।' मा० १.६६.३ हरहु,
हू : आ.मब० (सं० हरथ, हरत>प्रा. हरह>अ० हरहु) । हरते हो, हरो। 
__'हरहु बिषम भव पीर ।' मा. ७.१३०, ३.१३.१६
हरहुगे : आ० म०पुमब० । हरोगे । 'दुसह दुख हरहुगे ।' विन० २११.३
हराँसू : हरांस (दे० हरास) कए० । अप्रतिम मनोव्यथा । 'बय बिलोकि हिय होइ  हरीसू ।' मा० २.५६.४
हराम : वि० (अरबी) । अविहित, वजित, निषिद्ध (हा राम) । 'हराम हो हराम  हन्यो।' कवि० ७.७६
हवराहि : आ.प्रब० । हराते-ती हैं; पराजित करते-करती हैं । 'करहिं आपु सिर  धरहिं आन के, बचन बिरंचि हरावहिं ।' कृ. ४
हरास : संपु (फा० हिरास= खौफ; हिरासीदन् = शङका करना)।  आशङ्का+नैराश्य+त्रास से युक्त मनोव्यथा । 'धनुष तोरि हरि सब कर  हरेउ हास ।' बर० १६
हरि : (क) पू० (सं० हत्वा>प्रा० हरिअ>अ० हरि)। हरण करके, अपहृत करके  (आदि)। 'सठ सूनें हरि आनेहि मोही।' मा० ५.६.६ (ख) सं०पू० (सं०) । (१) विष्णु । 'बिधि हरि हर पद पाइ।' मा० २.२३१ (२) राम (विष्णु रूप) । 'पुनि निज भवन गवन हरि कीन्हा ।' मा० ७.१०.२ (३) राम (दुःख हरने वाला-इरतीति हरिः) । 'धनुष तोरि हरि सब कर हरेउ हरास ।' बर. १६ (४) इन्द्र । जैसे, हरिधन' । गी० ७.१६.२ (५) सिंह । 'जिमि हरि  तुलसी शब्द-कोश 
1137 
बधुहि छुद्र सस चाहा।' मा० ३.२८.१५ (६) वानर । 'मेरे अनुमान हनुमान 
हरि-गन मैं ।' गी० ५.२३.२ (७) कृष्ण । मा० १.२०.८
हरिअर : वि०पू० (सं० हरित-तर>प्रा० हरिअर) । अत्यन्त हरा, हरा-भरा, हरे  रंग का।
हरिअरइ : हराही-हरा । 'मुनिहि हरिअरइ सूझ ।' मा० १.२७५
हरिउ : हरि (विष्णु) भी। विन० २५०.२
हरिऐ : आ० कवा०प्रए० (सं० ह्रियते>प्रा. हरीअइ)। दूर कीजिए, निरस्त किया ___ की जाय । 'मति मोर बिभेदकरी हरिऐ।' मा० ६.१११.१६
हरिचंद : सं०० (सं० हरिश्चन्द्र>प्रा० हरिच्चंद)। सूर्यवंश प्रसिद्ध सत्यवती  राजा । मा० २.६५.३
हरिजन : ईश्वर भक्त । मा० ७.१०५ हरिजान,
ना : (दे० जान) विष्णु-वाहन =गरुड़ । मा० ७.७८.३; ७.८७ ख
हरित : वि० (सं०) । हरे रंग का । मा० ७.११७.११
हरितमनि : हरे रंग का मणिपन्ना।
हरितमनिन्ह : हरितमनि+संब० । पन्नों (के)। हरितमनिन्ह के पत्र फल ।' मा.  १.२८७
हरितमनिमय : वि० (दे० मय)। पन्नों से रचित । 'बेन हरितमनिमय सब कीन्हे।'  मा० १.२८८.१
हरितोषन : वि० (सं० हरितोषण) । भगवान् को तुष्ट करने वाला (साधन)। ___हरितोषन ब्रत द्विज सेवकाई ।' मा० ७.१०६.११
हरिधाम : हरिपद । मा० ३.३२
हरिन : सं०० (सं० हरिण) । मृग (विशेष) । बर० २६
हरिनख : सं०० (सं.) । बधनहा (व्याघ्र के नखों की माला जो बच्चों को पहनाई ___ जाती है) । 'हिये हरिनख अति सोभा रूरी।' मा० १.१९६.५
हरिनबारि : मृगजल, मगतृष्णा, मगमरीचिका (भ्रान्ति)। 'पायो केहि घृत बिचार  हरिन-बारि महत ।' विन० १३३.५
हरिपद : विष्णु लोक (वैकुण्ठ); रामधाम (साकेत धाम), सालोक्य मोक्ष । मा०  १.१९२ छं० ४ (सायुज्य मुक्ति का भी अर्थ आता है-जीव शाश्वत रूप से  भगवान् का अंशरूप बनने का पद पाता है)।
हरिपद् : हरिपद+कए । अप्रतिम भगवत्पद । 'पाव नारकी हरिपदु जसें ।' मा०  १.३३५.६
हरिपुर : विष्णुलोक, रामलोक, मोक्ष पद। विन० २२०.५
हरिप्रीता : विष्णु प्रिय (विष्णु देवता वाला) । 'सकल पच्छ अभिजित हरिप्रीता।'  मा० १.१६१.१ 
1138 
तलसो शब्द-कोश 
हरिबधुहि : हरि=सिंह की वधू सिही को । 'जिमि हरिबधुहि छुद्र सस चाहा । ___ मा० ३.२८.१५
हरिबे : भकृ.पु. (सं० हर्तव्य>प्रा. हरिअब्ध)। (१) हरने । 'भारु हरिबे को  अवतारु लियो नर को।' कवि० ७.१२२ (२) हरना चाहिए । 'तो अतुलित  अहीर अबलनि को हठि न हियो हरिबे हो।' कृ० ३६ हरिय,
ये : हरिऐ । विन० १४.६ कोन बल ते संसार सोग हरिये ।' विन० १८६.५
हरि-रस : हरि-भक्तिरस, लीलारस ; भक्तिरूप परमानन्द का अप्रतिम स्वानुभव । 
_ 'पूनों प्रेम-भगति रस हरि-रस जानहिं दास ।' विन० २०३.१६
हरिशंकरी : संस्त्री० । विष्णु और शङकर की एक साथ स्तुति का पद | विन०  ४६
हरिहउँ : आ०भ० उए० (सं० हरिष्यामि>प्रा० हरिहिमि>अ० हरिहिउँ) ।  हरूँगा। (१) अपहृत कर (छीन) लाऊंगा । 'हरिहउँ नारि जीति रन दोऊ।' मा० ३.२६.३ (२) निरस्त करूंगा । 'हरिहउँ सकल भूमि गरुआई।' मा०  १.१८७.७ हरिहि,
हो : (क) आभ.प्रए० (सं० हरिष्यति>प्रा. हरिहिइ)। हरेगा।  (१) ले लेगा। 'हरिहि मम प्राना ।' मा० ६.५४.६ (२) निरस्त करेगा। 'प्रभु प्रताप रबि छबिहि न हरिही।' मा० २.२०६.३ (ख) हरि+हि ।  भगवान् को। 'हरिहि देखि अति भए सुखारी ।' मा० १.६५.३
हरिहैं : आ०प्रब०भ० । हरेंगे, दूर करेंगे । 'रघुनाथ कृपा करि हरिहैं निज वियोग  संभव दुख ।' गी० ५.६.१
हरिहै : हरिहि । हरण करेगा, दूर करेगा। 'ईस अजसु मेरो हरिहै।' गी० २.६०.४
हरिहौं : हरिहउँ । दूर करूंगा-गी। 'मारग जनित सकल श्रम हरिहौं ।' मा०  २.६७.२
हरी : (१) हरि । भगवान् । मा० ७.१३ छं० ३ (२) (समासान्त में) वि० स्त्री।  हरण करने वाली। 'अवलोकत सोच-बिषाद-हरी है। कवि० ७.१८०  (३) भूकृ०स्त्री० । अपहृत की । 'इहां हरी निसचर बैदेही ।' मा० ४.२.३ ।। हरीस,
सा : (सं० हरि+ईश =हरीश) वानर-राज । 'कह प्रभु सुनु सुग्रीव  हरीसा ' मा० ४.१२.७
हरु : (१) आ० -आज्ञा~मए० (सं० प्रा० हर>अ. हरु) । तू दूर कर ।  "चंद्रहास हरु मम परितापं ।' मा० ५.१०.५ (२) हर+कए । शिव । 'बिधि  हरि हरु ससि रबि दिसिपाला ।' मा० २.२५४.६
हरु : वि०० (सं० लघुक>प्रा० हलुअ) । हलका । मा० १.२५८.७
हरिमाई : सं०स्त्री० । लघुता, हलकापन । 'देह बिशाल परम हरुआई।' मा.  ५.२६.१  तुलसी शब्द-कोश 
1139 
हए : क्रि०वि० (हरू का रूपान्तर) हलके से (धीरे) । 'लखन पुकारि राम  हरुए कहि ।' गी० ३.६.१
हरे: (१) हरि+सम्बोधन (सं०) । हे हरि । मा० ७.१३ छं २ (२) वि.पु०ब०  (सं० हरित>प्रा. हरिम)। हरे रंग के (हरिअर) । 'मानों हरे तृन चारु 'चरें।' कवि० ७.४४ (३) भक पु०ब० । दूर किये । 'पाप हरे परिताप हरे।' कवि० ७.५८ (४) अपने अधीन कर लिये । 'सबके मन मनसिज हरे ।' मा०  १.८५ (५) हरने से, हटाने पर । 'हरे बनिहि प्रभु तोरे ।' विन० ११६.५ हरेउ,
ऊ : भूक००कए। हर लिया, निरस्त किया। 'दीनदयाल सकल दुख  हरेऊ ।' मा० ७.८३.४
हरें: हरिहिं । हरते हैं । 'लोचन कंज की मंजुलताई हरें ।' कवि० १.३
हरे : हर। (१) हरता है। 'बुद्धि बल बर बस्त हरै।' जा०म० छं०. १  (२) हरण करे, हर सकता है। 'रघुनाथ बिना दुख कौन हरै।' कवि० ७.५५  'बिकार श्री रघुबर हरै ।' मा० ७.१३० छं० २
हरैया : वि.पु. (सं० हतका)। हरणकर्ता। भूमि के हरैया उखरैया भूमि धरनि  के।' गी० १.८५.३
हरो : (१) हो। छीन लिया। 'बचन बिराग-बेष जगतु हरो सो है।' कवि०  ७.८४ (२) वि.पु.कए० (सं०
हरित:>प्रा. हरिओ) । हरा । 'सूझत रंग  हरो।' विन० २२६.२
हरौं : हरई। (१) हरता हूं, छोनता, (चुराता) हूँ । 'पर बित जेहि तेहि जुगुति  हौं ।' विन० १४१.५ (२) हर लूं, उखाड़ फेंकू । 'बीस भुजा दस सीस हौं।'  कवि० ६.१३
हता : वि.पु. (सं०) । हरणकर्ता ।
हर्यो : हरेउ । हर लिया। मन हर्यो मूरति साँवरी ।' जा०म० छं० १८ 
हर्ष : संपु० (सं०) । पुलक, प्रसन्नता । मा० १.१६०
हलक : सं०० (सं० हृदय>प्रा०हडक्क-अरबी-हलक-गला) । मन । 'समर  समर्थ नाथ हेरिए हलक में ।' कवि० ६.२५
हलधर : सं०० (सं०) । कृष्ण के अग्रज =बलराम । मा० १.२०.८
हलबल : सं०० (अनुकरणात्मक)। हड़बड़ी, हड़कम्प, हलचल । 'गाज्यो सुनि  कुरुराज दल हल बल भो ।' हनु० ५
हलराइ : पुकृ० । हिला-झुलाकर । 'गाइ गाइ हल राइ बोलिहौं ।' गी० १.१६.४
हलराइहौं : आ०भ० उए । हिलाऊँ-झुलाऊँगी। गी० १.२१.३
हलरावति : वक०स्त्री० । हिलाती-झलाती। 'बाल केलि गावति हल रावति।' गी.  १.७.२ 
1140 
तुलसी शब्द-कोश 
हलराव : आ०प्रए । हिलाती-झुलाती है। 'लै उछंग कबहूं हलराव ।' मा०.  १.२००.८
हलाको : वि०स्त्री० (अरबी-हलाक-नाई)। मड़ने वाली ठगिनी । 'ऊधौ जू  क्यों न कहै कुबरी जो बरी नटनागर हेरि हलाकी ।' कवि० ७.१३४
हलावहिं : आप्रब० (सं० हल्लयन्ति-हल्लनं कम्पनम् >प्रा. हल्लावंति>अ०.  हल्लावहि) । झिटकते हैं, हिलाते कंपाते हैं। 'खाहि मधुर फल बिटप  हलावहिं ।' मा० ६.५.६
हलाहल : सं०० (सं० हलाहल=हालाहल ; फा० हलाहल)। तीव्र विषविशेष ।
हलाहलु : हलाहल+कए । विन० २४.४
हले : भूकृ००ब० (सं० हल्लित>प्रा० हल्लिम)। हिल गये। 'धरनीधर धोर  धकार हले हैं।' कवि ६.३३
हलोरि : पू० (सं० हिल्लोलयित्वा>प्रा० हिल्लोलिअ>अ. हिल्लोलि)। तरङ्ग  उठाकर, विक्षुब्ध कर । कपीसु कयो बात घात उदधि हलोरि के।' कवि०  ५.२७
हलोरे : सं०पुब० (सं० हिल्लोलक>प्रा. हिब्लोलय) । तरङ्ग। 'देखत स्यामल  धवल हलोरे ।' मा० २.२०४.५
हवाले : क्रि०वि० (अरबी-हवाला=भयानक) । भमंकर जकड़ में । 'आजु करउँ ___ खालु काल हवाले।' मा० ६.६०.८
हसि : अहसि । तू है । 'का अनमनि हसि कह हँसि रानी ।' मा० २.१३.५
हमेचें : आ०-भकृ००+उए । मैं हंसा । 'हसेउ जानि बिधि गिरा असांची।  मा० ६.२६.२
हस्त : सं०पू० (सं.)। हाथ । मा० १.६७
हहरात : वक०० । थरथराता-ते (काँपते) । 'उछरत उतरात हहरात मरि जात ।"  कवि० ७.१७६
हहरान : भूक०० । थरथरा उठा, कांप गया। 'पाहरूई चोर हेरि हिय हहरान  है।' कवि० ७.८०
हहरानी : भक०स्त्री०ब० । थरथरा उठीं, कोप गयीं। 'हहरानी फौज भहरानी  जातुधान की।' कवि० ६.४०
हहराने : भूक०'ब० । हरहरा कर (अंधड़ के समान) चले, कांप उठे। 'हहराने  बात, भहराने भट ।' कवि० ५.८
हहरि : पूकः । (१) दहलकर, थरथरा कर, कम्पित होकर । 'बिहरत हृदउ न  हहरि हर ।' मा० २.१६६ (२) ह-ह ध्वनि करके । 'हहरि हहरि हंसे ।' कवि० ६.४२  तुलसी शब्द-कोश 
1141 
हहरी : भक०स्त्री० । थरथरा उठी, कांप गयो । 'हहरी हृदय बिकल भइ भारी।'  कृ०६०
हहरु : आ० -- आज्ञा-मए । तू कम्पित हो, तू थरथरा । 'तुलसी तू मेरो, हारि  हिये न हहरु ।' विन० २५०.४
हहरे : भूकृपु०व० । थरथरा उठे, काप गये । 'हहरे हृदय हरास ।' रा०प्र०  ३.७.५
हहर्यो : भूकृ००कए । काँप गया, थरथरा उठा । कलि बिलोकि हहर्यो हौं।'  विन० २६७.४
हहा : हा-हा । (१) हास ध्वनि । 'हँसे प्रभु जानकी ओर हहा है ।' कवि० २.७  (२) आति, दैन्य, दुःख का सूचक (अव्यत) । 'काढ़त दंत करत हहा है।' कवि० ७.६६ (३) सं०स्त्री० । आति सूचक ध्वनि । 'तुलसी हहा करी।'  कवि० ७.६७
हहिं : अहहिं । हैं । 'करत हहिं निंदा।' मा० ३.३७.४
हहु : अहहु । हो । 'जानति हहु बस नाहु हमारे।' मा० २.१४.५
हो : स्वीकार बोधक अव्यय (सं. आम्, हं) । कवि०७.१२८
हाँक : सं० स्त्री० (प्रा० हक्का) । (१) पुकार, बुलावा, आमन्त्रण । 'तुम्ह तो कालु  हाँकि जनु लावा ।' मा० १.२७५.१ (२) आह्वान, ललकार । 'हाँक सुनत रजनीचर भाजे ।' मा० ६.४७.६ (३) सन्देश । 'अब बिसेष देखो तुम्ह, देखो हैं  कुबरी हाँक से लाए।' कृ०५०।।
हांकहिं : आ.प्रब० । पुकारते हैं । 'तात यों हाँकहिं ।' कृ० १३
होकहु : आ०मब० । हाँको, परिचालित करो । 'खोज मारि रथ हाँकहु नाता।'  मा० २.८४.८
हांकि : पूर्व० । (१) चला (कर)। 'भयं रथ हाँकि न जाइ।' मा० ३.२८  (२) हाँक देकर, ललकार कर । 'हेरि हँसि हाँकि फूकि फौज तै उड़ाई हैं।'  हनु० ३५
हाँके : भकृ०ब० । चलाये हुए । 'चले समीर बेग हय हाँके ।' मा० २.१५८.१ हाँके
उ : भूकृ००कए । हाँका, चलाया । 'रथ हाँकेउ ।' मा० २.६६
हाँडी : सं०स्त्री० (सं० हण्डिका>प्रा० हंडिआ>अ० हंडी)। मिट्टी का पात्र  विशेष । 'हाँडी हाटक घटित चरु राधे स्वाद सुनाज ।' दो० १६७ .
जाती : वि.स्त्री० [सं० हात्र=नाश, हानि) । नष्ट, क्षीण । 'भीर प्रतीति प्रीति  करि हाँती।' मा० २.३१.५
हासा : हासा, हास । · कुमुद-बंधु-कर-निंदक हाँसा।' मा० १.२४३.५
हांसी : हँसी (सं० हास) । उपहास । 'मारहिं चरन करहिं बहु हाँसी ।' मार  ५.२५.६ 
1142 
तुलसी शब्द-कोश 
हा : (१) अव्यय (सं.)। शोक, अवसाद, दैन्य आदि का सूचक । 'हा राम हा  रघुनाथ ।' मा० ६.१०१.६ (२) (समासान्त में) वि०० (सं० हन्) विलाश  कारी । 'रघुबंस बिभूषन दूषन-हा ।' मा० ६.१११.८
हाट : हट्ट। मा० २.११.३
हाटक : सं०० (सं० हटति दीप्यते इति हाटकम्-हट दीप्तो) । देदीप्यमान __सुवर्ण । 'सजे सबहिं हाटक घट नाना ।' मा० १.६६.३
हाटकपुर : स्वर्णमयी नगी लङका । मा० ५.३३.८
हाटकलोचन : सं०० (सं०-हिरण्याक्ष रहिरण्य -हाटक+अक्षि =लोचन)।  हिरण्याकशिपु का अनुज असुरविशेष । मा० १.१२२.६
हाटकु : हाटक+कए० । सुवर्ण कवि० ५.२४ हाड़,
डा : सं०० (सं० हड्डी= अस्थि) । हड्डी । मा० १.१२५; ६.५२.३
हाता : वि.पुं० (सं० हात–हाता)। त्याग कराने वाला, नष्ट करने वाला। ___यातुधान-प्रचुर हर्ष-हाता ।' विन० २६.५
हामो : वि००कए० (सं० हात्र) । (१) हीन, वञ्चित । 'सोहेब सेवक नाते ते  हातो कियो।' हनु० १६ (२) क्षीण, त्यक्त, नष्ट । 'हातो की हीय ते भरोसो  भुज बीस को।' कवि ६.२२
हाथ : हस्त (प्रा० हत्थ)। (१) कर, पाणि । मा० ७.१७.६ (२) लाभ  (लाक्षणिक) । 'नहिं लागिहि कछु हाथ तुम्हारें।' मा० २.५०.५ (३) अधीन  (लाक्षणिक) । मन हाथ पराएं।' मा० १.१३४.५
हाथहमारी : (दे० हजारी) सहस्रबाहु । कवि० ६.५
हाथहि : हाथ में, को। 'फरकि बाम भुज नयन देत जनु हाहि ।' जा०म० १०१
हाथा : हाथ । मा० २.५२.१
हाथिन : हाथी+संब० (सं० हस्तिनाम् >प्रा० हत्थीण)। हाथियों । 'हाथिन सों  हाथी मारे।' कवि० ६.४०
हाथी : सं०पू० (सं० हस्तिन् >प्रा० हत्थी) । कवि० ५.६
हाथु : हाथ+कए । एक भी हाथ (प्रहार) । 'बहइ न हाथु दहइ रिपु छाती।"  मा० १.२८०.१ हानि,
नी : सं०स्त्री० (सं०) । क्षति, नाश । मा० १.४.२; १.३६.५
हानिकर : वि.पु. (सं०) । नाशकारी । 'अघहानि-कर ।' दो० २३७
हाय : अव्यय (सं० हा)। विस्मय, क्लेश, क्षोम, शोक आदि-सूचक । माक  १.२७६.५ हनु० ३८
हार : (१) सं०पू० (सं०) । माला । मा० १.१४७.६ (२) मैदान । खेत, उपवन 
___ आदि । 'मानरु बिचारो बाँधि आन्यो हटि हार सों।' कवि० ५.११ 
तलसी शब्द-कोश 
1143 
'हार, हारइ,
ई : आ०ए० (सं० हारयति>प्रा० हारइ) पराजित होता या  अनुभव करता है । बिधंस कृत मख देखि मन महं हारई ।' मा० ६.८५ छं०
हारति : वकृस्त्री० । हारती, गवांती। यह बिचारि अंतरगति हारति ।' गी.  ५.१६.३
हारहिं : आ० प्रब० (अ०) । हार जाते हैं, पराजित (क्षीण) होते हैं। 'हारहिं  सकल सलभ समुदाई ।' मा० ७.१२०.५
हारहि : आ०मए० (अ०) । तू हार, सो दे, गवां दे । 'हारहि जनि जनम जाय ।'  विन० १३०.२
हारा : भूकृ.पु । (१) पराजित हुआ । 'हियें हारा भय मानि ।' मा० ४.८  (२) दाव पर लगा दिया (रखो दिया)। 'अब मैं जन्म संभु हित हारा।' मा०  १.८१.२
हारि : (१) संस्त्री० । पराजय । 'मानि हारि मन मैन ।' मा० १.१२६  (२) पूकृ० । हार कर, पराजित होकर । 'हारि परा खल बहु बिधि ।' मा० ३.२६ (३) (समासान्त में) वि.पु. (सं० हारिन) हरने वाला। 'संसय-भय  पर।' विना सान्त में) विलकर । 'हारि 
हारिको : भकृ००कए० । हारना । 'प्रभु के हाथ हारिबो जीतिबो नाथ ।' विन०  २४६.४ 
हारी : (१) भक०स्त्री० । दांव पर खोदी, गवा दी। 'मन हुं सबन्हि सब संपति  हारी।' मा० २.१५८.८ (२) हारी गई । 'कहा भयो कपट जुआ जो हौं हारी।' कृ०६० (३) हरि । पराजय । 'प्रगटत दुरत न मानत हारी।' कृ० २२ (४) ग्लानि, थकावट । 'मोहि मग चलत न होइहि हारी।' मा० २.६७.१ (५) (समासान्त में) वि.पु. (सं. हारिन्) । हरने वाला । 'सब विधि तुम्ह  प्रनतारति-हारी।' मा० ७.४७.३
हारें: क्रि०वि० । हारे हुए, पराजित दशा में, थके से होकर । हिय हारें चले  जाहिं।' मा० २.३००.८
हारे : भूक.पुब० (सं० हारित>प्रा० हारिय) । (१) पराजित हुए। (२) गवां  दिये (दे दिये) । 'मम हित लागि जन्म इन्ह हारे।' मा० ७.८.८ (३) शिथिल हो गये । 'थके बिलोकि पथिक हियँ हारे।' मा० २.२७६.५ (४) हारें । हारने  से । तिन्ह के हाथ दास तुलसी प्रभु कहा अपनपी हारे ।' विन० १०१.३
हारे : आ०-भूक००+उए । मैं हार गया। 'हृदय हेरि हारेउँ सब ओरा।'  मा० २.२६१.७
हारेउ : भूक०कए । हार गया, थक गया । 'हारेउ पिता पढ़ाई पढ़ाई ।' मा०  ७.११०.८ 
1144 
तुलसी शब्द-कोश 
७.७७.४ 
हारेहुं : हारने पर भी, हारे हुए में भी। 'हारेहुं खेल जितावहिं मोही।' मा०  २.२६०.८
हारो : हार्यो । थक गया । 'मन तो हिय हारो।' हनु० १६
हार्यो : हारेउ । पराजित हुआ। विन० २४७.३  हाल,
ला : (१) सं००+स्त्री० (अरबी == वर्तमान काल ; फा० स्थिति, गति) ।  दशा, अवस्था । कनक कसिपु कर पुनि अस हाला।' मा० १.७६.२ 'जैसी हाल करी यहि ढोटा ।' कृ० ३ (२) परिणाम, फल । 'राम बिमुख अस हाल  तुम्हारा ।' मा० ६.१०४.१०
हालिहै : आ०भ०प्रए० (सं० हल्लिष्यति>प्रा. हल्लिहिइ)। हिल जायगा,  प्रकम्पमान हो उठेगा । 'मसक हर कहै, भार मेरे मेरु हालिहै। कवि० ७.१२०
हाल : हाल+कए० . दशा, गति । गी० ५.३.४ ।। हास,
सा : सं००+स्त्री० (सं० हास)। (१) हंसने की क्रिया। मा० ७.७७.४  (२) हंसी, परिहास । 'तासु नारि सभीत बडि हासा ।' मा० ५ ३७.४ (३) स्मित, मुसकुराहट । 'सूचत किरन मनोहर हासा।' मा० १.१९८.७ (४) (सं० हास्य>प्रा० हास) । काव्यरस-विशेष जिसका स्थायी भाव हास है तथा मूर्खता आदि आलम्बन होते हैं । तिन्ह कहँ सुखद हास रस एहू ।'  मा० १.६.३
हास-अवास : (सं० हासावास=हास+अवास) कोहबर, घर में देवगृह जहाँ भावर  के बाद वर-वधू जाते और हासविनोद क्रीडा करते हैं । पा०म० १३३
हाहा : मनुहार, अनुनय, खेद, आश्चर्य, पश्चात्तम, आक्षेप, निन्दा आदि का बोधक  अध्यय (सं.)। मा० ६.७०
हाहाकार : सं०० (सं.) । खेद, क्लेश, संकट आदि का सूचक कोलाहल शब्द =  हा-हा ध्वनि । मा० १.८७.७, ६.४२.४; ६.६३.५, ६६.७; ७.१०७ क
हाहाकारा : हाहाकार । मा० १.६४.८
हिं : (क) अव्यय (सं० हि-निश्चयार्थक) । ही। 'होइ मरनु जेहिं बिनहिं श्रम ।'  मा० १.५६ (ख) (१) हि । को , 'करि बिनती गिरिजहिं गृह ल्याए ।' मा० १.८२.१ (२) अधिकरण विभक्ति-में। 'तपहिं मन लागा। मा० १.७४.३ (३) से, साथ। 'अस बरु तुम्हहिं मिलाउब आनी। मा० १.८०.४ (ग) आख्यात विभक्ति ब० । 'जहँ चितवहिं तह प्रभु आसीना । सेवहिं सिद्ध  मुनीस प्रबीना । मा० १.५४.६
हिंकरि : पूक० । हि-हिं ध्वनि करके । 'हिंकरि हिंकरि हित हेरहिं तेही।' मा०  २.१४३.७ हिंडोर,
रा : सं०० (सं. हिन्दोल)। झला, पालना । 'पलँग पीठ तजि गोद  हिंडोरा।' मा० २.५६.५  तुलसी शब्दकोश 
1145 
हिडोल,
ला : हिंडोरा । गी० ७.१८.४
हिडोलना : हिंडोल (सं० हिन्दोलनक)। 'आलि री राघो के हिंडोलना झूलन जैए।'  गी० ७.१८.१
हिंडोलसाल : सं०० (सं० हिन्दोल-साल)। वह वृक्ष (साल) जिस में हिंडोला  बंधा हो । गी० ७.१८.४ ।
हि : (क) निश्चयार्थक अव्यय (सं.)। ही । मा० १ श्लोक ३ (ख) अवधी  विभक्ति जो 'प्रति' के समान अर्थ देती है । 'भरतहि अवसि देहु जुबराजू (भरत को)।' मा० २.५०.२ 'रामहि तिलकु काल्हि जौं भयऊ (राम का, राम के लिए)।' मा० २.१६.६ 'राजहि तुम्ह पर प्रीति विसेषी (राजा में) ।' मा०  २.१८.५
हिस : सं०स्त्री० (सं० ह्रषा)। हींस, हीसना (अश्व-शब्द) । रथ रव बाजि हिंस  चहुं ओरा।' मा० १.३०१.१
'हिंसक : वि० (सं.)। हिंसा करने वाला-वाले, जीवधाती । मा० १.१७६.८ 
हिसा : सं०स्त्री० (सं.)। परपीडन, प्राणिवध, स्वार्थ हेतु या अकारण जीवघात ।  मा० १.१८३
हिएँ : हृदय से, में । 'पदपंकज सेवत सुद्ध हिएँ।' मा० ७.१४ छं० ।
हिए : (१) हिय । हृदय । 'कहउँ हिए अपने की।' मा० २.३०१.२ (२) हिएँ ।  हृदय में । 'मग लोग कुभोग सरेन हिए-हति ।' मा० ७.१४/०
हित : (१) वि० (सं.)। हितकारी, मित्र, प्रियजन । ‘हित अनहित मध्यम श्रम  फंदा ।' मा० २.१२.५ (२) इष्ट कार्य, कल्याण । 'मम हित लागि जन्म  इन्ह हारे।' मा० ७.८.८ (३) सं०पु । प्रति । 'हित द पद सरोज सुमिरौं ।' विन० १४१.५ (४) क्रि०वि० । को, के लिए (प्रयोजन, साध्य) 'हरि हित आपु गवन बन कीन्हा ।' मा० १.१५३.८ (५) ओर | 'हिंकरि हिकरि हित हरेहि  तेही।' मा० २.१४३.७
हितकारक : हितकारी (सं०) । मा० १.१५४.१ .
हितकारी : वि.पु. (सं० हितकारिन्) । अपने अनुकूल आचरण करने वाला,  हितू, उपकारी। मा० ७.२२.८
हितनि : हित+संब० । हितों, इष्ट वस्तुओं। हितनि के लाह की।' गी०  १.६६.५
हिताहित : (हित+अहित) । अच्छा-बुरा, अनुकूल-प्रतिकूल । गी० ५.१२.४ ।।
हितु : हित+कए । (१) कल्याण (इष्ट फल प्रप्ति) । 'राम सों सामु किए हितु  है।' कवि० ६.२८ (२) उपकार । 'करि हितु हरहु चाप गरुआई ।' मा०  १.२५७.६ (३) प्रियजन । 'चितवहिं हितु जानी।' मा० १.२६६.३
हितू : हितु । (१) प्रियजन, सगे संबंधी । 'जेउ कहावत हितू हमारे।' मा०  १.२५६.१ (२) हितकार्य करने वाला-वाले । 'उधो परम हितू हित सिखवत ।'