तुलसी शर-कोश 
509 
नसावाह : आ०मए० । तू नष्ट कर ! 'करन कलंक नसावहि ।' विन० २३७.३
नसावा : (१) नसावइ । 'ममता केहि कर जस न नसावा ।' मा० ७.७१.२ (२) भूकृ०० (सं० नाशित>प्रा० नसाविअ) नष्ट किया, बिगाड़ा। 'आह दइअ मैं काह नसावा ।' मा० २.१६३.६
नसावं : नसावइ । चाहे मिटा दे, मिटा सके। 'अंधकारु बरु रबिहि नसाब ।' मा० ७.१२२.१८
नसावौं : आ० उए० (सं० नाशयामि>प्रा० नसावमि>अ० नसावउँ) । नष्ट करता , मिटा रहा हूं। 'भेक ज्यों रटि रटि जनम नसावौं ।' विन० १४२.४ 
नसाहि, हीं : आ०प्रब० (सं० नश्यन्ति >प्रा० नासंति>अ० नासहि) । नष्ट हात हैं, मिट जाते हैं। पर संपदा बिनासि नसाहीं।' मा० ७.१२१.१६
नर्सहैं : आ०भ०प्रब । मिटेंगे। 'सकल परिताप नसहैं।' गी० ५.५१.५
नसहौं : नसाइहों । नष्ट करूँगा, मिटने देगा। 'अब लौं नसानी अब न नसहौं ।' विन० १०५.१
नस्वर : वि० (सं० नश्वर) । विनाश-शील । 'नस्वर रूप जगत सब।' मा० ६.७७
नह : नख (प्रा०)। 
नहछ : सं०० (सं० नखक्षर, नखच्क्षर >प्रा० नहच्छर)। नाखून काटने की क्रिया, प्रथम बार बालक के नख काटने के मुहूर्त का उत्सव । दे०रा०न० ।
नहत : वकृपु० (सं० नात >प्रा० नहत) । जोतता, माची या हल में बांधता । 'पसु लौं पसुपाल ईस बांधत छोरत नहत ।' विन० १३३.३
नहते : क्रियाति०पू० ब० (सं० अनक्ष्यन>प्रा० नहंत-महंतय)। जोतते, हल या जए में लगाते। तो जमघट साँसति हर हमसे बषभ खोजि-खोजि नहत ।" विन० ६७.४
नहरनी : सं०स्त्री० (सं० नखहरणी>प्रा० नह-हरणी)। नाखून काटने का उपकरण, नख-कर्तनी, नाखुनगीर । रान० १० निहा 
नहाइ, ई : (सं० स्नाति >प्रा० न्हाइ) आ० प्रए० । नहाता है, स्नान करता है। बिमल ग्यान जल जब सो नहाई ।' मा० ७.१२२११
नहाइ : (१) नहाता है। (२) प्रकृ० (अ० न्हाइ) । नहाकर, स्नान करके । 'प्रात नहाइ चले रघुराई ।' मा० २.१२४.४ (३) नहाने (को)। 'जो नहाइ चह एहिं सर भाई ।' मा० १.३६.८
नहाई : (१) नहाइ । नहाता है। (२) नहाइ । नहाकर । मा० २.२७६.६
नहाए : भूकृ००० । स्नान से निवृत्त हुए (स्नान किया)। 'आइ नहाए सारत बर।' म ० २.१३२
नहात : वकृ०० । स्नान करता-ते । 'जाना मरम नहात प्रयागा। मा० २.२०८.५ 
510 
_______________________________________________
नहान : भकृ० अव्यय । स्नान करने । 'प्रात नहान लाग सब कोऊ ।' मा० २.२७३.३
नहाना : नहान । 'पाइ रजायसु चले नहाना । मा० २.२७८.८
नहानी : भूकृ०स्त्री० ब० । स्नान-निवृत्त हुईं। 'मातु नहानौं ।' मा० २.१६७
नहाने : भकृ०० ब० । स्नान निवृत्त हुए। 'सविधि सितासित नीर नहाने ।' मा० २.२०४.४
नहारू : नाहरू । 'मारसि गाय नहारू लागी।' मा० २.३६.८
नहावा : भूकृ० । स्नान किया । 'सफल सौच करि राम नहावा ।' मा० २.६४.३
नहाही : आ०प्रब० (सं० स्नान्ति>प्रा० न्हंति>अ० न्हाहिं)। स्नान करते हैं। 
_ 'एहि प्रकार भरि माघ नहाहीं।' मा० १.४५.१
नहाहू : न्हाहु । 'तात जाउँ बलि बेगि नहाहू ।' मा० २.५३.१ 
नहि, ही : निषेधार्थक अव्यय (सं० नहि । नहीं। मा० १.३.२
नहि : (१) नहिं (सं०) । 'जात नहि कछु कही।' गी० ७.६.१ (२) पूकृ० (सं० नवा >प्रा० नहिअ>अ० नहि) । नह कर, हल आदि में जोत कर । 'न तु और सबै बिष बीज बए, हर हाटक कामदुहा नहि के।' कवि० ७.३३
नहुष : सं०० (सं०) । एक पुराण प्रसिद्ध राजा जो कुछ समय के लिए इन्द्र पद पर रहा और इन्द्राणी को पाने की इच्छा से ब्राह्मणों को जोत कर पालकी पर चढ़ा और शाप.भागी बना । मा० २.६१
नहे : भूक००० (मं० नद्ध>प्रा० नहिय) । जोते, जुए आदि में बांधे हुए। रहट नयन नित रहत नहे री।' गी० ५४६.२
नह्यो : भूकृ००कए । नहाया, स्नान किया। 'जूठनि को लालची, चहौं न दूध नह्यो हौं ।' विन० २६०.३
नांक : नाक । स्वर्ग । 'नव नाथ नांक को ।' हन० ६२
नाँधी : नाघी । गी० ३.७.२
नाँय : नाम । 'ललित लागत नाय ।' गी० ६.१४.४
ना : न (स०) । 'उदित सदा अथइहि कबहू ना ।' मा० २.२०६.२
नाइ : पू० । नवा कर, झुका कर । 'कहिहउँ नाइ राम पद माथा ।' मा० १.१३.६
नाइअ : आ०कवा०प्रए० । झुकाइए, नत किया जाय । 'ताहि बयरु तजि नाइम माथा ।' मा० ५.३६.५
नाइन्हि : आ०-- भूकृ० + प्रब० । उन्होंने झुकाया। 'सिव सुमिरे मुनि सात आइ सिर नाइन्हि ।' पा०म० ७५
नाइहि : आ०भ०प्रए० । झुकाएगा। कालउ तुअ पद नाइहि सीसा ।' मा० १.१६५.२ तलसो शब्द-कोश 
511 
नाइहै : (१) नाइहि । (२) मए । तू झुकाएगा। 'भलो मानिहैं रघुनाथ जोरि ___जो माथो नाइहै।' विन० १३५.५
नाई : क्रि०वि० (सं० न्यायेन>प्रा. नाएण>अ० नाइं)। समान । (१ 'तन मिल्यो जलपय की नाईं ।' कृ० २५ ‘सब सुत प्रिय मोहि प्रान कि नाई।' मा० १.२०८.५ (२) मानों । 'मुनि कहें चले बिकल की नाई।' मा० १.१३६.५
नाई : (१) नाइ। झुका कर। 'सिंघासन बैठेउ सिर नाई।' मा० ६.३५.५ (२) भूक०स्त्री० । झुकायी, उँडेल दी। 'मानो मदन मोहनी मूड़ नाई हैं।' गी० १.७१.३ (३) नाई । समानता । 'असि मन्मथ महेस की नाई।' मा० १.६०.८
नाउँ : सं०पु०कए० (सं० नाम>प्रा० नामं>अ. ना) । 'नाउँ गाउँ बूझत सकुचाहीं।' मा० २.११०.३
नाउ : (१) नाव । नोका। दो० ३५८ (२) आ० -- आज्ञा-मए० । तू झुका । परिहरि प्रपंच सब नाउ राम पद कमल माथ ।' विन० ८४.४
नाउनि : सं०स्त्री० (सं० नापिती) । नाऊ जाति की स्त्री । रान० १०
नाऊँ : नाउँ । 'मयसुत मायाबी तेहि नाऊँ।' मा० ४.६.२
नाऊ : सं०० (सं० नापित>प्रा० नाविअ)। नाई, केशकर्तक जाति विशेष । 'नाऊ बारी भाट नट ।' मा० १.३१६
नाएँ : क्रि०वि० । (१) झुकाये हुए (मुद्रा में) । 'मन मुसुकाहिं रामु सिर नाएँ।' मा० २.२८१.४ (२) झुकाने से । 'कपीसु निसिचरु अपनाए नाएँ माथ जू ।' कवि० ७ १६ (३) अवमानित किये हुए । 'निज सुदरता रति को मदु नाएँ।' कवि० ७.४५
नाए : भूक००ब० । झुकाये । 'आइ सबन्हि सादर सिर नाए ।' मा० १.२८७.३
नाएसि : आ०-भूक पु+प्रए० । उसने झुकाया (या झुकाये)। 'जाइ कमल पद नाएसि माथा।' मा० ४.२५.७
नाक : (१) सं०० (सं०)। स्वर्ग । 'महि पाताल नाक जसु ब्यापा ।' मा० १.२६५.५ (२) सं०स्त्री० (सं० नका>प्रा० नक्का>अ. नक्क) । नासिका। 'नाक कान बिनु भइ बिकरारा।' मा० ३.१८.१
नाकचना : (मुहावरा) ऐसा कठिन कार्य (संकट) जैसे नाक से चने चबाना । 'दसमुख बिबस तिलोक लोकपति बिकल बिनाए नाकचना हैं।' गी० ७.१३.७
नाकनटी : नाकनटी स्वर्गनटी+ब० । स्वर्ग की नर्तकियां, अप्सराएँ। 'नाकनटी नाचाहिं करि गाना।' मा० १.३०९.४
नाकप : नाकपति (सं.)। इन्द्र । 'रॉकनि नाकप रीझि करै। कवि० ७.१५३
नाक्रपति : स्वर्ग-राज, इन्द्र । 'रंक नाकपति होइ।' मा० २.६२ 
512 
_______________________________________________
नाकपाल : नाकपति । कवि० ७.२३
नाकेस : (सं० नाकेश) इन्द्र । गी० ७.१६.१
नाग : सं०० (सं०) । (१) सर्प । 'खगपति सब धरि खाए नाना नाग बरूथ ।' मा० ६.७४ क (२) हाथी । 'सजहु तुरग रथ नाग ।' मा० २.६ (३) पाताल वासी जातिविशेष जिसका सिर (पुराणों में) सर्प का कहा गया है। 'देव दनुज नर नाग खग ।' मा० १.७ घ
नागपास : (सं० नागपाश) । सर्प-बन्धन, मायिक सर्पबाणों का जाल । 'नागपाल बाँधेसि ले गयऊ।' मा० ५.२०.२
मागमनि : (१) सर्प की मणि (२) गजमुक्ता । 'उर अति रुचिर नागमनि माला ।' मा० १.२१६.५
नागर : वि०० (सं०) । (१) नगरनिवासी। गनी गरीब ग्राम-नर नागर ।' मा० १.२८.६ (२) शिष्ट, सुसंस्कृत, सभ्य । ‘गुनसागर नागर बर बीरा ।" मा० १.२४१.२ (३) कलाकुशल । 'नागर नट चितवहिं चकित हहिं न ताल बंधान ।' मा० १.३०२ (४) दक्ष, निपुण, विवेकशील । 'बोले बचनु राम नय नागर ।' मा० २.७०.७ (५) तीव्र, क्षिप्रकारी । 'अतिनागर भवसागर सेतः।' मा० ३.११.१४ (६) काव्य की या कथन की कोमल गुणों से सम्पन्न रीति में निपुण । 'जयति बचन रचना अति नागर ।' मा० १२८५.३
नागरमनि : नागरों में श्रेष्ठ । 'नटनागरमनि नंदललाऊ ।' कृ० १२
नागराज : गजराज । विन० ६३.२
नागरि : नागरी । ग्वालिनि अति नागरि ।' कृ० १२
नागरिपु : (१) सर्प शत्रु =गरुड़ । (२) गजशत्रु =सिंह । 'निज कर डासि नागरिपु छाला।' मा० १.१०६.५
नागणे : नागरी+ब० । नगर की कुशल सुन्दरियाँ । 'लोचन लाह लटति नागरी।' जा०६० १६
नागरी : नागर+स्त्री० (सं०) ।
मागा : नाग। (१) हाथी। मा० १.१० १.७ (२) सर्प । 'जनु सपच्छ धावहिं बहु नागा।' मा० ६.५०.५ (३) पाताल की जाति । मा० १.१८२.११
मागे : वि.पु० (सं० नग्नक>प्रा० नग्गय) । दिगम्बर, निर्वसन (शिव) । 'नागे के आगे हैं मागने बाढ़े।' कवि० ७.१५४
नागेन्द्र : (सं.)। गजराज, हस्तियूथप । विन० ४६.४
नागो : वि०पु०कए० (सं० नग्नः>प्रा० नग्गो)। दिगम्बर, वस्त्रहीन । 'नागो फिरै, कहै मागनो देखि, न खागो कछु ।' कवि० ७.१५३ 
_______________________________________________
513 

नाघ, नाघइ : (सं० लङ्घयति>प्रा० लंघह; सं० नाखयति-नख गती>अ० नाघइ) आप्रए । कूद जाता है, लांघ जाता है, फांद सकता है । 'जो नाघ सत जोजन सागर ।' मा० ४.२६.१
नाघउ : आउए । लांघ सकता हूं, फलांग जाता हूं। 'लीलहिं नाघउ जलनिधि खारा ।' मा० ४.३०.८
नाघत : वक.पु । लापता, मांधते । 'नाघत भयउ पयोधि अपारा।' मा० ७.६७.३
नाहिं : आप्रब० । लांघ जाते हैं । 'नाहिं बग अनेक बारीसा।' ६.२८.२
नाघि : पू० । लांधकर । 'नाघि सिंधु एहि पारहि आवा।' मा० ५.२८.२
नाधी : भूकृ०स्त्री० । लोधी । 'कहे कटु बचन रेख नाघी मैं।' गी० ३.७.२
नाघेउ : भूकृ००कए । लांघ गया। 'पुर दहि नाघेउ बहुरि पयोधी।' मा० ७.६७.५
नाघेहु : आ०-भूकृपु+मब० । तुमने लांधा। 'सोउ नहिं नाघेउ असि मनुसाई ।' मा० ६.३६.२
नाच : (१) सं०० (सं० नृत्य>प्रा० नच्च) । 'धेरि सकल बहु नाच नचावहिं!' मा० ६.५.७ (२) नाचइ । 'नाच नटीइव ।' मा० ७.७२.२ 
नाच, नाचह : (सं० नत्यति>प्रा० नच्चइ) आप्रए । नाचता-ती है। 'जह तह नाचइ परिहरि लाजा।' मा० ६.२४.१
नाचत : वक०० (सं० नृत्यत्>प्रा० नच्चंत) । नाचता, नाचते । 'मोरगन नाचत बारिद पेखि ।' मा० ४.१३
नाचति : वक०स्त्री० । नाचती, नाच रही। 'रुचिर मोर जोरी जन नाचति ।' गी० ७.१७.१४
नाहि : आप्रब० (सं० नृत्यन्ति>प्रा० नच्चंति>. नच्चहिं) । नाचते-ती हैं । 'नाकनटी नाहिं करि गाना ।' मा० १.३०६.४
नाचा : (१) नाच । नृत्य। 'जस काछिअ तस चाहिअ नाचा।' मा० २.१२७.८ (२) नाचइ । नाचता है । 'अनुहरि तालगतिहि नटु नाचा ।' मा० २.२४१.४ (३) भूक०० । नाच उठा, नत्य कर चला । 'सिर-भुजहीन रुंड महि नाचा।' मा० ६.१०३.२
नाचि : पू० । नाच कर। 'नाचि कूदि करि लोग रिझाई ।' मा० ६.२४.२
नाची : (१) नाचि । 'मारु काटु धुनि बोलहिं नाची।' मा० ६.५२.२ (२) भूक०स्त्री० । नत्य कर चली । तिय मिस मीचु सीस पर नाची।' मा० २.३४.५ 
514 
तुलसी शब्दकोश 
नाचे : भूकृ००ब० । नृत्य कर उठे । 'सगुन सब नाचे ।' मा० १.३०४.३
नाचें : नाचहिं । नाच रहे हैं । 'रुंडन के झुड झूमि झूमि झुकरे से नाचें ।' कवि० 
नाचो : नाच्यो । 'फिरि बहु नाच न नाच्यो।' विन० १६३.१
नाच्यो : भूकृ.पु.कए० (सं०
नृत्त:>प्रा० नच्चिओ। नाच उठा, नृत्य किया। 'अब तव कालु सीस पर नाच्यो।' मा० ६.६४.७
नाज : अनाज । 'सौंधे जग जल नाज ।' दो० १४६
नाजु : नाज+कए । खाद्य पदार्थ । 'कंद मूल फल अमिय नाजु ।' गी० २.७.२
नाठी : भूक०स्त्री० (सं० नष्टा>प्रा० नट्ठा= नट्ठी)। नष्ट हो गयी । 'मुनि अति बिकल मोहँ मति नाठी।' मा० १.१३५.५
नाठे : भूक पु० (सं० नष्ट>प्रा० नटुनट्ठय) । दुष्ट, विकृत । 'जूझिबे जोगु न ठाहरु नाठे ।' कवि० ६.२८ ।।
नात : सं.पु. (सं० ज्ञातित्व>प्रा. णाइत्त) । सम्बन्ध, सगापा । 'होइ नात यह 
__ ओर निबाहू ।' मा० २.२४.६
नाता : नात । 'मानउँ एक भगति कर नाता।' मा० ३.३५.४
नाती : सं०० (सं० नप्त = नप्तक>प्रा० नत्तिअ) । पुत्र अथवा पुत्री का पुत्र; पौत्र या दौहित्र । 'उत्तम कुल पुलस्ति कर नाती।' मा० ६.२०.३
नातें : नाते से, सम्बन्ध से । केहि नाते मानिऐ मिताई।' मा० ६.२१.२
नाते : नाता+ब० । 'जहँ लगि नाथ नेह अरु नाते ।' मा० २.६५.३
नातो : नाता+कए । एक सम्बन्ध । 'नातो नेह जानियत ।' कवि० ७.१६६
नात्र : (सं० न+अत्र) इसमें नहीं। 'नात्र संशयं ।' मा० ३.४.२४
नाथ : सं०० (सं.)। (१) स्वामी (२) पति । मा० २.६५.३
नाथा : नाथ । मा० १.२१०.१० 
नाथ, थू : नाथ+कए० । एकमात्र स्वामी । 'चलन चहत बन जीवन नाथ ।' मा० २.५८.३
नाद : सं०० (सं०) । शब्द, ध्वनि, रव, घोष । मा० २.६२.८
नावा : नाद । मा० २.१६०.३
नादू : नाद+कए । 'सुनि न जाइ पुर आरत नादू ।' मा० २.८१.३
नाना : अव्यय (सं.)। अनेक, बहुत, विविध । 'जलचर थलचर नभचर नाना ।' मा० १.३.४ 
नानाकार, रा : वि० । विविध आकारों वाले । नानाकार सिलीमुख धाए।' मा० ६.६१.२ 'नाना आयुध नानाकारा ।' मा० ३.१८.५
नानायुध : विविध आयुध । मा० ६.४० 
_______________________________________________
515 
नान्ह : वि.पु. (सं० श्लक्ष्ण>प्रा० लण्हनन्ह) । सूक्ष्म, महीन । 'करषि कातिबो नान्ह ।' दो० ४६२
नाप : सं०स्त्री० । परिमाण, माप । 'नाप के भाजन भरि जलनिधि जल भो।' हनु० ७
नापे : भूक पु०ब० । परिमित किये । 'बल इनके पिनाक नीके नापे-जोखे हैं।' गी० १.६५.२ 
नामि, भी: संस्त्री० (सं.)। उदरस्थ गर्तविशेष । मा० १.१४७, ७.७६
नाभिकड : रावण की नाभि जिसके लिए प्रसिद्ध है कि भीतर अमृतकुण्ड था अतः वह मरता न था । मा० ६.१०२.५
नाम : सं०० (सं० नामन्) । (१) संज्ञा-जातिवाचक, गुणवाचक, क्रियावाचक और द्रव्यवाचक शब्द । 'सुमिरिअ नाम रूप बिनु देखें ।' मा० १.२१.६ (२) व्यक्तिवाचक शब्द । 'समझत सरिस नाम अरुनामी ।' मा० १.२१.१ (३) अर्थबोधक आन्तरिक शब्द =स्फोट । 'नाम रूप दुइ ईस उपाधी।' मा० १.२१.२ (४) मन्त्र शब्द । 'नाम जीह जपि जाहिं जोगी।' मा० १.२२.१ (५) सूक्ष्म शब्द या शब्दतन्मात्र जिस पर चित्त एकाग्र कर योगी मधुमती भूमिका प्राप्त करता है । 'साधक नाम जपहिं लय लाएँ ! होहिं सिद्ध अनि मादिक पाएँ ।' मा० १.२२.४
नामकरन : सं०० (सं० नामकरण) बालक के नाम रखने का संस्कार जो जन्म से दस दिन पर होता है। मा० १.१६७.२
नामन्ह : नाम+संब० नामों। 'राम सकल नामन्ह तें अधिका।' मा० ३.४२.८
नामा : (१) नाम। 'रामचरितमानस एहि नामा ।' मा० १.३५७ (२) (समासान्त में) वि० । नाम वाला । 'भूप अनुज अरिमर्दननामा।' मा० १.१७६.३ (३) नाम वाली । 'मय तनुजा मंदोदरि नामा ।' मा० १.१७८.२
नामानी : नाम+कब० (सं० नामानि)। बहुत नाम । मा० ७.५२.३
नामिनी : वि.स्त्री० । नाम वाली, नाम धारिणी। बहनामिनी ।' विन० १८.२
नामी : वि०पू० । नामवाला, नामधारी, संजी। 'समझत सरिस नाम अरु नामी।' मा० १.२१.१ 
नामु, नामू : नाम-+कए । एकमात्र नाम । 'जपहिं नामु जन आरत भारी।' मा० १.२२.५
नामैं : नाम को, नाम ही को। 'हर से हर निहार जपें जाके नामैं ।' गी० ५.२५.२
नायः : आ०-भूक+उए । मैंने झुकाया। 'देखि चरन सिरु नायउँ ।' मा ७.११० ख
नायउ : भक०पू०कए० । झुकाया । 'पुनि सिरु मायउ आइ।' मा० ७.१० ख 
516 
_______________________________________________
नायक : सं०० (सं०) । (१) मुख्य । ‘गननायक'-१.२५७.७ (२) पदाधिकारी प्रधान । 'दच्छहि कीन्ह प्रजापति नायक ।' मा० १.६०.६ (३) नेता, बड़ा, सम्मान्य । 'बिहग नायक गरुड़।' मा० १.१२० ख (४) संचालक, निर्देश, यूथप । 'पठइस किमि सबहो कर नायक ।' मा० ४.३०.२ (५) स्वामी, प्रभु । 'चराचर नायक ।' मा० ६.१०२.४ (६) प्रेमी (शृङ्गार रस का आलम्बन) । 'ऐसे तो सोचहिं न्याय-निठर नायक-रत सलभ खग कुरंग कमल मीन ।' गील ५.८.२
नायका : नायक । मा० ३.२० छं० ३
नाये : नाए । झुकाए तिरस्कृत किये । 'राजत नयन मीन मद नाये ।' गी १.३२.४
नायो : नायउ । (१) झुकाया। 'आइ बिभीषन पुनि सिरु नायो।' मा० ६.१०६.७ (२) उँडेल दिया । 'पावक जरत मनहुं घृत नायो।' गी० ६.२.५
नारको : वि.पु. (सं० नारकिन्, नारकीय, नारकिक)। नरक-सम्बन्धी, नरक निवासी । मा० ६.२.८; १.३३५.६
नारद : सं०पू० (सं.)। देवर्षि विशेष । मा० १.३.३
नारवी : सं०स्त्री० (सं.)। नारद का कर्म (नारदत्व); ज्ञानदायकत्वकर्म (नारं ज्ञानं ददातीति नारदः)। 'लखि नारद नारदी उमहि सुख भा उर।' पा०म०१७
नारा : सं०पु० (सं० नाल)। नाला, नदी के आकार का सोता । 'चहुं दिसि फिरेऊ धनुष जिमि नारा।' मा० २.१३३.२
नाराच : सं०० (सं.)। लोह-बाण ! मा० ३.२० छं०
नाराचा : नाराचा । मा० ६.६८.४ ।
नारायन : सं०पु० (सं० नारायण)। (१) त्रिदेव-सृष्टिकर्ता परमात्मा विष्णु । (२) विष्ण के अवतारविशेष जो नर के भाई थे और वदरिकाश्रम में तप किया था-दे. नर । 'नर नारायन सरिस सुभ्राता।' मा० १.२०.५
नारि : नारी । (१) स्त्री। मा० १.१६.२ (२) जन्मपत्री में स्त्री का सातवा स्थान । 'दारुन बैरी मीचु के बीच बिराजति नारि ।' दो० २६८ (३) ग्रीवा । 'जिअत न नाई नारि चातक धन तजि दूसरहि ।' दो० ३०५ (४) स्त्री+ ग्रीवा । 'नेह नारि नई है ।' गी० १.८५.३
नारिऊ : स्त्री भी। नर नारिऊ अन्रे ।' कवि० ७.१७४
नारिचरित : स्त्री का चरित्र जिसमें मौनधारण, रोदन, देव को दोष लगाना, अपने को ही दोषी बताना, मिथ्योक्ति आदि सम्मिलित हैं+आठ अवगुण भी उसी में सुलसी शब्द-कोश 
517 
आते हैं-साहस, मिथ्या, चपलता, माया, भय, अविवेक, अशोन और निर्दयता 
(मा० ६.१६.३) । 'नारि चरित करि ढारइ आँसू ।' मा० २.२७.७
नारिषरमु : (दे० घरम)। एकमात्र स्त्री का धर्म =पातिव्रत । 'नारि धरम कुलरीति सिखाईं।' मा० १.३३६.१ ।
नारिधर्म : स्त्री का धर्म-पातिव्रत । नारिधर्म पति देव न दूजा ।' मा० ३.५.४
नारिन्ह : नारि+संब० । स्त्रियों (ने) । 'नर नारिन्ह परिहरी निमेष ।' मा० १.२४६.१
नारिमय : वि० (सं० नारीमय) । स्त्री-पूर्ण, स्त्रियों से परिव्याप्त । 'देखहिं चराचर नारिमय जे ब्रह्ममय देखत रहे।' मा० १.८५ छं.
नारियर : सं००कए० (सं० नारिकेलम्>प्रा० नालिएरं>अ० नालिएरु) । नारियल का फल । 'टकटोरि कपि ज्यों नारियरु सिरु नाइ सब बैठत भए।' जा०म०ई० ११
नारी : भारी+ब० । स्त्रियाँ । 'मुदित असीस देहिं गुर नारी ।' मा० १.१६५.४
नारी : सं०स्त्री० (सं.) । (१) मानवी । सोह न बसन बिना बर नारी। मा० . १.१०.४ (२) पत्नी। 'खोजइ सो कि अग्य इव नारी।' मा० १.५१.२ (३) (फा० नारी-दोजखी)=नारकी। पापी। 'ढोल गार सूद्र पसु नारी।' मा० ५.५६.६ (यहां स्त्री वाला अर्थ प्रसङ्ग-प्राप्त नहीं है) । (४) दे० नारि ।
नारे : नारा+ब० । नाले, सोते। 'कंदर खोह नदी नद नारे।' मा० २.६२.७
नाल : सं०पु० (सं.)। डंठल, डांड़ी। 'कमल नाल ।' मा० १.२५३.८
नावे : (१) नाव में । 'तेल ना भरि नप तनु राखा ।' मा० २.१५७.१ (२) नाव पर । 'गुरहि सुना चढ़ाइ बहोरि ।' मा० २.२०२.८
नाव : सं० स्त्री० (सं० नो>प्रा. नावा>अ० नाव) । नौका । मा० २.१००.३ /नाव
नावइ : (सं० नमति>प्रा० नावइ) आ०प्रए० । झुकाता है, नत करता है। 'बार-बार नाव पद सीसा ।' मा० ४.७.१४
नाव : मा० उए० । झुकाता हूं। 'आश्रम जाइ जाइ सिरु नावउँ।' मा० ७.११०.१०
नावत : वकृ००। (१) झुकाता, झुकाते। 'सुर नर मुनि सब नाबत सीसा।' मा० १.५०.६ (२) उँडेलते, ढरकाते । 'बिगरत मन संन्यास लेत, जल नावत आम घरो सो।' विन० १७३.४
नावरि : सं०स्त्री० (सं० नोटिका>प्रा० नावडिआ>अ० नावडी=नावडि)। छोटी नाव, क्रीडा-नौका । 'जन नावरि खेलहिं सरि माहीं। मा० ६.८८.६
नावहिं : आ.प्रब० (अ.) । झुकाते हैं । 'बार-बार सिर नावहिं ।' मा० ६.१०६ 
518 
तुलसी मन्द-कोश 
नावा : (१) नाव । 'भवसागर दृढ नावा। मा० ७.५३.३ (२) भूकृ. । झुकाया। 'मैं सप्रेम मुनिपद सिरु नावा।' मा० ७.११३.१४
नावे : नावहिं । 'दुखी दिन रिहि तें सिर नावें ।' कवि० ७.२
नावौं : नावउँ । (१) नत करता हूं। 'हाथ जोरि करि बिनय सबहि सिर नावौं ।' जा०म० २ (२) उँडेल हूँ। 'आनि सुधा सिर नावौं ।' गी० ६.८.१
नास : (१) सं०० (सं० नाश>प्रा० नास) । मृत्यु । 'तासु नास कल्पांत न होई ।' मा० ७.५७.१ (२) निवारण, लोप । 'ब्याधि नास ।' मा० ७.७४ क (३) नासइ-दे०/नास । (४) आ.-प्रार्थना-मए०। तू नष्ट कर। 'आपु न नास आपने पोषे ।' गी० ५.१२.२ (५) (समासान्त में) नाशकर्ता। 'सत्य संकल्प सुरत्रास-नासं ।' विन० ५१.४ नास
नासइ : (१) (सं० नाशयति >प्रा० नासइ) आ.प्रए । नष्ट करता-ती है। 'जोग-सिद्धि फल समय जिमि जतिहि अबिद्या नास ।' मा० २.२६ (२) (सं० नश्यति>प्रा० नासइ) नष्ट होता है।
मासहि : आ०प्रब० (अ.) । नष्ट होते हैं । 'राम कृपां नासहिं सब रोगा।' मा० ७.१२२.५
नासहि : आ०-आज्ञा-मए० (सं० नाशय>प्रा० नासहि) । तू नष्ट कर । 'जनि जल्पना करि सुजसु नासहि।' मा० ६.६० छं०
नासा : (१) नास । 'जौं लगि करौं निसाचर नासा।' मा० ३.२४.२ (२) सं०स्त्री० (सं०)। नासिका। 'केई तव नासा कान निपाता।' मा० ३.२२.२. (३) नासइ । नष्ट करता है। जिमि रबि निसि नासा ।' मा० १.२४.५ (४) भूकृ०० । नष्ट हो गया । 'उयउ भानु बिनु अम तम नासा ।' मा० १.२३६.४ (५) नष्ट कर दिया। 'पापिनि सबहिं भाँति कुल नासा ।' मा० २.१६१.६
नासिक : नासिका।
नासिका : (१) सं०स्त्री० (सं.)। नाक- अङ्गविशेष । मा० ५.५४.४ (२) घ्राणेन्द्रिय । 'बास नासिका बिनु लहै ।' वैरा० ३
नासिबे : भकृ.पु. । नष्ट करने । 'जैसे तम नासिबे को चित्र के तरनि ।' विन १८४.१
नासी : भूकृ०स्त्री० । नष्ट हुई, मिटी। 'जनित बियोग बिपति सब नासी।' मा० ७.६.३
नासू : नास+कए । विनाश, अन्त । 'नाथ न होइ मोर अब नासू ।' मा० 
नासै : नासइ । मिट सकता है। 'दुख बिनु हरि कृपा न नास ।' विन० ८१.४ 
_______________________________________________
519 
नाह : नाथ (प्रा.) । स्वामी, पति । मा० २.१४०.३
नाहर : सं०० (फा.)। सिंह, चीता, व्याघ्र।
नाहरनि : नाहर+संब० । व्याघ्रों। 'देखि हैं हनुमान गोमुख नाहरनि के न्याय ।' विन० २२०.७
नाहरु : नाहर+कए । अद्वितीय सिंह । कृ० १८
नाहरू : सं०० (सं० स्नायु-रुज्>प्रा० न्हारुअ) । नसों में होने वाला रोग-विशेष जिसमें से रक्त धारा समय-समय पर बह चलती है और उस अङ्ग की नस लम्बी बढ़ती जाती है । गोरोचन से रक्तधारा का शमन होता है (और गोरोचन गाय के पेट से निकलता है) । 'मारसि गाय नाहरू लागी।' मा० २.३६.८ कुछ विद्वान् 'नाहरू' का सम्बन्ध 'नाहर' से मानकर पालित सिंह के लिए गाय मारने का भी अर्थ लेते हैं, परन्तु अधिकतर पाठ 'नहारू' मिलता है जो प्रा० महारू' के समीप है तथा 'नेहरुआ' का प्रयोग भी गोस्वामी जी ने इसी अर्थ में किया है। वस्तुतः सं० स्नायुरूप>प्रा. न्हाउरूअ>हारू>नहारू-नाहरू से संगति अधिक योग्य है । अब नाहरू का तात्पर्य ताँत से है जो बकरे आदि के मारने से सुलभ है, तदर्थ गोवध करना जघन्य है-अल्प कार्य हेतु गोहत्या महापातक है।
नाहा : नाह । मा० ६.८.८
नाहि : नहिं । मा० १.६५ नाहिन
नाहिन : नहीं ही, कभी नहीं, कथमपि नहीं, निश्चय ही नहीं। 'नाहिन राम राज के भूखे।' मा० २.५०.३ (इसका अन्तिम घटक 'न' निश्चयार्थक है जो 'जाओ न, कहो न' आदि में प्रयुक्त मिलता है)। नाहिने
नाहिन : नाहिंन । 'ज्ञान गाहक नाहिन ब्रज मधुप अनत सिधारि ।' कृ० ५३
नाही : नाहिं । मा० १.८.४ 
नाहु, हू : नाह+कए० (अ०) । स्वामी, पति । मा० २.१४५; १.६७.७ निंद
निदइ : (सं० निन्दति>प्रा० निदइ) आप्रए । तिरस्कृत करता है। 'सरद सुधा सदन छबिहि निंदै बदन ।' गी० १.८२.२
निदक : (१) विपु० (सं०) । निन्दा करने वाला-वाले, अपवादकर्ता। 'सिय निंदक अघ ओघ नसाए।' मा० १.१६.३ (२) तिरस्कार करने वाला-वाले । 'सरद चंद निंदक मुख नीके।' मा० १.२४३.२
निवक : निंदक+कए । अद्वितीय निन्दाकर्ता। 'सिव साधु निंदकु मंदमति ।' पा०म०छं०८ 
520 
_______________________________________________
निदत : वकृ०० । निन्दा करता-करते, अभिभूत करता-करते। 'कलस मनहुं रबि ससि दुति निंदत।' मा० ७.२७.७
निवति : वकृ०स्त्री० । निन्दा करती, दोष देती । 'निसिहि ससिहि निंदति बहु भांती ।' मा० ६.१००.३
निदरी : निरि । निरादर करके, अवहेलना करके। 'चलेसि मोहि निंदरी ।' मा० ५.४.२
निदहिं : आ०प्रब० । (सं० निन्दन्ति>अ० निदहिं) । निन्दा करते हैं। निंदहि जोग बिरति मुनि ग्यानी।' मा० २.२७४.१
निदा : सं०स्त्री० (सं.)। गहीं, अपवाद, तिरस्कार । मा० १.३६.४
निदित : वि०भूक० (सं.)। निन्दापात्र । 'जो निदत निदित भयो बिदित बुद्ध ___अवतार ।' दो० ४६४
निदै : निदहिं । 'निदै सब साधु ।' कवि० ७.१२१
निंद : निदइ।
निध : वि० (सं.)। निन्दनीय, निन्दा योग्य । विन० ५२.८ 
नि:कंप : वि० (सं० निष्कम्प) । अचल, स्थिर । विन० ५६.५
नि:काज : क्रि०वि० (सं० निष्कार्य) । निष्प्रयोजन, व्यर्थ । 'निःकाज राज बिहाय नृप इव सपन कारागृह पर्यो।' विन० १३६.२
नि:काम : वि० (सं० निष्काम)। कामनारहित, फलेच्छारहित । 'भजन करहिं 
नि:काम ।' मा० ३.१६
निःप्राप्य : अप्राप्य । विन० ५७.२
नि:शुभ : (सं० निशुम्भ)। शुम्भ असुर का अनुज जिसे दुर्गा ने मारा था । विन० १५.४
नि:संक : निसंक । हनु० १
निःसरित : भूकृ० (सं० निःसृत)। उद्भूत, आविर्भूत । 'चरित सुरसरित कबि मुख्य गिरि
नि:सरित ।' विन० ४४.७
निःसीम : वि० (सं.)। सीमातीत, भेदरहित । विन० ५६.५ निमरा 
निअराइ, ई : (सं० निकटायते>प्रा० निअडाइ) आ.प्रए । निकट आता है-आती है । तेहि कि मोह ममता निमराई ।' मा० २.२७७.२
निअराइ : पूकृ० । निकट आकर । ‘रहे भूमि निअराइ ।' मा० ३.४०
निअराइन्हि : आo-~भूक+प्रब० । वे निकट जा पहुंचे। 'सिय नहर जनकोर 
__ नगर निअराइन्हि ।' जा०म० १२०
निअराई : (१) निअराह । निकट पहुंचता है। 'एहि बिधि भरत नगर निअराई।' मा० २.१५८.३ (२) निगरानी । 'तुरतहिं पंचवटी निराई।' मा० ३.१२.८ 
_______________________________________________
521 
निअराएँ : क्रि०वि० । निकट पहुंचे हुए (स्थिति में)। 'बरपहिं जलद भूमि निगराएँ । मा० ४.१४.३ 
निअरान, ना : भूकृ.पु. । निकट आ पहुंचा। 'ताहि कालु निअराना।' मा० 
निअरानि, नी : भूक०स्त्री० । निकट पहुंची। ‘जाइ नगर निअरानि बरात बजावत।' पा०म० १०१
निअरानु : निगरान+कए । 'आइ कालु निरानु ।' रा०प्र० ५.६.६
निभराने : भूकृ.पुब । निकट पहुंचे । 'आश्रम निकट जाइ निअराने ।' मा० २.२३५.१
निअराया : निअराना । निकट आ गया। 'रिष्यमूक परबत निअराया ।' मा० ४.१.१
निअरावा : निअराया। निकट पहुंच गया। 'मैं अभिमानी रबि निअरावा ।' मा० ४.२८.३
'निप्राउ : न्याउ । 'होइहि धरम निआउ ।' रा०प्र० ६.६.२
निकंद : सं००। निर्मूलन, विनाश । 'खल बद निकंद महाकुसलं ।' मा० ६.१११.१०
निकंदन : वि.पु । निमूलनकर्ता, विनाशक । 'नामु सकल कलि कलुष निकंदन।' मा० १.२४.८
निकंदय : आ०--प्रार्थना-मए० (सं०) । तू निमूल कर । 'रघुनंद निकंदय द्वंद्वधनं ।' मा० ७.१४.२० 
निकदिनि, नी : वि०स्त्री० । निमूल-कारिणी । 'असुर सेन सम नरक निकंदिनि ।' मा० १.३१.६
निकट : (१) क्रि०वि० (सं०) । समीप में । 'एहि सर निकट न आव आभागा।' मा० १.३८.३ (२) वि० । समीपस्थ ।
निकर : सं० (सं०) । समूह । मा० १.२४.८
निकरन्हि : निकर+संब०। समूहों (ने)। 'राम-सर-निकरन्हि हए।' मा० ६.८८ छं०
निकर्यो : भूक००कए । निकला । 'नरक निदरि निकर्यो हौं।' विन० २६७.२
निकसत : वकृ.पु. (सं० निष्कसत् >प्रा० निक्कसंत)। (१) निकलता-ते । 'धोखेउ निकसत राम ।' वैरा० ३७ (२) निकलते ही। 'सबै सुमन बिकसत रबि निकसत ।' गी० १.१.१०
निकसहि : आ०प्रब० (सं० निष्कसन्ति >प्रा० निक्कसंति>अ० निक्कसहिं)। निकलते हैं। गांव निकट जब निकसहिं जाई।' मा० २.११४.१ 
522 
तुलसी शब्द कोश 
निकसि : पूक० । निकल कर । निकसि बसिष्ठ द्वार भये ठाढ़े।' मा० २.८०.१
निकसे : भूक००० । निकले, प्रकट हुए । 'निकसे जन जुग बिमल बिधु ।' मा० १.२३२
निकाई : निकाई से, भलाई में । 'राम निकाईं रावरी है सबही को नीक ।' मा० १.२६ ख
निकाई : (दे० नीक) सं०स्त्री० । स्वच्छता, पवित्रता, मनोहरता। 'बनइ न बरनत नगर निकाई ।' मा० १.२१३.१ (२) भलाई, अच्छाई। 'भलो कियो खल को, निकाई सो नसाई है।' कवि० ७.१८१ ।।
निकाज : वि० (सं० निष्कार्य>प्रा. निक्कज्ज)। निकम्मा, व्यर्थ (तुच्छ)। 'निरबल निपट निकाज ।' दो० ५४४ 
निकाम, मा : क्रि०वि० (सं० निकामम्)। (१) अत्यधिक, पर्याप्त । 'निकाम स्याम सुदरं ।' मा० ३.४ छं० २ (२) यथेष्ट । 'देहिं केक इहि खोरि निकामा ।' मा० २.२०२.३
निकाय : सं०० (सं०) । समूह, बहुत, झुड के झुड । 'ऐसे नर निकाय जग अहहीं।' मा० ६.६.८
निकाया : निकाय । मा० १.१८३.४
निकारहिं : आ०प्रब० । निकाल देते हैं। 'कुलवंति निकारहिं नारि सती।' मा० ७.१०१.३
निकारि : पूक० । निकाल कर । मा० ६.८५ छं० निकास
निकासई : (सं० निष्कासयति>प्रा० निक्कासइ) आ०प्रए । निकालता है। तेहि बहु बिधि भासइ देस निकासइ ।' मा० १.१८३ छं०
निकासौं : आउए । निकालूं । 'कहु केहि नृपहि निकासी देसू ।' मा० २.२६.२
निकिष्ट : वि० (सं० निकृष्ट)। अधम, नीच (उत्कृष्ट का विलोम)। मा० ३.५.१४
निकेत : संपु० (सं०) । (१) घर, आवास । मा० २.३२० (२) शरीर=जीव का भोगायतन । (३) चिन्ह, उपस्थ इन्द्रिय । 'परसै बिना निकेत ।' वैरा० ३
निकेता : निकेत । मा० ४.१४.६
निकेतु : निकेत+कए । घर । 'जरत निकेतु, धावी धावी।' कवि० ५.६
निकैया : निकाई । सुन्दरता । 'नखसिख निरखि निकैया।' गी० १.६.२
निखंग : निषंग । गी० १.५३.२
निगड़ : सं०० (सं०)। लोहे का कड़ा या शृखला जो कैदी को पहनाते हैं बेड़ी । 'बाँध्यो हौं करम जड़ गरब गूढ़ निगड़।' विन० ७६.२
निगदित : भूकृ.पु. (सं०) । पठित, पाठ में आया, कहा या पढ़ा गया। 'रामायणे दिगदित ।' मा० १ श्लोक ७ 
_______________________________________________
523 
निगम : सं०० (सं०) । वेद तथा वैदिक परम्परा के
अन्थ:-संहिता, ब्राह्मण, उपनिषद्, आरण्यक तथा वेदाङ्ग (ज्योषित, कल्प, छन्दः, निरुक्त, व्याकरण और शिक्षा)। मा० १.१२
निगमनि : निगम+संब० । निगमों (ने) । 'साखि निगमनि भने।' विन० ५६०.२
निगमागम : निगम+आगम। मा० १.६.६
निगमादि : निगम तथा पुराण एवं दर्शनशास्त्र । मा० ७.८६.१
निगमु : निगम+कए । एकमात्र वेदप्रमाण । 'महिमा निगमु नेति कहि कहई।' मा० १.३४१.८
निगानांग : वि० (सं० नग्नाङ्ग ?) । दिगम्बर, पूर्णतया निर्वसन । 'निगानांग करि नितहिं नाच इहि नाच ।' बर० २४
निगूढ़ा : वि०स्त्री० (सं०) । गुप्त, रहस्य पूर्ण (दुरूह) । समुझी नहिं हरि गिरा निगढा ।' मा० १.१३३.३
निगोड़ी : वि०स्त्री० । गवार, असभ्य, नीच । 'छलिन की छोड़ी सो निगोड़ी छोटी जाति-पांति ।' कवि० ७.१८ ।।
निग्रह : सं०० (सं.)। निरोध, दण्ड । 'सागर निग्रह कथा सुनाई ।' मा० ७.६७.८ वैष्णव दर्शन में निग्रह अथवा निरोध प्रतीक है। जीव संसारोन्मख चित्तवृत्तियों का निरोध करे, एतदर्थ भगवान् अवतार-लीलाओं द्वारा निग्रह का उपदेश करते हैं। निग्रह ही लीलाओं का प्रयोजन है। सागर-निग्रह से संसार-निरोध का प्रतीकार्थ आता है जिससे अविद्यारूप रावण के विनाश का मार्ग प्रशस्त होता है।
निघटत : (१) घटत, चुकता, क्षीण होता। 'जिमि जलु निघटत सरदप्रकासे । मा० २.३२५.३ (२) घटते ही । 'निघटत नीर मीन गन जैसें ।' मा० २.१४७.८
निघटि : प्रकृ० । क्षीण या अल्प हो (कर) । 'निघटि गये सुभट, सतु सब को छुट्यो।' कवि० ६.४६
निचाइहि : निचाईनीचता में ही, अधमाचरण से ही। 'लहइ निचाइहि नीचु ।' मा० १.५
निचाई : सं०स्त्री० (सं० नीचता>प्रा. निच्चया)। अधमता, दुष्टता। 'नीच निचाई नहिं तजै ।' दो० ३३७
निचोइ : पूकृ० (सं० निश्चोत्य>प्रा० निच्चोइअ>अ० निञ्चोइ)। निचोड़ कर, सार निकाल कर । 'कहे बचन बिनीत प्रीति प्रतीति नीति निचोइ।' गी० ५.५.५
निचोयो : भूकृ०कए । निचोड़ा, रस निकालने का प्रयास किया। फिर फिरि बिकल अकास निचोयो।' विन० २४५.३ 
:524 
_______________________________________________
निचोर : सं०० (सं० निश्चोत>प्रा० निच्चोड)। निचोड़, सार, निष्कर्ष । 'धन दामिनि बरन तन रूप के निचोर हैं।' गी० १.७३.२
निचोरि : पूक० । निचोड़ कर, सार निकाल कर । 'बरनहु रघुबर बिसद जसु श्रुति सिद्धांत निचोरि ।' मा० १.१०६
निचोल : सं०पु० (सं०) । परिधान । 'नील निचोल छाल भइ ।' पा०म० ११२
निछावरि : नेवछावरि । मा० १.२६२
निज : वि० (सं०) । स्वकीय, अपना । मा० १.२.११ (२) स्व, स्वयम् ।
निजतंत्र : स्वतन्त्र । (जिसे अपने बाहर किसी की अपेक्षा न हो)। 'निजतंत्र श्री रघुकुलमनी ।' मा० १.५१ छं०
निजात्मक : (दे० क) अपनी आत्मा के । ते जड़ जीव निजात्मक घाती।' मा० ७.५३.६
'निजानंद : आत्मानन्द, आत्मसाक्षात्कार-सुख । मा० १.१४४.५
निजु : निज+कए० । स्वयम् । 'प्रीति प्रतीति निगम निजु गाई ।' मा० २.७२.५
निजे : अपना ही । 'करत सुभाउ निज ।' विन० ८६.१
निठुर : वि० (सं० निष्ठुर>प्रा० निठुर) । कठोर, निर्दय, क्रूर । मा० २.६८.६
निठुरता : सं० स्त्री० (सं० निष्ठुरता) । कठोरता, क्रूरता, निर्दय व्यवहार। मा० २.२४
निठुराई : निठुरता । मा० २.४१.४
निडर : वि० (सं० निर्दर>प्रा० निडर) । निर्भय । मा० १.६५
नित : क्रि०वि० (सं० नित्य) । सदा, निरन्तर । मा० १.५६.१ 
निहि, हीं : नित्य ही। 'अति दीन मलीन दुखी नितहीं।' मा० ७.१४.११ ।।
निति : (१) नीति (प्रा० नित्ति)। 'बिरह बिबेक धरम निति सानी।' मा. ६.१०६.३ (२) (नीति से, नियमतः) के लिए । 'मीन जिअन निति बारि उलीचा ।' मा० २.१६१.८; १.२०६.४; ७.१२१.१६
नितु : नित+कए । सदा । ‘राम सों सामु किएँ नितु है हितु ।' कवि० ६.२८
नितं : नित्य ही । 'नाम द्वै राम के लेत नित हौं।' कवि० ७.१०२
नित्य : (१) क्रि०वि० । सदैव । 'राम रमेस नित्य भजामहे ।' मा० ७.१३ छं० ४ (२) शाश्वत, अविनाशी । जीव नित्य ।' मा० ४.११.५ (३) सं० । शौच, स्नानदि=दैनिक कार्य । 'नित्य निबहि गुरहि सिर नाए ।' मा० १.२२७.१
नित्यकरम : सं०० (सं० नित्यकर्म)। अनिवार्य दैनिक क्रिया-स्नान, सन्ध्यो पासन आदि; नैमित्तिक एवं काम्य कर्मों के अतिरिक्त वे कर्म जिनका उल्लङ्कन अविहित है। मा० २.२७४.२ 
_______________________________________________
525 
नित्यक्रिया : सं०स्त्री० (सं०) नित्यकरम । 'नित्यक्रिया करि गुरु पहिं आए।' मा १.२३६.८ 
निवर, निदरई : (निरादर करना, उपेक्षा या अवहेला करना) आ०प्रए० ।। अनादर करता-ती है । 'सुचि सुरसरि रुचि निदर सुधाइ।' मा० २.२८८.८
निदरत : (१) वकृ० । अनादर करता-ते । (२) क्रियाति०पू०ए० । 'अध औगुन निदरत को।' गी० ६.१२.१-२
निदरति : वकृ०स्त्री० । अनादर करती, आदर नहीं करती। 'सुचि सुषमा..." सोमदुति निदरति ।' गी० ७.१७.११
निदरहि : आ०प्रब० । अनादर करते हैं, कम करके मानते हैं। नर नारि निदरहिं नेहु निज ।' मा० २.२५१ छ.
निदरहुं : आ०-संभावना-प्रए । चाहे अनादर करें। 'के निदरहुं के आदरहुं सिंघहि स्वान सिआर ।' दो० ३८१
निदरि : प्रकृ० । उपेक्षित कर, तृणवत् समझकर । 'सानुज निदरि निपातउँ खेता।' मा० २.२३०.७
निदरे : भूक पुब० । अनाहत किये, पिछाड़ दिये । 'निदरे कोटि कुलिस एहिं. छाती।' मा० २.२००.४
निदरेसि : आ०-भूकृ००+प्रए। उसने अनादर किया। 'जग जय मद. निदरेसि हरु ।' पा०म० २६
निदरौं : आ० उए । अनादर करता हूं। 'गुन गिरिसमरत ते निदरौं ।' विन.. १४१.४ 
निदान, ना : सं०० (सं० निदान) । (१) मूल कारण । (२) अन्त, फल, परिणाम । 'बवै सो लवं निदान ।' वैरा० ५ 'जहां कुमति तह बिपति निदाना।' मा० ५.४०.६ (३) नाश (अन्त)। 'देहि अगिनि जनि करहि निदाना।' मा० ५.१२.११ 
निदानु, नू : निदान+कए० । (१) मूल कारण । 'तात सुनावहु मोहि निदान ।' मा० २.५४.८ (२) अन्त, नाश । काहे करसि निदान ।' मा० २.३६ ।। 
निदेस, सा : सं०० (सं० निदेश, निर्देश) । आज्ञा, संकेत । 'सोइ करेहु जेहि होइ निदेसा। मा० ७.५६.८
निदेस : निदेस+कए० । निर्देश, आदेश । मा० २.३०६.२
निद्रा : संस्त्री० (सं.) । सुषुप्ति । मा० १.१७०.२
निधन : सं०० (सं.)। मरण । 'बंधु निधन सुनि उपजा क्रोधा।' मा० ५.१६.३
निधरक : वि०+क्रि०वि० । बेरोकटोक, निःशक, निरातङ्क, निर्भय, बेधड़क ।' निधरक बैठि कहइ कटु बानी।' मा० २.४१.१ 
526 
_______________________________________________
निधान : सं०० (सं०) । (१) आकर, खानि । 'भूतल भूरि निधान ।' मा० १.१ (२) कोष, धनागार । 'अगुन अनूपम गुन निधान सो।' मा० १.१६.२
निधाना : निधान । मा० १.४४.२
निधानु : निधान+कए । एकमात्र आकर या कोष । मा० २.५८; १.२७.८
निधि : सं०स्त्री० (सं००)। (१) आकर, कोष, खानि-निधान । मा० ७.६७ ख (२) आश्रय-जैसे, जलनिधि आदि (३) समुद्र । भद निधि तर नर बिनहिं प्रयासा।' मा० ७.५५.६ (४) दे० नवनिधि । बिधि निधि दीन्ह लेत जन छीने ।' मा० २.११८७
निनारी : वि०स्त्री० । पृथक विशिष्ट, विलक्षण । 'अवधपुरी प्रतिभुवन निनारी।' मा० ७.८१.६
निनारे : वि०पू०ब० । विलक्षण, अलग, असम्पृक्त, विभक्त । 'उर बिहरत छिन छिन होत निनारे ।' कृ० ५६
निपट : क्रि०वि० । नितान्त, सीमान्त तक, अत्यन्त । 'बिबरन भयउ निपट नरपाल ।' मा० २.२६.७ 
निपहि, हि : नितान्त ही, केवल । 'निपटहिं द्विज करि जानहि मोही।' मा० १.२८३.१ 'निपटहि डॉटति निठुर ज्यों ।' कृ० १४
निपात : सं०० (सं.)। पतन, विनाश । 'मन जात किरात निपात किए।' मा० ७.१४.७
निपात : आ० उए । मार गिराता हूं। 'सानुज निदरि निपातउँ खेता।' मा० २.२३०.७
निपातत : वकृ०० । ढहाता-ते । रूख निपातत खात फल ।' रा०प्र० ५.५.१
निपाता : भूकृ००। (१) मार गिराया। 'रथ तुरंग सारथी निपाता।' मा० ६.६५.२ (२) काट डाला । 'जिन्ह कर नासा कान निपाता।' मा० ६.५.६
निपाति : पूकृ० । ढहाकर, ध्वस्त करके । 'ताहि निपाति महाधुनि गर्जा ।' मा० ५.१८.८
निपाते : भूकृ००० । ढहा दिये, मार गिराये । 'जातुधान जूथप निपाते बात-जात हैं।' कवि० ६.४१
निपुन : वि० (सं० निपुण) । (१) दक्ष, कुशल । 'परुसन लागे निपुन सुआरा।' मा० १.६६.७ (२) विवेकशील, अवसरोचित कार्य-कुशल । 'बुद्धि बल निपुन कपि ।' मा० ५.१७ (३) सतर्क, सावधान । नयन निपुन रखवारे ।' कृ० ५६ (४) सार ग्राही, द्रष्टा । 'तत्त्वबिचार निपुन भगवाना।' मा० १.१४२.७ (५) तात्त्विक, तीव्र एवं यथार्थ । 'नेम पेम निज निपुन नबीना।' मारू 
_______________________________________________
527 
२.२३४.३ (६) लोक-शास्त्र आदि के निरीक्षण से उचितानुचित का ज्ञाता। 
'नीति निपुन सोइ परम सयाना ।' मा० ७.१२७.३
निपुनता : सं०स्त्री० (सं. निपुणता)। कौशल, दक्षता, मर्मज्ञता आदि । 'निपुनता न पर कही।' मा० १.६४ छं० ।
निपुनाई : निपुनता। मा० ६.२४.२
निफन : वि० (सं० निष्पन्न>प्रा० निष्फन्न) । सम्पन्न (क्रि०वि०-सम्पन्न रीति से पूर्णतः) । 'जोते बिनु बए बिनु निफन निराए बिनु, सुकत सुखेत सुख सालि फूलि फरि गे।' गी० २.३२.२
निफल : वि० (सं० निष्फल>प्रा० निष्फल)। व्यर्थ, बेकार । 'निफल होहिं रावन सर कसें ।' मा० ६.९१.६
निबरत : वकृ.पु. (सं० निवण्वत्>प्रा० निव्वरंत)। निर्वत होता, शान्ति पाता। 'काल कला कासीनाथ कहें निबरत हों।' कवि० ७.१६५
निवर्यो : भूकृ० पु०कए० (सं० निर्वतः>प्रा० निव्वरिओ) । निर्वत हुआ, शान्ति-लाभ किया। 'प्रभु सों गुदरि निबर्यो हौं ।' विन० २६६.४
निबल : वि० (सं. निर्बल>प्रा० निब्बल)। बलहीन । 'प्रभु समीप छोटे बड़े रहत निबल बलवान ।' दो० ५२७
निबह : सं०० (सं० निवह) । समूह, श्रेणी । 'मनहुं उडुगन-निबह आए मिलन तम तजि द्वेषु ।' गी० ७.६.४ 
निबह, निबहइ : (सं० निर्वहति>प्रा० निव्वहइ-निभना, यथावत् परिणाम तक पहुंचना, सफलता तक जाना, सम्पन्न होना, पूरा पड़ना) आ०प्रए० । निभता है, पूरा पड़ता है, सम्पन्न हो पाता है। 'सखा धरम निबहइ केहि भांती।' मा० ५.४६.५
निबहति : वक०स्त्री० । निभती, बात बन जाती, पूर्ति होती। 'रावरे निबाहे सबही की निबहति ।' विन० २४६.१
निबहते : क्रियाति००० । तो निभ जाते ।' लक्ष्य पा जाते । 'तो. 'हम केहि 
__ भांति निबहते ।' विन० ९७.३
निबहहिंगे : आ०भ०पु०प्रब० । नि.गे, लक्ष्य या गन्तव्य तक पहुंचेंगे। 'मेरे बालक कैसे धौं मग निबहहिंगे।' गी० १.६६.१
निबहा : भूकृ० । निभ गया, पूरा-खरा उतर गया। 'प्रेम नेम निबहा है।' गी० २.६४.५
निबही : भूक०स्त्री० । निभ गई, पूरी पड़ गयी । 'राम रुख लखि सबकी निबही ।' गी० ७.३७.२
निबहे : भूकृ००० । निभे, पूर्ति पा गये । 'कैसे निबहे हैं, निबहेंगे।' गी० २.३४.३ 
528 
_______________________________________________
निबहेंगे : निबहहिंगे। गी० २.३४.३
निबहै : निबहइ । निभ जाय। निबहै सब भांति सनेह सगाई।' कवि० ७.५८ निब
हैगे : आ०भ०पू०प्रए । निभेगा, लक्ष्य प्राप्त करेगा। 'तुलसी प नाथ के निबाहेई निबहैगो।' विन० २५६.४
निबहौंगो : ०भ०पुउए । निभ जाऊँगा, पार पा जाऊँगा, अन्त तक पहुंच जाऊंगा । 'अवधि लौं बचन पालि निबहींगो।' गी० २.७७.३
निबह्यो : भूक०पु०कए । निभ गया, पूरा पड़ा । 'कछु न काज निबह्यो है।' गी० ४.२.२
निबाह : सं०० (सं० निर्वाह>प्रा० निव्वाह) । निभाव, परिणाम पर्यन्त कार्य की निष्पत्ति । 'बिधि बस होइ निबाह ।' रा०प्र० ३.७.४ (२) योगक्षेम, गुजारा । (३) दे० निबाहु । /निबाह
निबाहइ : (सं० निर्वाहयति>प्रा. निव्वाहइ-/निबह+प्रेरणा)। आ०प्र० । सम्पन्न करता है, परिणाम तक पहुंचता है। पूरा करता है।
निबाहत : वकृ.पु । निर्वाह करता-ते; पूर्णता देता-ते । 'स्वाति निदरि निबाहत नेम ।' दो० २८६
निबाहनिहारा : वि० । निभाने वाला, छोर तक यथावत पहुंचाने वाला । 'सील सनेहु निबाहनिहारा ।' मा० २.२४.२
निबाहब : भूकृ.पु । निभाना, परिणाम तक पहुंचाना । 'नेह निबाहब नीका ।' दो०४६६
निबाहा : भूकृ०० (सं० निर्वाहित>प्रा. निव्वाहिम) । निभाया, अन्त तक उचित रीति से पहुंचाया। जेहिं तनु परिहरि प्रेम निबाहा।' मा० २.१७१.६
निबाहि : प्रकृ० (सं० निर्वाह्य>प्रा० निव्वाहिअ>अ. निव्वाहि) । पूरा करके, सम्पन्न करके । 'नित्य निबाहि मुनिहि सिर नाए।' मा० १.२२७.१
निवाहिए : आ०कवा०प्रए । निभाया जाए, अन्त तक पूर्ण किया जाए। तेहि नातें नेह नेम निज ओर तें निबाहिए।' कवि० ७.७६
निबाहिब : भकृ०० (सं० निर्वाहयितव्य>प्रा० निव्वाहिअव्व) । निर्वाह करना । 'तहँ तहँ राम निबाहिब नाथ सनेहु ।' बर० ६६
निबाहिबे : निबाहिब (का रूपान्तर) (प्रा० निव्वाहिअव्वय) । निर्वाह करने, पूर्ति देने । 'अपनी निबाहिबे, नप की निरबही है।' गी० २.४१.३
निबाही : भूकृ०स्त्री०ब० । निभा दी, पूर्ण कर दी। 'प्रभु प्रसाद सिर्व सबइ निबाहीं ।' मा० २.४.४
निबाही : (१) भूकृ०स्त्री० । पूर्ण की। 'नाम के प्रताप बाप आजु लौं निबाही नीकें ।' कवि० ७.८० (२) निवाहि । चुकता करके, पूरा कर । 'आजु बयरु सब लेउ निबाही ।' मा० ६.६०.७ 
_______________________________________________
529 

निबाहु, हू : (क) निबाह+कए। (१) सफलता, कार्य की पूर्ति । 'हाँकि न होई निबाहु ।' मा० १.१५६ (२) पहुंच, गति । 'जहँ नाहिन गज बाजि निबाह।' मा० १.१५७.५ (३) निस्तार, सत्परिणाम तक पहुंच । 'उघरहि अन्त न होइ निबाहू।' मा० १.७.६ (४) परिणाम तक यथावत् चलना। 'होइ नात यह ओर निबाहू ।' मा० २.२४.६ (ख) आ०-आज्ञा-मए । तू निभा। राम नाम पर तुलसी नेम निबाहु ।' बर० ५७
निबाहें : निभाने से, परिणाम पर्यन्त पूर्णता देने से । कनकहि बान चढ़इ जिमि दाहें । तिमि प्रियतम पद नेम निबाहें।' मा० २.२०५.५
निबाहे : निबाहें। 'प्रेम नेम के निबाहे चातक सराहिए।' विन० १७८.२ (२) भूकृ.पु.ब० । निर्वाह किए। 'रावरे निबाहे सबही की निबहति ।' विन० २४६.१
निबाहेई : निभाने से ही । 'तुलसी पै नाथ के निबाहेई निबहैगो।' विन० २५९.४
निबाहेउ : भूक०पु०कए । पूरा कर दिया । 'कोउ कह नृपति निबाहेउ नेहू ।' मा० २.२०२.५
निबाहेहु : आ०-भ.+आशा+मब० । तुम पूरा करना । 'ओर निबाहेहु भायप - भाई।' मा० २.१५२.५
निबाहैं : (१) आ०प्रब० । निभाते हैं, पूर्ति देते हैं । भरत......"बुधिबल बचन निबाहैं।' गी० २.७३.१ (२) निबाहें। 'तुलसी हित अपनो अपनी दिसि अबि चल नेम निबाहैं।' विन० ६५.५
निबहै : निबाहइ । पूरा कर दे । 'जौं बिधि कुसल निबाहै काजू ।' मा० २.१०.३
निबाह्यो : निबाहेउ । 'सिला साप समन निबाह्यो नेह कोल को।' कवि० ७.१५
निबिड़ : वि० (सं०) । सधन, गहन, निश्छिद्र । 'कबहुं दिवस महुं निबड़ तम ।' मा० ४.१५ ख
निबुकि : पू० । उछल कर, फलांग लगा कर । 'निबुकि चढ़े उ कपि कनक अटारी ।' मा० ५.२५.६
निवृत्त : भूकृ०वि० (सं० निवृत्त)। समाप्त। 'तम निवृत्त नहिं होई ।' विन० १२३.२
निवृत्ति : सं०स्त्री० (सं० निवृत्ति)। विषय-वैराग्य, निग्रह, त्याग । मा० ७.११७.१२
निबेदित : भूक०वि० (सं० निवेदित) । नैवेध रूप में अपित । मा० २.१२६.२ 
निबेरि, री: पूक० । समाप्त कर, हटा कर । 'गृह आनहिं चेरि निबेरि गती।' मा० ७.१.१.३
निबेरी : भूक०स्त्री०ब० । पूर्ण की। 'नेग सहित सब रीति बेनिरी।' मा० १.३२५.७ 
530 
तुलसी शब्दकोश 
ब 
ने 
निबेरी : निबेरि । मा० २.६४.८
निबेरें : निवृत्त करने से । 'तुलसिदास यह बिपति बागुरौ तुम्हहि सो बनै निबेरें ।' विन० १८७.५
निबेरो : भूक०पु०कए० । (१) समाप्त कर दिया । 'एकहि बार आजु बिधि मेरो सील सनेह निबेरो।' गी० २.७३.२ (२) निबटाया । 'स्वान को प्रभु न्याव निबेरो।' विन० १४६.५
निबेही : वि० (सं० निर्वेधित>प्रा० निव्वेहिअ)। अनाविद्ध=बिना छेद किया हुआ; अछूता, असंपृक्त । 'कोउ न मान मद तजेउ निबेही ।' मा० ७.७१.१
निभ : वि० (सं०) । तुल्य, सदृश । हिमगिरि निभ तनु ।' मा० ६ ५३.१
निमज्जत : वक.पुं० । (१) डुबकी लेता । मा० २.३१०.८ (२) डूबता हुआ। ___सोक समुद्र निमज्जत कपीसु ।' कवि० ७.४
निमज्जन : सं०० (सं०) । डुबकी (स्नान) । मा० २.३१२.६
निमज्जनु : निमज्जन+कए । 'कीन्ह निमज्जन तीरथ राजा ।' मा० २.२१६.१
निमज्जहिं : आप्रब० (अ०) । डुबकी लेते हैं । मा० २.२२४.२
निमि : सीता-पिता के पूर्वज का नाम जिनकी मृत्यु वसिष्ठ के शाप से हुई। देवताओं ने उन्हें पलकों पर निवास का वरदान दिया था अतएव उनको पलकों के झपकने का कारण माना गया है-देवों की पलकों पर निमि का निवास नहीं है ।
अत: एकटक नेत्रों के लिए उत्पेक्षा की जाती है कि निमि ने आसन छोड़ दिया-दूर चले गये । 'भए बिलोचन चारु अचंचल । मनहं सकुचि निमि तजे दिगंचल ।' मा० १.२३०,४ निरखहिं नारि निकर बिदेहपुर निमि नप के मरजाद मिटाई ।' गी० १.१०८.६
निमिराज : निमिवंशज राजा-जनकराज । कवि० १.८
निमिराजु : निमिराज+कए । जनकराज-सीरध्वज-सीताजी के पिता। मा० २.२७७
निमिष : सं०० (सं०) । (१) आँखों का झपकना, पलकों के उठने-गिरने की क्रिया --निमेष । (२) पलक झपकाने का समय भाग-पल (जिसमें चार क्षण होते हैं)। 'निमिष सरिस दिन जामिनि जाहीं।' मा० १.३३०.१ 'निमिष विहात कलप सम तेही।' मा० १.२६१.१
निमेष : निमिष (सं०) । (१) पलक झपकने की क्रिया । 'सनमुख चितवहिं राम तन नयन निमेष निवारि ।' मा० ६.११८ ग (२) पल का समय । 'अरध निमेष कलप सम जाहीं।' मा० १.२७०.८ (३) पलक ।
निमेषनि : निमेष-+संब० । पलकों। 'नयन निमेषनि ज्यों जोगवै ।' गी०१.६६.३
निमेये, : निमेष-+ब०। झपकियाँ। 'पलकन्हिहं परिहरी निमेषं ।' मा० १.२३२.५