1096
सुमोति : (दे० मोती) उत्तम जाति की मुक्तामणि । मा० १.३१६ छं०
सुर : (१) सं०० (सं०) । देव । मा० १.२५.६ (२) स्वर । गी० ७.१६.४
सुरंग, गा : वि० (सं० सुरङ्ग)। उत्तम रंग वाला । 'तड़ित बिनिंदक बसन __सुरंगा।' मा० १.३१६.१
सुरंगनि : सुरंग+संब० । उत्तम रंग वालों। कवि० ६.३२
सुरकुल : देवजाति, देव समूह । मा० १.४२.५
सुरगन : सुरकुल । मा० २.२४१.७
सुरगाइ : सुरधेनु (दे० गाइ) । काम धेन । रा०प्र० १.१.२
सुरगुर, गुरु : देवताओं के आचार्म =बृहस्पति । मा० २.२६५; २४१.८
सुरगैया : सुरगाइ । गी० १.२०.३
सुरघाती : वि० (सं० सरघातिन)। देवों का संहारकर्ता । मा० ६.७४.७
सुरजूथ, था : (दे० जूथ) देव समूह । मा० १.१८६ छं०३ ।
सुरतटिनि : (सं० सुरतटिनी) देव नदी गङ्गा । विन० ४६.४
सुरतरु : सं०' (सं०) । (१) कल्पवृक्ष । मा० १.३२४ (२) यमुना तट पर कदम्ब वृक्षविशेष जिसके नीचे कृष्ण ने लीलाविहार किये थे । ठाढ़े सुरतरु तर तटिनी के तट हैं।' क. २०
सुरति : (१) संस्त्री० (सं० स्मृति) । स्मरण । 'सुरति कराएहु मोरि ।' मा. ७.१६ क (२) सुधबुध, होश । देस कोस के सुरति बिसारी।' मा० ३.२१.६ (३) (सं० सुतरां रतिः सरतिः) अनन्य एकाग्र प्रेमयोग । 'स्वामि सुरति सुर बीथि बिकासी ।' मा० २.३२५ ५ यहां भी स्मति का भाव है परन्तु रिति' का अर्थ मुख्य प्रतीत होता है।
सुरतिय : (दे० तिय) देवाङ्गना । मा० १.३१८.६ ।
सुरदावन : वि०पू० (सं० सरद्रावण) । देवों को खदेड़ भगाने वाला रावण । 'झपटै भट जे सुरदावन के ।' कवि० ६.३४
सुरधनु : इन्द्रधनुष । गी० ७.८.३
सुरधाम, मा : देवधाम, स्वर्गलोक । 'राउ गयउ सुरधाम ।' मा० २.१५५; ६.११२८
सुरधुनि : सं० स्त्री० (सं० सुरधुनी) । देवनदी=गङ्गा । कवि० ७.२१
सुरधेनु, न : देवों की धेनु =कामधेनु । मा० ७.३५.२
सुरधेनुहि : कामधेनु को । 'खारी सेव सुरधेनुहि त्यागी।' मा० ७.११०.७
सुरधेनू : सुरधेनु । मा० १.१४६.१
सुरनगर : देवनगरी अमरावती । गी १.६.८
सुरनाथ, था : सुरपति । (१) विष्णु (२) इन्द्र (३) शिव । मा० १.१०६.८
_______________________________________________
1097
सुरनाथु : सूरनाथ+कए । इन्द्र । मा० २.२२६.१
सुरनायक : सुरनाथ । (१) विष्णु । 'जय जय सुरनायक ।' मा० १.१८६ छं. (२) इन्द्र । 'सु रनायक नयन भार अकुलान ।' गी० ५.२२.६
सुरनारि, री : देवाङ्गना, अप्सरा । मा० १.१२६.४; ३१४.७
सुरनारीं : सुरनारी+ब० । देवाङ्गनाएं । मा० १३१४.७
सुरनि, न्ह : सुर+संब० । देवों (ने आदि) । 'देखि सुरन्ह दुदुभी बजाई।' मा० ७.१२.८
सुरप : सुरपति (सं०) । इन्द्र । 'प्रमुदित मन सुनि सुरप सची के हैं।' गी० २.३०.५
सुरपति : देवराज इन्द्र । मा० ३.१.५
सुरपाल : सुरपति । (१) इन्द्र (२) विष्णु (आदि) । मा० २.२१६
सुर-पुर : देवनगर । (१) स्वर्ग (२) अमरावती । मा० १.३०६
सुरपुरु : सुरपुर+कए । स्वर्ग । 'नरक परौं बरु सुरपुरु जाऊ ।' मा० २.४५.१
सुरवधू : देवाङ्गना, अप्सरा । मा० ६.१०६ ख ।
सुरबर : (१) श्रेष्ठ देव । मा० १.३१६ छ० (२) इन्द्र । मा० २.२२०.३
सुरवास, सा : सं०० (सं० सुरवास) । देवालय । मा० १.२८७.४
सुरबासू : सुरबास+कए० । देव निवास । मा० २.१३८.६
सुरबीथि : सं०स्त्री० (सं० सुरवीथी)। देवमार्ग=आकाशमार्ग = छायापथ = आकाशगङ्गा (आकाश में घने नक्षत्रों का आरपार मार्ग सा दिखाने वाला लम्बा समूह । मा० २.३२५.५
सुरबेलि : कलपबेलि (सं० सुरवल्ली - कल्पकली कल्पलता) अभीष्टदायिनी स्वर्ग की लता । 'सुरतरु रुखा सुरबेलि पवन जनु फेरइ ।' जा०म० १०८
सुरव्राता : (दे० बात) देव समूह । मा० १.६२.७
सुरभवन : देवालय, देवमन्दिर । मा० १.१५५.८ ।।
सुरभि : (१) सं०स्त्री० (स०)। सुगन्ध । 'बेनु सुरभि...किमि पावै ।' विन० ११४.४ (२) वि० (सं०) । सुगन्धित । 'सीतल सुरभि पवन बह मंदा।' मा० ७.२३.४ (३) सं०स्त्री० [सं०) । कामधेनु, गाय । 'स्याम सुरभि पय बिसद अति ।' मा० १.१०
सुरभी : सुरभि । (१) कामधेनु, यथेच्छदायिनी देवधेनु । 'सुर सुरतरु सुरभी सबही के।' मा० २.२१५.६ (२) गाय । 'सुरभी सनमुख सिसहि पिआवा।' मा० १.३०३.५ (३) गाय+सुगन्धित । 'सूपोदन सुरभी सरपि ।' मा० १.३२८
सुरभूपा : (१) विष्णु । मा० १.१९२ छं० (२) राम । मा० ४.१३.३
1098

सुरमनि : (दे० मनि) देवमणि =पूराणणित चिन्तामणि (जो सभी अभीष्ट वस्तुओं का दान करती है) । 'लहि जन रंकन्ह सुरमनि ढेरी।' मा० २.११४.५.
सुरमाया : देवों द्वारा की हुई छलना, देवकृत छद्म प्रभाव । मा० २.१६
सुरमौर : (दे० मौर) सर-मुकुट; देवों में मकूट के समान सर्वोपरि; देवोत्तम । कवि० ७.२६
सुरराउ, ऊ : सुरराजु (अ०) । इन्द्र । मा० २.२२०.४
सुरराजु, जू : सुरराज+कए । देवराज = इन्द्र । मा० २.२७२; २६५.१
सुरराया : (दे० राया) देवराज = इन्द्र । मा० ७.५४.७
सुरलोक : देवलोक =स्वर्ग। मा० १.११३
सुरलोकु, कू : सुरलोक+कए० । मा० २.८१.४
सुरवर : देवोत्तम । मा० २ श्लो०१
सुरस : वि० (सं०) । सुस्वादु रस-युक्त । 'खाहु सुरस सदर फल नाना ।' मा. ४.२५.२
सुरसर : देवों का सरोवर, मानस-सरोवर । मा० २.६०.४
सुरसरि, री : (दे० सरि) देवनदीगङ्गा । मा० १.२.८; १२५.१
सुरसरित, ता : सुरसरि । मा० १.१०६, ४०.१
सुरसा : सं०स्त्री० (सं.)। सर्पमाता=देव दूतीविशेष । मा० ५.२.२
सुरसाईं : (दे० साईं) । (१) देवराज इन्द्र । गी० १.१५२ (२) विष्ण, राम ।' मा० १.१३६.५
सुरसाल : सं०पु० (सं० सुरशल्य>प्रा० सुरसल्ल) । देव-कण्टक, असुर, राक्षस__आदि । मा० १.२७
सुरसुंदरी : देवाङ्गना=अप्सरा । मा० १.६१.१
सुर-सुरभी : (दे० सुरभी) देवधेनु = कामधेनु । मा० २.२१५.६
सुरसैया : सुरसाईं। इन्द्र । कृ० १६
सुरस्वामी : सुरसाईं। मा० १.५३.३
सुराँ : सरा से, में । 'जाहिं सनेह सुरा सब छाके ।' मा० २.२२५.३
सुरा : सं०स्त्री० (सं.)। मदिरा । मा० १.१३६
सुराई : सं०स्त्री० (सं० शूरता)। पराक्रम । 'जान उमापति जास सुराई।' मा० ६ २५.२
सुराऊ : (दे० राऊ) उत्तम राजा । 'सकल अंग संपन्न सुराऊ ।' मा० २.२३५.८
सुराग : (दे० राग) उत्तम राग, श्रेष्ठ स्वर संगति युक्त गेय पद । 'बाज सुराग कि  गाँडर तांती।' मा० २.२४१.६
सुराज : (दे० राज) । (१) उत्तम राज्य, निपुण राजा का शासन । जस सुराज खल उद्यम गयऊ ।' मा० ४.१५.३ (२) उत्तम राजा।
_______________________________________________
1099
सुराजा : (१) उत्तम राजा । 'प्रजा बाढ़ जिमि पाइ सुराजा।' मा० ४.१५.११ (२) सुराज । उत्तम राज्य ।
सुराजू : सुराज+कए । उत्तम राज्य, निष्कण्टक राज्य । 'मोहि दीन्ह सुख सुजसु सुराजू ।' मा० २.१८०.५
सुराति, ती: उत्तम रात्रि, शुक्ल रजनी, चन्द्र-तारक-खचित निशा। मा० १.१५.६
सुरानीक : (१) (सुर+अनीक) देवों की सेना । (२) (सुरा+नीक) अच्छी मदिरा । 'बहुरि सक्र सम बिनवउ तेही। संतत सुरानीक हित जही।' मा० १.४.१०
सुरारि, री : देवश =दत्य, दानव, असुर, राक्षस । मा० ३.४ छं०; ६.२१.१
सुरालय : सं०० (सं०) । स्वर्ग । कवि० ७.६२
सुरासुर : (सं०) देव तथा दैत्य-दानव । मा० २.१८६.७
सुरीति : उत्तम रीति । दो० २३
सुरुख : (दे० रुख) अनकल उत्तम आकार चेष्टाओं वाला । 'सुरुख सुमुखा एकरस एकरूप ।' विन० २४६.३
सुरुचि : सं०+वि. (सं.)। (१) श्रेष्ठ रुचि । 'सुरुचि लखि मो पर होह कृपाल ।' मा० १.१४ (२) श्रेष्ठ रुचि (कान्ति) से सम्पन्न | 'सुरुचि सुबास सरस अनुरागा।' गा० १.१.१ (३) उत्तानपाद की बड़ी रानी=ध्रुव की माता । विन० ८६.५
सुरुष : सुरुखा । गी० ७.३४.६
सुरूप : (१) श्रेष्ठ रूप, सौन्दर्यादि । कवि० ७.६८ (२) उत्तम रूप वाला।
सुरूपता : सं०स्त्री० (सं.) । सुन्दरता । गी० ७.६.१
सुरूपु : सुरूपु+कए० । उत्तम रूप । मा० २.१२१.७
सुरेख : उत्तम रेखा । गी० ७.१७.८
सुरेश : (सं.) देवों का स्वामी। (१) इन्द्र । (२) परमेश्वर । मा० ६ श्लो० १
सुरेस : सुरेश (प्रा.) । इन्द्र । मा० १.१२५.५
सुरेसहि : इन्द्र को। 'देखि प्रभाउ सुरेसहि सोचू ।' मा० २.२१७.७
सुरेसा : सुरेस । मा० १.१०४.३
सुलग : वि०+क्रि०वि० (सं० सुलग्न>प्रा० सुलग्ग)। संलग्न (अलग का विलोम), समीपस्थ, पास । 'धनु सायक सुलग हैं।' गी० २.२७.४
सुलगइ : आ०प्रए । धुआँ देकर धीरे-धीरे जलती है। 'अवाँ अनल इव सलगइ छाती।' मा० १.१६०.७
सुलगन : उत्तम लग्न के उदय का समय । मा० १.३३८
सुलच्छन : वि० (सं० सुलक्षण)। (१) उत्तम लक्षणों वाला-वाली । 'सल सुलच्छन सुता तुम्हारी।' मा० १.६७.७ (२) उत्तम लक्षणों को पहचानने वाले, लक्षित करने वाले । 'लसाहिं सुलच्छन लोग।' मा० १.७ क-अथवा (३) सं० । उत्तम लक्षण (चिह्न)।
सुलच्छनि : सुलच्छन+स्त्री० । श्रेष्ठ लक्षणों वाली। मा० १.६८.७; १३१.६ (पाठान्तर)।
सुलभ : वि० (सं०) । सरलता से प्राप्य । मा० ७.३५.३
सुलभु : सुलभ+कए । मा० २.३०४.३
सुलाखि : पूकृ० । (१) (सं० सुलक्ष्य>प्रा० सुलखिअ>अ० सुलक्खिा)। भली भांति लक्षणों से लक्षित कर, खरा-खोटा पहचान कर । (२) (अरबी-सलाख -खाल खींचन) परखाने के लिए ऊपर की पर्त खींच कर (सोने को परखाने के लिए ऐसा करते हैं) । 'और भप परखि सुलालि तोलि ताइ लेत।' कवि० ७.२४
सुलाभ : श्रेष्ठ उपलब्धि । गी० १.६२.५
सुलाहु : (दे० लाहु) एकमात्र उपलब्धि । 'एक भरत जनमि जग सुलाहु लहा है।' ___ गी० २.६४.४
सुलोचन : सं०+वि० (सं०) । (१) सुन्दर नेत्र । चितै सुलोचन कोर ।' दो० २३६ (२) सुन्दर नेत्रों वाला । मा० २.२७४.६
सुलोचनि : वि० सं०स्त्री० (सं० सुलोचनी)। श्रेष्ठ नेत्रों वाली सन्दरी। मा० २.२५
सुव : सुअ । पुत्र । 'पवन-सुव ।' हनु० १
सुवन : (१) सं०० (सं० सुवन = सूर्य, चन्द्र, अग्नि)। पुत्र । 'पांडुसुवन ।' दो० ४१६ (२) वि.पु. । उत्पादक, प्रसव करने वाला । रा०प्र० १.५.३ पुत्र अर्थ में यह 'सूनु' का रूपान्तर लगता है।
सुवा : सुआ । तोता पक्षी । 'सोई सेंबर तेइ सुवा।' दो० २५६
सुवेश : वि० (सं.)। उत्तम वेषविन्यास (परिधानालंकार) से सम्पन्न । मा०
सुषमा : सं० स्त्रो० (सं.)। सम संघटना की शोभा; योग्य अङ्गसंयोजन वाली सुन्दरता।' मा० २.२३७.५
सुषमाफर : सुन्दरता (सुषमा) की खानि; अति मनोहर । बर० १०
सुषेन, ना : सं०० (सं० सुषेण) । वाल्मीकि के अनुसार चिकित्साविशेषज्ञ वानर यूथपविशेष । गोस्वामी जी के अनुसार लड़का निवासी वैद्यविशेष । मा० ६.५५; ५५.७
सुसंग : उत्तम सम्पर्क, सज्जनों का संसर्ग, सत्संगति । मा० ४.१५
सुसंगति : सुसंग। मा० १.७.५
सुसंगू : सुसंग+कए । मा० १.७.४
1101
सुसम्पति : उत्तम धन-वैभव । मा० ३.४०
सुसचिवन : सुसचिव+संब० । योग्य सचिवों (को)। 'सांत सुसचिवन सौंपि सुख बिलसइ नित नरनाहु ।' दो० ५२१
सुसदसि : (दे० सदस)। उत्तम सभा । 'बैठे अचल सुसदसि बनाई।' गी.. १.१०८.२
सुसमउ : सुसमय+कए । अप्रतिम अनुकूल समय । 'पाइ सुसम उ सिवा सन भाषा ।' मा० १.३५.११
सुसमय : योग्य उत्तम समय, सम्पत्ति-सौभाग्य-काल । 'सुसमय दिन द्वै निसान सब के द्वार बाज।' विन० ८०.३
सुसरित : उत्तम (पवित्र) नदी । मा० २.२४७.७
सुसाइँ, ईँ : (दे० साई)। श्रेष्ठ स्वामी । दो० ५३०
सुसाखा : उत्तम पुष्ट हरीभरी डाल । मा० २.५.७
सुसानी : (दे० साखी)। उत्तम साक्षी जो योग्य मध्यस्थता करे तथा दोनों पक्षों को मान्य हो । 'अगुन सगुन बिच नाम सुसाखी ।' मा० २.२१.८
सुसाजी : वि०पू० (सं० सुसज्जिन ) । सुसज्जित करने वाला । कृ० ६१
सुसाधन : उत्तम साधन श्रेष्ठ उपाय । 'अवसि होइ सिधि साहस फलइ सुसाधन ।' पा०म० २०
सुसाधित : भूक दि० (सं.)। भली भांति सिद्ध किया हुआ+योग्य रीति से उपाजित तथा सुरक्षित । 'करम जाल कलिकाल कठिन आधीन सुसाधित दाम को ।' विन० १५५.३
सुसामध : (दे० सामध) । समधियों उत्तम योग (मिलन या समधोर)। 'पहिलिहिं परि सुसामध भा सुखदायक ।' पा०म० ११७
सुसामुझि : (दे० सामु झि)। सद्धि, शुद्ध-निर्मल बुद्धि, समत्व बुद्धि । 'अकथ अनादि सुसामुझि साधी ।' मा० १.२१.२
सुसार, रा : सं०स्त्री० (सं० सुमारासुस्वादु वस्तु) । (हिन्दी में) दायज में दी जाने वाली सामग्री == अन्न, सीधा, पकवान आदि खाद्य सामग्री। प०ई जनक अनेक सुसारा।' मा० १.३३३.२
सुसालि, ली : (दे० सालि)। उत्तम जाति का धान । फरइ कि कोदव बालि सुसाली।' मा० २.२६१.४
सुसावधान : भली भांति सावधान, पूर्णतया एकाग्र । गी० १.६२.१
सुसिख : (दे० सिख) । उत्तम उपदेश । गी० २.१६.४
सुसिद्धि : उत्तम फल की उपलब्धि । दो० ५३६
सुसीतल : अतिशीतल, अनुकल लगने वाली शीतलता से युक्त । गी० ७.१२.१
सुसीतलताई : सं०स्त्री० (सं० सुशीतलता) । सुखकर शीतलता । मा० १.३६.६.
1102
_______________________________________________
सुसीतलि : (दे० सीतलि) । सुखकर शीतलता से युक्त । मा० १.१०६.३
सुसील, ला : (१) वि० (सं० सुशील) । उत्तम शीलयक्त । मा० ७.२४.३; ६२.२ (२) सं० । उत्तम शील, सत्स्वभाव । 'समुझि सुमित्रां राम सिय रूपु सुसीलु सुभाउ।' मा० २.७३
सुसीलता : सं०स्त्री० (सं० सुशीलता)। उत्तम स्वभाव सम्पन्न । मा० १.१२७.३
सुसीलु : सुसील+कए । मा० २७३
सुसुकत : वकृ.पु० । रोदन आदि की ध्वनिविशेष करता, सिसकता। 'कछु न कहि __ सकत, सुसुकत सकुचत ।' कृ० १७
सुसुकि : वकृ० । सिसक कर, रुआंसी कण्ठध्वनि निकालकर । 'सुसुकि सभीत सकुचि रूखे मुख बातें सकल सवारी ।' कृ० ६
सुसुर : उत्तम स्वर । गी० ७.१६.४
सुसेवित : वि० (सं० सुसेवित) । भली भाँति सेवा किया हुआ; उत्तम रीति से उपासित (आराधित) । मा० ३.३७.८
सुसेव्य : वि० (सं० सुसेव्य) । श्रेष्ठ आराध्य, पूजनीय । विन० १७४.३
सुसेल : श्रेष्ठ सेल (नामक आयुध)। कवि० ६.३३
सुसेवक : उत्तम परिचारक । मा० २.२०३.५
सुसेवकनि : सुसेवक+संब० । उत्तम सेवकों (को) । मा० १.२४
सुसेवा : उत्तम सेवा । मा० २.३१२.७
सुसेव्यमन्वहं : अन्वहं प्रतिदिन+भली भाँति सेवा योग्य । प्रतिदिन सेवनीय,  नित्य उपासनीय । मा० ३.४ छं.
सुस्वामि : वि० (सं० सुस्वामिन्) । उत्तम स्वामी । मा० १.२८.४
सुहव : (१) वि० (सं० सुभग>प्रा० सुहब) । सुन्दर। (२) सं०पू० । संगीत में रागविशेष । गी० ७.१६.४ ।।
सुहा सुहाइ : (१) आप्रए० (सं० सुखायते सुखं वेदयते>प्रा० सुहाइ)। सुखकर प्रतीत होता है । (२) (सं० शुभायते>प्रा. सुहाइ)। शोभा देता है। (३) (सं० सुभाति>प्रा० सुहाइ)। रुचता है, अच्छा लगता है। सिरनि सिखा सुहाइ ।' गी० १.५३.२
सुहाइँ : (१) पू० । सुशोभित होकर, सुखकर प्रतीत होकर । 'तापस बेष बनाइ, पथिक पर्थे सुहाइ, चले लोक लोचननि सुफल करन हैं।' कवि० २.१७ (२) सहाई । दीप्त, शोभित, सुरुचिपूर्ण । 'राम कथा कलिमल हरनि मंगल करनि सुहाइ ।' मा० १.१४१
सुहाई : (१) सुहाई+ब० । शोभित हुईं। मा० २.६१.१ (२) सुहाई+अधि करण । सुखदायिनी पर । 'गुरहि सुनावं चढ़ाइ सुहाई।' मा० २.२०२.८
1103
सुहाई : (१) सहाइ । शोभायुक्त-सुरुचिपूर्ण-सुख कर होती है। 'पारस परस कुधात सुहाई ।' मा० १.३.६ (२) भक०स्त्री० । सुखकरी, शोभाकरी, रुचिकरी। 'फटिक सिला अति सुभ्र सहाई ।' मा० ४.१३.६
सुहाउँगो : आ० भ०० उए । रुचिकर-सुखकर लगूगा। 'ज्यों साहिबहि सुहाउँगो।' ___ गी० ५.३०.१
सुहाएँ : सुहाए' से; सुन्दर-सुख कर.. से। 'सेवा करेहु सनेह सुहाएँ ।' मा० २.१७५.८
सुहाए : भूक पुब० । सुख कर, शोभन, उत्तम । 'सुनि बसिष्ट के बचन सुहाए।'  मा० ७.१०.६
सुहागु : सोहागु । मा० २.२१.४ (पाठान्तर)
सुहाड़ : सुदृढ़ हड्डी । 'रन रावन राढ़ सुहाड़ गढ़े।' कवि० ६.६
सुहाथ : (१) उत्तम हाथ, दाहना हाथ । (२) स्वहस्त= अपना हाथ । 'सुहाथ माथे राखि राम रजाइ।' गी० ७.२७.५
सुहाये : सुहाए । 'सहज सुहाए नैन ।' गी० १.३५.१
सुहायो : भूक.पु.कए । सुखकर, सुरुचिपूर्ण, शोभन । गी० ६.४.४
सुहावन : वि०० (सं० सुखापन>प्रा० सुहावण) । सुखदायी। 'बहइ सुहावन त्रिबिध समीरा ।' मा० ७.३.१०
सुहावनि, नी : सुहावन+स्त्री० । सुखदायिनी । मा० ७.४.५; ५.३५ छं० २ ।
सुहावनु : सुहावन+कए । एकमात्र सुखप्रद, शुभ । 'सगुन सुहावनु जानु।' रा०प्र० ६.१.३
सुहावने : सुहावन (रूपान्तर) । कवि० ७.१४१
सुहावनो : सुहावन+कए० । कवि० ५.१
सुहावा : वि०० (सं० सुखापक>प्रा० सुहावअ) सुखद, सुन्दर । मा० ७.५५.१
सुहित : (१) (दे० हित) श्रेष्ठ हितू । (२) वि.पु. (सं०) । तृप्त (जिसे अन्य  अपेक्षा न हो) । विन० ७७.२
सुहृद : सं०+वि० (सं० सुहृद्) । (१) शुभ हृदययुक्त । 'पुनि कह राउ सुहृद जियें जानी ।' मा० २.२७.१ (२) मित्र । मा० ५.४८.४
सुहेत : (दे० हेत) उत्तम साधन । कवि० ७.६३
सुहो : सुहव । राग विशेष । 'गावै सुहो गोंड़ मलार ।' गी० ७.१८.५
सूंड़ : सं०स्त्री० (सं० शुण्ड, शुण्डा)। हाथी की नाक । दो० ३४५
सूकर : सं०० (मं० सूकर= शूकर) । वराह, सुअर । मा० ६.११०.७ अवतार वर्णन में वराहावतार से तात्पर्य रहता है ।
सूकरखेत : सं०० (सं० शकरक्षेत्र) । तीर्थविशेष । मा० १.३० क
सुकरी : सूकर+स्त्री० । विन० २५८.३
1104
_______________________________________________
सूको : भूकृ००कए० (सं० शुष्क:>प्रा० सुक्को)। सूख गया। 'सांसति सागर सूको।' कवि० ७.६०
सूख : (१) भूक०० (सं० शुष्क>प्रा० सुक्क सुक्ख)। सूख गया, सूखा हुआ (नीरस) । रस रस सूख सरित सर पानी।' मा० ४.१६.५ ‘सूख हाड़ ले भाग सठ ।' मा० १.१२५ (२) सूखइ । सूखता है, शुष्क हो रहा है । 'कंठ सूख मुख आव न बानी ।' मा० २.३५.२
सूख, सूखइ : आ०प्रए० (सं० शुष्यति>प्रा० सुक्खइ) । सूखता है, शुष्क होता है । सूख रहा है । मा० २.३५.२
सूखत : वपु । सूखता, सूखते । 'जनु जलचर गन सूखत पानी ।' मा० २.५१.६
सूखहिं : आ०प्रब० । सूखा रहे हैं । 'सूखहिं अधर जरइ सब अंगू ।' मा० २.४०.१
सूखि : (१) पूकृ० । सूखा (कर)। सिअरें बचन सूखि गए कंसें ।' मा० २.७१.९ (२) भूकृस्त्री० । सूख गई । 'सहमि सूखि सुनि सीतलि बानी ।' मा० २.४४.२
सूखे : भूकृ००ब० । शुष्क हुए । 'सूखे सकुचात सब ।' कवि० ५.२०
सूच, सूचइ : आ.प्रए० । (१) (सं० सूचयति) । सूचित करता है। (२) (सं० सूच्यते>प्रा० सच्चइ) । सूचित होता है, प्रकट हो रहा है। 'अन अहिबातु सूत्र जनु भाबी।' मा० २.२५.७।
सूचक : वि० सं० (सं.)। सूचनादायक, प्रतीक, चिह्न, लक्षण । 'भरत आगमन सूचक अहहीं ।' मा० २.७.५
सूचत : वकृ.पु० । सूचित करता-करते । 'सूचत किरन मनोहर हासा ।'. मा० १.१६८.७
सूची : सं०स्त्री० (सं०) । सूई । 'कपट सार सूची सहस ।' दो० ४१०
सूच्छम : वि० (सं० सूक्ष्म)। ह्रस्व, अणु । 'अति रसग्य सूच्छम पिपीलिका ।' विन० १६७.३
सूझ : (१) सूझइ । 'सूझ न एक उ अंग उपाऊ।' मा० १.८.६ (२) भूक००। सूझा, सूझता था । 'सूझ न आपन हाथ पसारा ।' मा० ६.५२.४ ।
सूझ, सूझइ : आ०ए० (सं० सुबुध्यते, शुध्यति>प्रा० सुज्झइ) । दिखता है; ज्ञात होता है, शोधपूर्वक जाना जाता है; प्रकट होता है । 'मुनिहि हरिअरइ सूझ ।' मा० १.२७५ 'अगमु न कछु जग तुम्ह कह मोहि अस सूझइ ।' पा०म० ४५
सूझत : वकृ.पु । दिखता-दिखते । 'सूझत मीचु न माय ।' दो० ४८२
सूझहिं : आप्रब० । सूझते हैं, प्रकाश में आते हैं, दिखते हैं। सूझहिं रामचरित मनि मानिक ।' मा० १.१.८
_______________________________________________
1105
सूझा : सूझ । (१) सूझता है, जान पड़ता है। 'चोंच भंग दुख तिन्हहि न सूझा।' मा० ६.४०.१० (२) दिखाई पड़ा । 'दिसि अरु बिदिसि पंथ नहिं सूझा ।' मा० ३.१०.११
सूझि : सं०स्त्री० । सूझबूझ, समझ । 'आपनि सूझि कहौं ।' कवि० ६.२८
सूझै : सूझइ । 'देखत सुनत समुझतहू न सूझ सोई ।' कवि० ७.१२०
सूझ्यो : भूकृ.पु०कए । दिखाई पड़ा । 'स्वामि न सूझ्यो नयन बीस मंदिर के से मोखे ।' गी० ५.१२.५
सूत : सं.पु. (सं.)। (१) सारथि । 'दूसरें सूत बिकल तेहि जाना।' मा० ६.४२.८ (२) चारण (ब्राह्मणी में क्षत्रिय से उत्पन्न संकरवर्ण अथवा क्षत्रिया में वैश्य से उत्पन्न) । 'मागध सूत बंदिगन गायक ।' मा० १.१९४.६ (३) (सं० सूत्र>प्रा० सुत्त) । तागा, डोरी । 'मन हुँ भानु मंडलहि संवारत धर्यो सूत बिधि-सत बिचित्र मति ।' गी० ७.१७.३ (४) (फा० सूद) लाभ, मूलधन पर मिलने वाला ब्याज, व्यवसाय का नफा । सुहृद समाज दगाबाजिही को सौदा सूत ।' विन० २६४.२ (५) भूक०० (सं० सुप्त>प्रा० सुत्त)। सोया हुआ, सोता है । जिमि टिट्टिभ खाग सूत उताना ।' मा० ६.४०.६
सूतत : सूत+वकृ००। सोता हुआ। 'महामोह निसि सूतत जाग ।' मा० ६.५६.७
सूता : सूत । सोया हुआ । 'देखा बाल तहाँ पुनि सूता ।' मा० १.२०१.५
सूतिहीं : सूत+भउए । सोऊँगा । 'प्रसाद राम नाम के पसारि पाय सूतिहीं।' कवि० ७.६६
सूत्र : सं०० (सं.)। (१) धागा । (२) कटि भूषणविशेष । 'कल किकिनि कटि सूत्र मनोहर ।' मा० १.३२७.४
सूत्रधर : सं०० (सं.)। (१) नाट्य निर्देशक = सूत्रधार । (२) कठपुतली नचाने वाला जो तागा हाथ में पकड़े हुए पुतलियों को विविध गति देता है। 'सारद दारुनारि सम स्वामी । राम सूत्रधर अंतरजामी।' मा० १.१०५.५
सूदन : वि० (सं०) । विनाशक, मारने वाला । जैसे, रिपुसूदन । 'तब सुबाहु-सूदन जसु सखिन्ह सुनायउ।' जा०म० ७८
सूधौ : भूकृ०० कए । मार डाला । 'ससि समर सूधो राहु ।' गी० १.६७.४
सूद्र  : सं.पुं० (सं० शूद्र) । अन्त्यज, वर्ण व्यवस्था में चतुर्थ वर्ग । मा० ७.६७.१
सूद्रु : सूद्र+कए । मा० २.१७२.६
सूध : वि.० (सं० शुद्ध>प्रा० सुद्ध)। (१) निष्कलुष, अमिश्रित । 'सूध दूध मुख करिअ न कोहू ।' मा० १.२७७.१ (२) सरल, निश्छल । 'काह करौं सखि सूध सुभाऊ ।' मा० २.२०.८
सूधि : सूधी । 'जोंक सूधि तन कुटिल गति ।' दो० ४००
1106
_______________________________________________
सूधियै : सीधी ही, बेलाग, स्पष्ट । 'सूधियं कहत हौं ।' कवि० ७.१६७
सूधी : वि०स्त्री० । सीधी, सरल, भोली, निश्छल । 'तू सूधी करि पाई ।' कृ० ८
सूधें : सीधे क्रम में । 'उलटि जपें जारा मरा सूधे राजा राम ।' दो० ३६७
सूधे : वि.पु०ब० । सरल, निष्कपट, सीधे । 'सधे मन सूधे बचन ।' दो० १५२
सूधो, धौ : सूध+कए। (१) सीधा, यथाक्रम । 'कोउ उलटो कोउ सूधो जाप।' गी० ५.४०.३ (२) निश्छल, स्पष्ट । 'सधी सति भाय कहें मिटति मलीनता।' विन० २६२.४
सून : वि० सं० (सं० शून्य>प्रा० सुण्ण) । (१) रिक्त (छा)। सून बीच दसकधर देखा।' मा० ३.२८.७ (२) गणित का अभावसूचक चिह्न । 'नाम राम को अंक है, सब साधन हैं सून ।' दो० १० ।
सूनु : सं० पु(सं०) । पुत्र । 'समीर-सूनु ।' कवि० ५.२८
सूनेंं : सूने से, में । 'सूनें हरि आनिहि पर नारी ।' मा० ६.३०.६
सूने : वि.पुब० । शून्य, रिक्त । 'सूने सकल दसानन पाए ।' मा० १.१८२.७
सूनो : वि०पु०कए । शून्य, रिक्त । 'सूनो सो भवनु भो ।' गी० १.६६.२
सून्य : सं०+वि० (दे० सून) । 'सून्य भीति पर चित्र ।' विन० १११.२
सूप : (१) सं०पु० (सं०) । दाल । मा० १.३८८ (२) (सं० शूर्प>प्रा० सुप्प) । अन्न पछोरने (स्वच्छ करने) का उपकरण विशेष । 'भरिगे रतन पदारथ सूप हजार हो।' रा०न० १६
सूपकारी : सं०० (सं० सूपकारिन् = सूपकार)। सुआर, भोजन बनाने का व्यवसायी। मा० १.३२८.७
सपनखहि : शूर्पणखा को । मा० ३.२२
सूपनखा : संस्त्री० (सं० शूर्पणखा>प्रा० सुप्पणहा) । एक राक्षसी= रावण की बहन । मा० ३.१७.३
सूपनखाहि : शूर्पणखा को । 'पठ्यो सूपनखाहि लखान के पास ।' बर० २८
सूपसास्त्र : (दे० सास्त्र) भोजन बनाने का शास्त्र:-पाक विद्या । मा० १.६६.४
सूपोदन : सं०० (सं० सूपोदन) । दाल-भात । 'सूपोदन सुरभी सरपि ।' मा० १.३२८
सूम : सं+वि० (फ्रा० शूम = मनहूस) । (१) ऐसा व्यक्ति जिसका नाम कहना. सुनना अशुभ माना जाता हो । 'कहि सुनि सकुचिअसूम खल गत हरि संकर नाम ।' दो० ३६१ (२) कन्जूस, कृपण, अनुदार (अरबी-सूम = महंगा बेचना) । 'बाजीगर के सूम ज्यों खल खोह न खातो।' विन० १५१.२
सूर : (१) सं०० (सं०) । सूर्य ! 'तुलसी सूधे सूर ससि समय बिडंबित राहु।' दो० ३६७ (२) वि० (सं० शर>प्रा० सूर)। वीर, योद्धा । मा० ७.७० (३) (सं० सूरि)। विद्वान् । 'जोगी सूर सुतापस ग्यानी।' मा० ७.१२४.६
_______________________________________________
1107
सूरता : सं०स्त्री० (सं० शूरता) । वीरता । मा० १.२६६.८
सूरति : सं०स्त्री० । (१) (अरबी-सूरत)। आकृति, चित्र । कृ० २८ (२) शोभा । ___ गी० ७.१७.२ (३) सुरति । स्मति, सुध । 'भई है मगन, नहिं तन की सरति।' गी० ५.४७.२
सूरनि : सूर+संब० । शूरों (के, को) । सूरनि उछाहु कर कादर डरत हैं।' कवि० ६.४६
सूरा : सूर । वीर । मा० ६.२८.३
सूरी : सं०पु+वि० (सं० मूरि) । विद्वान् । 'राम कथा गावहिं श्रुति सूरी। - मा० ७.१२६.२
सूरो : सूर+कए० (सं० शूरः>प्रा० सूरो) । सुभट । हनु० ३
सूर्पनखा : सूपनखा । गी० ६.२१.२
सूल : सं०० (सं० शूल>प्रा० सूल)। (१) शस्त्रविशेष । 'सूल कृपान परिध गिरिखांडा।' मा० ६.४०.८ (२) शिव का त्रिशूल जो त्रिताप का प्रतीक है। मा० ७.१०६.१३ (३) क्लेश, दुःख । 'त्रिबिधि सूलहर ।' कृ० २१ मा० ७.१२४ (४) कसक, मनोव्यथा । 'एक सूल मोहि बिसर न का काऊ।' मा० ७.११०.२ (५) सूला। सूली+कष्ट, व्यथा। 'मिटी मोहमय सूल ।' मा० १.२८५
सूलघर : सं०+वि० (सं० शूलधर)। त्रिशूलधारी शिव । कवि० ७.१४६
सूलपानि : सूलधर । हनु० १२-१३
सूलप्रद : कष्टदायक । मा० ३.४४
सूलहर : कष्टहरण करने वाला । कृ० २१
सूला : (१) सूल । (२) सं०स्त्री० (सं० शूला)। सूली, फाँसी, बन्धन, जकड़न । 'हृदयं हरष बीती सब सूला।' मा० ४.४.१ गोस्वामी जी ने कर्मबन्धन तथा तज्जनित व्यथा के लिए इसका अधिकाधिक प्रयोग किया है। 'मोह सकल ब्याधिन्ह कर मूला। तिन्ह ते पुनि उपजहिं बहु सूला।' मा० ७.१२१.२६
सृंखला : सं०स्त्री० (सं० शृङ्खला) । लोहपाश, जंजीर । 'तुलसिदास प्रभु मोह सृखला छुटिहि तुम्हारे छोरे ।' विन० ११४.५
सृंंंंंंंंंंंंंंंंंंंंंंंंंंंंंंंंंंग : सं०० (सं० शृङ्ग) । चोटी, शिखर । मा० ७.१६.५
सृंगनि, न्ह : सृग+संब० च संगनि. ह : संग+संब० चोटियों (पर)। 'मेरु के सगनि जन धन बसे ।' मा० ६.४१.१ (२) चोटियों (में)। 'गिरि सृगन्ह जनु प्रबिहिं ब्याला ।' मा० ६.८३.६
सृंगबेरपुर : सं०पू० (शङ्गवेरपुर)। सिंगरौर=गङ्गातट पर स्थित नगर जिसका राजा गुहनामक निषाद था। मा० २.८७.१
1108
_______________________________________________
सृंगी : सं०० (सं० ऋष्यशृङ्ग) । विभाण्डक ऋषि के पुत्र = कौशल्यापुत्री शान्ता के पति-राम के बहनोई । मा० १.१८६.५
सृकाल, ला, सृगाल : सं०पु० (सं० शृकाल = शृगाल) । सियार । मा० ६.१०२.७; ३०.३; मा० ३.२० छं० १
सृज, सृजइ : आ.प्रए० (सं० सृजति) । रचता है, सर्जन करता है, बनाता है, उत्पन्न करता है । तपबल ते जग सृजइ बिधाता।' मा० १.१६३.२
सृजत : वकृ.पु । रचता-ते, सृष्टि करता-ते । मा० ५.२१.५
सृजति : वकृस्त्री० । रचती, सृष्टि करती । मा० २.१२६ छं०
सृजि : पूक० । सुष्टि करके, बनाकर । 'जो सजि पालइ हरइ बहोरी ।' मा० २.२८२.२
सृजीं : भूक०स्त्री०ब० । उत्पन्न की। 'कत बिधि सृजी नारि जग माहीं।' मा० १.१०२.५
सृजे : भूकृ००ब० । बनाये, उत्पन्न किये, रचे । 'पुरषनि सागर सृजे ।' गी० ५.१२.५
सृजेउ : भूक०'०कए । बनाया, उत्पन्न किया। 'कुल कलंकु करि सजेउ बिधाता।' मा० २.२०१.६
सृज्यो : सृजेउ । 'सृज्यो हो बिधि बायें ।' गी० ७.३१.५
सृष्टि : सं० स्त्री० (सं.)। रचना, विश्वरचना, जगत् । 'नाना भांति सष्टि बिस्तारा। मा० ७.८०.७
सेंति : अव्यय । बिना मूल्य, बिना प्रयोजन, मुफ्ती । 'कुसाहेब सेंतिहू खारे।' ___ कवि० ७.१२
सेंदुर : संपु० (सं० सिदूर>प्रा० सेंदूर)। सौभाग्यवती के मांग का प्रसाधन चूर्ण विशेष । 'राम सीय सिर संदुर देहीं ।' मा० १.३२५.८
सेंबर : संपुं० (सं० शिम्बल =शाल्मल>प्रा० सेंबल)। वृक्षविशेष जिसका लाल फल सुन्दर दिखता और फल में-से रूई निकलती है। 'सोई सेंबर तेइ सुवा सेवतः सदा बसंत ।' दो० २५६
से : (१) वि.पु । समान, तुल्य । 'मोहि से सठ पर ममता जाही।' मा० ७.१२३.३ (२) क्रि०वि० । मानों (उत्प्रेक्षा)। 'कबरी हाँक से लाए।' कृ० ५० (३) सर्वनाम । वे । 'लायक हे भृगुनायक, से धनु सायक सौपि सुभाय सिधाए ।' कवि० १.२२
सेइ : (१) पूक० । सेवा करके । 'सीतहि सेइ कहहु हित अपना ।' मा० ५.११.२ (२) आ-आज्ञा---- मए । 'सेइ साधु गुरु समुझि सिखि राम भगति थिरताइ ।' दो० १४०
_______________________________________________
1109

सेइअ, ए : आ०कवा०प्रए० (सं० सेव्यते>प्रा० सेवीअइसेईअइ)। सेवन या सेवा कीजिए; सेवित किया जाय । 'प्रभु रघुपति तजि से इस काही।' मा० ७.१२३.३
सेइअहिं : ०कवा०प्रब० । सेए जाते हैं (उनकी सेवा की जाती है)। 'सेइअहिं सकल प्रान की नाईं।' मा० २.७४.५
सेइबे : भकृ.पु० । सेवा करने । 'सांकरे के से इबे सराहिबे सुमिरिबे को ' कवि० ७२२
सेइयहु : आ०-भ०+आo-मत्र । तुम सेवा करना । 'सिय से इयहु मन ___ मानि ।' गी० ७.३२.३
सेइये : सेइअ । 'सेइए सनेह सों बिचित्र चित्रकूट सो।' कवि० ७.१४१
सेइहहिं : आ०भ० प्रब० । सेएंगे, सेवन करेंगे (भोगेंगे) । 'भरतु बंदिगृह से इहहिं ।' मा० २.१६
सेइहि : आ.भ.प्रए । सेएगा, सेवा करेगा। 'होइ अकाम जो छल तजि सेइहि ।' मा० ६.३.३
सेई : भूकृ०स्त्री० (सं० सेविता)। (१) सेवित की। जिन्ह गुर साधु सभा नहिं ___ सेई ।' मा० २.२६४.८ (२) पाली-पोसी । 'भगिनी ज्यों सेई है।' कवि० २.३ (३) सेइ । 'अवधि पारु पावौं जेहि सेई ।' मा० २.३०७.८
सेएँ : सेवित करने (किये-से) । 'तरहिं न बिनु सेएं मम स्वामी ।' मा० ७.१२४.७
सेए : भूकृ००० । सेवा द्वारा तुष्ट किये । 'जों मैं सिव सेए अस जानी।' मा० १.६०.४
सेएहु : आ०-भ०+आज्ञा --मब० । तुम सेवा करना । 'सेएहु मातु सकल सम जानी।' मा० २.१५२.४
सेज : सं०स्त्री० (सं० शय्या>प्रा० सेज्जा>अ० सेजन)। पलँग या बिस्तर । मा० २.१४.६
सेत : (१) वि० सं० श्वेत)। उज्ज्वल, गौरवर्ण, सितवर्ण । 'मन मेचक तन सेत ।' विन० १६०.३ (२) सेतु । 'सेत सागर तरनु भो।' कवि० ६.५६
सेतु : सं०० (सं०) । (१) धारा रोकने हेतु बांध । (२) नदी, समुद्र आदि के आरपार बनाया जाने वाला मार्ग=पुल । मा० ६.१ (३) सीमा, मर्यादा (धर्म-संहिता आदि) । 'रघुकुल केतु सेतु श्रुति रच्छक ।' मा० ७.३५.८
सेतुबंध : सं०० (सं०) । सेतु का किनारा जहाँ ऊंचा ढेर (बांध) बना होता है। मा० ६.४.३
सेतू : सेतु । मा० १.८४.६
सेन : (१) सेना । 'चतुरंगिनी सेन संग लीन्हे ।' मा० ३.३८.१० (२) सं०० (सं० सैन्य>प्रा० सेन्न)। सेना, सैनिक समूह । 'असुर सेन सम नरक निकंदिनि ।' मा० १.३१.६
1110
_______________________________________________
सेनप : सं०० (सं० सैन्यप) । सेनापति । मा० २.२४२
सेना : सं० स्त्री० (सं०) । फौज (गज, रथ, अश्व और पदाति के चार अङ्ग होते हैं) । मा० ४.२२.३
सेनापति : सं.पुं० (सं.)। सेनानायक, संचालक सेनाधिकारी। मा० ६.३६.५
सेनि, नी : श्रेनी । पङि क्त, समूह । 'हंस-सेनि संकुल ।' गी० ७.४.४
सेनु : सेन+कए । सैन्य-समुदाय, सैनिक वर्ग । 'एहि बिधि भरत सेन सब संगा।' मा० २.१६७.३
सेवरा : सं०० (सं० श्वेतपट>प्रा० सेवडा)। श्वेताम्बर जैन (लक्षणा से) प्रच्छन्न दुराचारी साधु । 'सुरा सेबरा आदरहिं निहिं सुरसरि बारि।' दो० ३२६ (यहाँ 'सेबरा' वामाचारी का तात्पर्य रखता है)।
सेबी : (समासान्त में) वि०पु० (सं० सेविन) । सेवाशील; सेवाकारी । ख ग मग चरन सरोरुह सेबी।' मा० २.५६.३
सेब्य : सेव्य । मा० ५.४७
सेमर : सेंबर। विन० १६७.२
सेयें : सेएँ । सेवा करने से । कवि० ७.१४०
सेये : सेए । 'सेये सीताराम नहिं ।' दो०६६
सेर : सं०पू० (सं०) । सोलह छटांक का परिमाण विशेष (जो आजकल के किलोग्राम से कुछ कम होता है)। 'कहिम सुमेर कि से र सम ।' मा० २.२८८
सेल, ला : सं०० (प्रा.)। आयुधविशेष (शक्ति, साँग)। मा० २.१६१.५  'सनमुख राम सहेउ सोइ सेला।' मा० ६.६४.२
सेल्ही : संस्त्री० । मालाकार गंडा (जिसे जोगड़े पहनते हैं)। ‘ओझरी की झोरी कांधे आँतनि की सेल्ही बाँधे ।' कवि० ६.५०
सेव : (१) सेवा। 'जो कर भूसुर सेव ।' मा० ३.३३ (२) सेवइ । 'अधम सो नारि जो सेव न तेही ।' मा० ३.५.६
सेव सेवई : आ०प्रए० (सं० सेवते>प्रा० सेवइ)। सेवा करता-ती है। 'सेवइ ___ सबन्हि मान मद नाहीं ।' मा० ७.२४.८
सेवउँ : आ० उए ० । सेवा करता हूं (था) । तेहि सेवउँ मैं कपट समेता ।' मा० ७.१०५.५
सेवक : वि.पु. (सं.)। (१) परिचारक । 'सेवक सचिव सुमंत्रु बोलाए ।' मा० २.५.१ (२) दास्य भावना का भक्त (जो जीव का सहज स्वरूप मान्य है)। 'एहि ते तव सेवक होत मुदा ।' मा० ७.१४.१४
सेवकनि, न्ह : सेवक+संब० । सेवकों (को, से) 'राम कहा सेवकन्ह बुलाई।' मा० ७.११.२, मा० २.१८७
_______________________________________________
1111
सेवकपाल : सेवकों (भक्तों) के रक्षक । रा०प्र० ५.४.४
सेवकसेव्यमाव : परमेश्वर को सेव्य (आराध्य स्वामी) तथा अपने को सेवक मान कर किया जाने वाला भक्तिभाव; स्वस्वामिभाव सम्बन्ध । मा० ७.११६ रामानुज, मध्य आदि वैष्णव मतों उपासना की यह पद्धति सम्मत है। रामानन्द ने 'कैकर्य' को सर्वोपरि महत्त्व दिया है और वल्लभ तो दास्य को ही मुक्ति मानते हैं क्योंकि जीव का वही सहज स्वरूप है।
सेवकहि : सेवक में, को। 'प्रभुहि सेवकहि समर कस ।' मा० १.२८१ को साहेबु सेवकहि नेवाजी।' मा० २.२६६.५
सेवकाईं : सेवकाई में, सेवक भाव से । सेवकु लहइ स्वामि सेवकाई।' मा० २.६.८
सेवकाई : सं०स्त्री० । सेवक भाव, सेवा कर्म । मा० ७.१६.४
सेवकिनी : सेवक+स्त्री० (सं० सेविका) । परिचारिका । मा० ७.२४.५
सेवकी : सेवकिनी । पा०म०/० १५
सेवकु : सेवक +कए० । 'सेवकु लहइ स्वामि सेवकाई ।' मा ० २.६.८
सेवत : वकृ० । सेवा करता-ते । “पद पंकज से वत सुद्ध हिएँ ।' मा० ७.१४.५ सेवा करते हुए को । 'सेवत सुलभ सुखद सब काहू ।' मा० १.३२.११
सेवति : वक०स्त्री० । सेवा करती। मा० ७.२४.४
सेवहिं : (१) आप्रब० । सेवा करते हैं, उपासते हैं । 'सेवहिं सान कल सब भाई ।' मा० ७.२५.१ (२) सेवा करेंगे। 'सेवहिं सकल चराचर ताही। बरइ सीलनिधि कन्या जाही।' मा० १.१३१.४
सेवहि : आ०मए । तू सेवा कर । 'महेसहि सेवहि ।' पा मं० २४
सेवहु : आ०मब० । सेवा करो। 'सेवहु जाइ कृपा आगारा।' मा० ७.१६६
सेवाँ : (१) सेवा में । 'पुनि तें मम सेवां मन दयऊ ।' मा० ७.१०६.६ (२) सेवा से । 'तोषे राम सखा की सेवा ।' मा० २.२२१.३
सेवा : (१) भूक०० (सं० सेवित>प्रा० सेविअ) । सेवन किया। 'साधु समाज सदा तुम्ह सेवा ।' मा० २.१५०.४ (२) सं-स्त्री. (सं.)। उपासना । 'करहि रघुनायक सेवा ।' मा० १.३४.७ (३) परिचर्या । 'करइ सदा नप सब के सेवा ।' मा० १.५५.४ (४) नवधा भक्ति में मूर्ति की सपर्या ।' मा० ७.१६.८
सेवार : सं०० (सं० शैवाल>प्रा० सेवाल)। जलाशय में फैलने वाला तण. विशेष । मा० १.३८.४
सेवित : भूकृ०वि० (सं.)। सेवा किया हुआ, पूजित, परिचरित। मा० ६.१११.२१
सेवौं : सेवउँ । (१) सेवा करता हूं ! 'देवसरि सेवौं ।' कवि० ७.१६५ (२) सेवा करूँ। 'सेवौं अवध अवधि भरि जाई ।' मा० २.३१३.८
1112

सेव्य : वि० (सं०) । आराध्य, उपास्य । सेवा का आलम्बन । मा० ७ श्लोक १
सेव्यमान : वकृ०० (सं0) कवा० । सेवा किये जाते हुए । मा० ७ श्लोक १
सेष, षा : सं०पू० (सं० शेष)। (१) सर्पराज, शेषनाग । मा० १.४.८ (२) शेषावतार लक्ष्मण । 'नाना बिधि प्रहार कर सेषा।' मा० ६.५४.५ (३) बचा हुआ अंश ।
सेषु : सेष+कए । शेषनाग । 'कहि सकइ न सेषु ।' मा० २.२२५
सेस : सेष । मा० १.१२
सेसू : सेस+कए । 'सकल धरम धरनी धर सेसू ।' मा० २.३०५.२
सैं : सन । से, प्रति । 'कहेहु दंडवत प्रभु से ।' मा० ७.१६
सैंतति : वकृ०स्त्री० (सं० समेतयन्ती)। समटती, बटोरती। 'लेति भरि भरि अंक __ संतति पंत जन दुई करनि ।' गी० १.२८.४
सै : सय । सो । 'संबत सोरह से एकतीसा ।' मा० १.३४.४ ।
सैन : (१) सेन (सं० सैन्य)। सेना । 'अनुज संभारेहु सन।' मा० ६.६७ (२) संस्त्री० (सं० संज्ञा>प्रा० सन्ना) । संकेत, इङ्गित, आँखों से संकेत, इशारा । 'बरजति सैन नैन के कोए।' कृ० ११
सैनु : सैन+कए । सेना । 'हारि निसाचर सैनु पचा।' कवि० ६.१५
सैबल : सेवार (सं० शैवल) । गी० ७.१७.६
सैल : सं०० (सं० शैल>प्रा० सइल) । शिला समूह = पर्वत । मा० १.१
सैलकुमारी : पार्वती । मा० १.७८.२
सैलजहि : शैलजा=पार्वती को । 'जाइ बिबाहह सैलजहि ।' मा० १.७६
सैलनंदिनि : पार्वती। गी० १.५.६
सैलराज : पर्वतराज=हिमालय । मा० १.६६.६
सैला : सैल । 'भागौं तुरत तजौं यह सैला।' मा० ४.१.५॥
सैलु : सल+कए० । पर्वत । मा० १.२६२.८
सैलोपरि : पर्वत के ऊपर । मा० ७.५६.१०
सैसव : सं०० (सं० शैशव) । आठ वर्ष तक की बाल्यावस्था। विन० १३६.६
सों : अव्यय (सं० सह>अ० सहुं) । से (परसर्ग)। 'सो माया प्रभु सो भय ___ भाखे ।' मा० १.२००.४
सोंधी : वि०स्त्री० (सं० सुगन्धि'>प्रा० सूअंधी)। अच्छी-भली । 'जो चितवनि सोंधी लगे, चितइए सबेरे ।' विन ० २७३.३
सोंधे : वि०पू० (सं० सुगन्धित>प्रा० सुअंधिय) । सुगन्धयुक्त । 'खात खुनसात सोंधे दूध की मलाई है।' कवि० ७.७४
1113
सो : (१) सर्वनाम पुकए० । (सं० स:>प्रा० सो) । वह । 'सो जानब सतसंग प्रभाऊ ।' मा० १.३.६ (२) वि.पु.कए० (सं० सहक्>प्रा० सरि-सउ)। सदृश । 'राम-सो प्रभु को कृपा निकेतु ।' मा० २.२३२ (३) मानों (उत्प्रेक्षा)। 'सुसुकि सभीत सांच सो रोए ।' कृ० ११
सोआइहौं : आ०भ० उए. (सं० स्वापयिष्यामि>प्रा० सोआविहिमि> अ. सोआविहिउँ) । सुलाऊँगा-गी। गी० १.२१.१
सोइ : (१) पूक० (सं० सुप्त्वा>प्रा. सोविअ>अ. सोवि) । सो, सोकर । 'जागत रहे जु सोइ ।' दो० ४८६ 'सबरी सोइ उठी ।' गी० ३.१७.१ (२) सर्वनाम (सं० सए ब>अ० सोजि)। वही । 'सोइ फल सिधि सब साधन फूला।' मा० १.३.८
सोइए, ऐ, ये : आ० भावा० । नींद लीजिए, सोया जाय । 'जागिए न सोइए।' कवि० ७.८३
सोइबो : भक०पु०कए । सोना, नींद लेना (हो, चाहिए)। 'जब सोइबो तात यों हांकहिं, नयन मीचि रहे पौढ़ि कन्हाई ।' कृ० १३
सोइहै : आ०मए० (सं० स्वप्स्यसि>प्रा० सोविहिहि) । तू सोएगा । 'तू यहि बिधि सुख सयन सोइहै।' विन० २२४.४ ।
सोईं : भूक०स्त्री००० । सो गई, निद्रालीन हुई। 'सुदर बधुन्ह सासु ले सोई।' मा० १.३५८.४
सोई : (१) सोइ । वहीं । 'जो जहँ सुनइ धुनइ सिरु सोई।' मा० २.४६.८ (२) (सं० सोपि>प्रा० सोइ) । वह भी। 'तौ कहि प्रगट जनावहु . सोई।' मा० २.५०.६ (३) पू० । सोकर, सो। 'परिहरि सोच रहहु तुम्ह सोई।' मा० १.१७१.४ (४) भूक० स्त्री० (सं० सुप्ता>प्रा. सोविआ)। सो गई, निद्रालीन हुई।
सोउ : सर्वनाम (सं० सोपि>प्रा० सोवि) । वह भी। मा० ७.२२.४ 'राम नाम बिनु सोह न सोऊ ।' मा० १.१०.३
सोएँ : सो जाने पर, निद्रावस्था में। 'बैठे उठे जागत बागत सोएं सपनें ।' कवि० ७.७८
सोए : भूक० ब० । निद्रालीन हुए । लेटे। 'ते सिय रामु साथरी सोए।' मा० २.६१.३
सोक, का : सं०० (सं० शोक) । अनिष्ट प्राप्ति या इष्ट हानि से हुई मनोव्यथा । ___ मा० २.५०.१ 'फिरा श्रमित व्याकुल भय सोका ।' मा० ३.२.४
सोकप्रद : वि० । शोकदायक । मा० १.२३८.२
1114
_______________________________________________

सोकु, कू : सोक+कए । अनन्य शोक । 'अब अपलोकु सोकु सुत तोरा ।' मा० ६.६१.१३, २.८१.४
सोखि : सोषि । सुखाकर । गी० ५.१४.२
सोखिबे : भक०० । सुखाने, शुष्क करने । 'सोखिबे कृसानु पोषिबे को हिमभानु ___ भो।' हनु० ११
सोखे : भूक००ब० (सं० शुष्क>प्रा० सुक्या =सोक्खा - सं० शोषित>प्रा० सोसिय) । सुखा डाले । 'राम के प्रताप रबि सोच सर सोखे हैं।' गी० १.९५.४
सोखेउ : सोषेउ । 'कौतुक सागर सोखेउ।' बर० ५५
सोख्यो : सोखेउ । सुखा डाला । विन० २४७.३
सोग : सोक (प्रा०) । 'लोग सोग श्रब बस गए सोई।' मा० २.८५.६
सोच : (१) सोचइ । सोचता है, शोक करता है । 'सचिव सोच तेहि भाति ।' मा० २.४४ (२) सं०० (सं० शोच्य>प्रा० सोच्च) । चिन्ता । 'नारद चले सोच मन माहीं।' मा० १.१३१.६ (३) शोक | 'सोच बिकल बिबरन महि परेऊ।' मा० २.३८.७ (४) खुटका, कसक । 'नाम प्रसाद सोच नहिं सपनें ।' मा० १.२५.८
सोच, सोचइ : आ०ए० (सं० शोचति, शुच्यति>प्रा० सोच्चइ)। चिन्ता करता है, शोक करता है, सोचता है। 'जो सोचइ ससिकलहि सो सोचइ रोरेहि ।' पा०म० ५५
सोचत : वक०० । सोचता-ते । मा० ७.१६.४
सोचति : वक स्त्री० । सोचती, शोक या चिन्ता करती। 'बैठि नमित मुख सोचति __सीता।' मा० २.५८.२
सोचन : भकृ० अव्यय । सोचने, चिन्ता (शोक) करने । 'तनु धरि सोचू लाग जनु सोचन ।' मा० २.२६.७
सोचनीय : वि० (सं० शोचनीय)। सोचने योग्य, शोकालम्बन ; शोच्य । मा० २.१७३.५-६
सोचहिं, हीं : (१) आप्रब० । शोक या चिन्ता करते हैं। 'समुझि काम सुखु सोचहिं भोगी।' मा० १.८७.८ 'सकल अबला सोचहीं।' मा० १.९७ छं० (२) ध्यान करते हैं । 'इंद्रिय रूपरासि सोचहि सुठि ।' कृ० २६
सोचहि : आ०मए० । तू शोक (या चिन्ता) कर । 'अस बिचारि सोचहि जनि  माता ।' मा० २ ६७.६
सोचहु : आ०मब० । (१) सोचते हो, शोक मनाते या चिन्ता करते हो । 'जासु बिरहें सोचह दिन राती ।' मा० ७.२.३ (२) सोचो । 'सो सोचहु मन माहीं।' कृ० ३३
_______________________________________________
1115
सोचा : सोच । 'सुनि न भगिरा सती उर सोचा।' मा० १.५७.६
सोचाई : भूकृ०स्त्री० । सोचवाई, बिचरवाई । 'सुदिनु सुनखतु सुछरी सोचाई।' मा० १.६१.४
सोचिअ : आ०कवा०प्रए । सोचिए, सोचा जाता है, सोचा जाय। मा० २.१७२-७३
सोचिए : सोचिअ । गी० ७.३२.१
सोचिहैं : आ०भ०प्रब । सोचेंगे, शोक करेंगे, चिन्तित होंगे। जिन्हहि बिलोकि सोचिहैं लता द्रुम ।' गी० ६.१८.३
सोची : भूकृ०स्त्री० । सोच में पड़ गई । 'प्रभु गति देखि सभा सब सोची।' मा० २.२७०.३
सोचु, चू : (१) सोच+कए० । कोई चिन्ता । 'पूत बिदेस न सोचु तुम्हारे। मा० २.१४.५ (२) एक मात्र सोच (चिन्ता) । 'सो सुनि भयउ भूप उर सोचू ।' मा० २.४०.८
सोचै : सोचहिं । 'सोचें सब या के अघ कैसे प्रभु छमि हैं ।' कवि० ७.७१
सोचे : (१) सोचइ । (२) सोचहि । 'तू सोचकर । 'सोचे जनि मन माहं ।' विन० २७५.३ (३) भकृ० अव्यय । सोचने । 'तात राउ नहिं सोचं जोग ।' मा० २.१६१.२
सोध : सं०पु (सं० शोध)। (१) खोज। (२) शुद्धीकरण, संशोधन । 'खल प्रबोध जग सोध मन को निरोध कुल सोध ।' दो० २७४
सोधक : वि० (सं० शोधक)। शोध करने वाला खोजने वाला+ शुद्ध करने वाला । 'साधु सोधक अपान को।' गी० १.८८.३
सोधत : वकृ.पुं० । (१) खोजते । (२) संशोधन करते । सोधत मख महि __जनकपुर ।' रा०प्र० ४.४.५
सोधा : भूक०० । शोधन किया, खोजा, अनुसंधान किया । 'तात धरम मतु : म्ह सब सोधा । मा० २.६५.२
सोधाइ : पूकः । शोध करवाकर, बिचरवाकर । 'सुदिन सोधाइ रिषि चले।" पा०म०ई० १०
सोधाए : भूकृ०पु । शोध करवाए, बिचरवाये । 'नृप सुदिन सोधाए।' गी०
सोधि : (१) कृ० । खोजकर, विचार करके । 'सोधि सुगम मगु तिन्ह कहि दीन्हा । मा० २.११८.८ (२) बिचरवा कर या विचार कर । 'सुदिन सोधि सबु साजि सजाई ।' मा० २.३१ ८ (३) (धातु आदि) । शुद्ध करके । कवि० ५ २५
सोधिय : आकवा०प्रए । सोधिए, विचारिए, खोजिए। 'सोधिय सुदिन सयानी।' कृ० ४६
1116
_______________________________________________
सोधु : सोध+कए । खोज, जानकारी, हालचाल । 'भरत सोधु सबही कर लीन्हा ।' मा० २.१६८.१
सोधेउँ : आ०-भकृ०पु०+उए । मैंने खोजा, शोध किया और विचारा ! 'सोधे। सकल बिस्व मन माहीं।' मा० २.२१२.२
सोधै : आप्रब० । खोजते हैं । 'लिये छरी बेंत सोधे बिभाग।' गी० ७.२२.५
सोध्यो : (१) भूक००कए० । खोजा, खोजा हुआ। (२) शुद्ध किया हुआ । ___सोध्यो राम पानि पाक हौं।' हनु० ४०
सोन : (१) सं+वि० (सं० सुवर्ण>प्रा. सोग्ण)। काञ्चन । 'सोन सुगंध सुधा ससि सारू ।' मा० २.२८८.१ (२) (सं० शोण)। नदविशेष । 'मिलेउ महानदु सोन सुहावन ।' मा० १.४०.२ (३) रक्तवर्ण, लाल । 'सुभग सोन सरसोरुह लोचन ।' मा० १.२१६.६
सोना : सोन । (१) काञ्चन । 'चले रंक जनु लूटन सोना।' मा० २.१३५.२ (२) लाल । 'मनहुं साँझ सरसीरुह सोना ।' मा० १.३५८.१
सोनित : सं०पू० (सं० शोणित)। रुधिर, खून । मा० ६.३३
सोने : सुवर्ण ने । 'इन्ह तें लही दुति मरकत सोने ।' मा० २.११६.८
सोनो : सोना+कए । सुवर्ण । “गोरे को बरन देखें सोनो न सलोनो लागे । कवि० २.१६
सोपान : (१) सं.पुं० (सं.)। सीढ़ी (घाट का जीना) । 'सोपान सुंदर नीर निमल ।' मा० ७.२६ छं० 'जन सुरपुर सोपान सुहाई।' मा० २.१७०.४ (२) ग्रन्थ का अध्याय (रामचरित मानस में-जो मानस सरोवर के रूपक के आधार पर है।)
सोपाना : (१) सोपान । 'सलिल सुधा सम मनि सोपाना ।' मा० १.२१२.६ (२) काण्ड (ग्रन्थ के अध्याय) | ‘एहि महें रुधिर सप्त सोपाना।' मा० ७.१२६.३
सोपि : (सं० सोपि=स:+अपि) । वह भी । 'समुझे मिथ्या सोपि ।' मा०७७१
सोभ : सोभा । जा०म० ६५
सोभत : व.पु. । सुशोभित होता। 'सोभत भयउ मराल इव संभ सहित __कैलास ।' मा० ६.२२ ।
सोभति : वकृ० स्त्री० । सुशोभित होती। 'राम बाम दिसि सोमति रमा रूप गुन खानि ।' मा० ७.११
सोभा : सं०स्त्री० (सं० शोभा) । चारुता, सुन्दरता, दीप्ति । मा० १.११
सोभाकर : वि० (सं० शोभाकर)। (१) शोभा का आकार, सौंदर्य खानि, सन्दरता की राशि । (२) सौन्दर्य की सष्टि करने वाला। (३) सौन्दर्य विकीर्ण करने वाला । (४) सौन्दर्य रूपी किरणों वाला। 'अनुपम अज अनादि सोभाकर ।' मा० ७.३४.४
_______________________________________________
1117
सोभामई : वि०स्त्री० (सं० शोभमयी)। (१) शोभा से रचित । (२) शोभा समूह । (३) शोभाबहुल । मा० १.३२५ छं० २ ।
सोभामय : वि.पु. (सं० शोभामय) । शोभा सम्पन्न, दीप्ति पुञ्ज, आभाओं से रचित । गी० १.५.१
सोभित : भूक०वि० (सं० शोभित) । शोभायुक्त । मा० ३.२० ख
सोभिहै : आ०भ०प्रब० । सुशोभित होंगे। गी० ५.५०.४
सोम : (१) सं०० (सं०) । चन्द्रमा। मा० ३.४२ (२) यज्ञोपयोगी लताविशेष तथा उससे बना पेयविशेष-दे० सोमजाजी।
सोमजाजी : वि.पु. (सं० सोमयाजी-सोमेन इष्टवान) । जिसने सोमयज्ञ किया हो (सोमलता के सन्धान से भजन विशेष सम्पादन किया हो)। 'कोन धों सोमजाजी अजामिल अधम ।' विन० १०६.३
सोमु : सोम+कए । चन्द्रमा । कवि० १.६
सोयो : भूक०'०कए । सोया, विश्राम लिया। 'कबहुं न नाथ नीद भरि सोयो।' विन० २४५.४
सोर : सं०पु. (फा० शोर) । कोलाहल ।
सोरठ : सं०० (सं० सौराष्ट्र>० सोरट्र) । संगीत में रागविशेष । 'शारंग गुंड मलार सोरठ।' गी० ७.१६.४
सोरठा : सं०० (सोरठ) । एक छन्द जिसके प्रथम-तृतीय चरणों में ११-११ और द्वितीय-चतुर्थ में १३-१३ मात्राएं होती हैं (जो दोहे का उल्टा होता है)। संभव है, इस सोरठ राग से सम्बन्ध रहा है। 'छंद सोरठा सुदर दोहा ।' मा० १.३७.५
सोरह : षोडस (प्रा० सोलह) । मा० ५.२.८
सोरा : सोर । कोलाहल । 'रिपुदल बधिर भयउ सुनि सोरा ।' मा० ६.६८.२
सोरु, रू : सोर+कए । कोलाहल । मा० २.१५३ 'गे रघुनाथ भयउ अति सोरू।' मा० २.८६.१
सोव सोवइ : आ०प्रए० (सं० स्वपिति>प्रा. सोवइ)। सोता है, सो सके, सोए । 'सो किमि सोव सोच अधिकाई।' मा० १.१७०.२ 'करइ पान सोवइ षटमासा ।' मा० १.१८०.४
सोवत : (१) वकृ०० । सोता-ते; सोता हुआ-सोते हुए । 'उठे लखनु प्रभु सोवत जानी।' मा० २.६०.१ (२) सोते.सोते, सोते से । 'मनहं बीर रस सोक्त जागा।' मा० २.२३०.१
सोवतहि : सोते-सोते ही। 'पहुंचेहउँ सोवतहि निकेता।' मा० १.१६६.८
सोवन : भकृ० अध्यय । सोने (हेतु) । 'कहि सचिवहि सोवन मृदु बानी ।' मा० २.६०.१
1118
_______________________________________________
सोवनिहारा : वि०पू० । सोने वाला, निद्राशील, सोता रहने वाला। 'मोह निसा __सबु सोवनिहारा । मा० २.६३.२
सोवसि : आ०मए० (सं० स्वपिषि>प्रा० सोवसि) । तू सोता है, सोता रहता है ।  'करसि पान सोवसि दिन राती।' मा० ३.२१.७
सोवहिं : आ०प्रब० । सो रहे हैं (महानिद्रा ले रहे है)। 'संग्राम अंगन सुभट __सोवहिं ।' मा० ६.८८ छं०
सोवहिगो : आ०भ००मए । तू सोयेगा। 'सोवहिगो रनभूमि सुहायो ।' गी० ६.४.४
सोवहुं : आ०-कामना-प्रब० । सोएं, सो जायँ। 'सोवहं समर सेज दोउ भाई।' मा० २.२३०.४
सोवहु : आ.प्रब० । सोवो, शयन करो। 'पुनि पुनि प्रभु कह सोवहु ताता।' मा० १.२२६.८
सोवा : (१) भूकृ०० । सोया, निद्रित हुआ। 'राम बिमुख सुख कबहुं न सोवा।' मा० ७.६६.६ (२) सोवइ । सो रहा है (महानिद्रालीन पड़ा है)। 'प्रगट सो तनु तव आगे सोवा ।' मा० ४.११.५
सोवै : सोवइ । सो रहा हो । 'सोवै सो जगावो। कवि० ५.६
सोष, सोषइ : आ०प्रए० (सं० शोषयति>प्रा० सोसइ) । सोखता है, सुखाता है, नीरस करता है। 'अनहित सोनित सोष ।' दो० ४०० 'जिमि लोहि सोषइ संतोषा।' मा० ४.१६.३
सोषक : वि० (सं० शोषक) । (१) सोखने वाला, सुखाने की शक्ति से सम्पन्न । 'कोटि सिंधु सोषक तव सायक।' मा० ५.५०.७ (२) क्षयकरक । 'ससि पोषक सोषक: ।' मा० १.७ ख
सोषत : वकृ.पुं० । सुखाता (है) । 'बड़वानल सोषत उदधि ।' दो० ३७४
सोषनहारु : वि०पू०कए । सोख ने वाला, चूसने वाला । 'सो हित सोषनहारु ।' दो० ४००
सोषहिं : आ०प्रब० । सुखाते हैं, सुखा सकते हैं । 'सोहिं सिंधु सहित झष ब्याला।' मा० ५.५५.६
सोषा : (१) भूकृ०पु। सोख लिया, सुखा डाला। 'सायक एक नाभि सर सोषा। मा० ६.१०३.१ (२) सुखा डाला गया। 'उदित अगस्ति पंथ जल सोषा।' मा० ४.१६.३
सोषि : पू० । सुखा (कर) । 'सक सर एक सोषि सत सागर ।' मा० ५.५६.२
सोषिअ, य : आ०कवाउप्रए० (सं० शोष्यते>प्रा० सोसीअइ)। सुखा डालिए, सुखाया जाय । 'सोषिअ सिंधु करिअ मन रोपा।' मा० ५.५१.३
_______________________________________________
1119
सोषिहैं : आ०भ०प्रब० । सोख लेंगे, सुखा डालेंगे। 'राघो बान एकहीं समुद्र सातौ _सोषिहैं ।' कवि० ६.२
सोषेउ : भूक००कए । सुखा डाला। 'सोषे उ प्रथम पयोनिधि बारी ।' मा०
सौषौं : आ० उए । सुखा डाल, सोख ल। सोषौं बारिधि बिसिख कृसानू ।' मा० ५.५८.१
सोसि : (सं० सोसिसः असि) । तू वह है। ‘जोसि सोसि तव चरन नमामी ।' मा० १.१६१.५
सोसु : (समासान्त में) वि००कए० (सं० शोषः, शोषम>प्रा० सोसो, सोसं> अ० शोसु) । सोषक, सुखा डालने वाला । 'नाम कुंभज सोच-सागर-सोस ।' विन० १५६.४ '
सोह, सोहइ, ई : आ०प्रए० (सं० शोभते>प्रा० सोहइ)। सुशोभित होता है, शोभा पाता है । सोह न राम पेम बिन ग्यान ।' मा० २.२७७.५ 'ताहि कि सोहइ ऐसि लराई।' मा० ६.६६.२ 'मध्य दिवस जन ससि सोहई ।' मा० ६.३५.४
सोहत : वकृ.पु । सुशोभित होता-होते । मा० २.१४१
सोहति : वकृ०स्त्री० । सुशोभित होती । 'उभय बीच सिय सोहति कसें ।' मा० २.१२३.२
सोहमस्मि : यह वैदिक महावाव्य है जिसकी अद्वैतपरक व्याख्या है :-स:= ब्रह्म अहम् = जीव, अस्मि = हूं में ब्रह्म हूं । अर्थात् जीव ब्रह्म ही है। विशिष्टा द्वैत की व्याख्या कुछ भिन्न है :-जीव अंश होने से अंशी ब्रह्म का अङ्गरूप है अत: वह ब्रह्म से अभिन्न है-~-पृथक् उसकी सत्ता ही नहीं। जीव जब इसी प्रतीति को सिद्ध कर लेता है तो चित्तवत्ति अखण्ड (अविच्छिन्न) रूप में एकाकारता (अखण्डरूपता) अनुभव करती है। यही अखण्डवृत्ति है। 'सोहमस्मि इति बृत्ति अखंडा।' मा० ७.११८.१
सोहर : शोर (?)। कोलाहल । 'लखि लौकिक गति संभु जानि बड़ सोहार । __ भए सुंदर सत कोटि मनोज मनोहर ।' पा०म० १११ (यहाँ 'शोहरा' या 'शोहरत' से तात्पर्य है जिसका ख्याति' अर्थ होता है)।
सोहहिं, हीं : आ० प्रब० (अ०) । सुशोभित होते हैं । मा० ६.६५.७७.२६ छ।
सोहा : (१) भूकृ०० (सं० शोभित >प्रा० सोहिअ)। सुशोभित हुआ। मा० ७.५६.१० (२) सोहइ । 'राम नाम बिनु गिरा न सोहा ।' मा० ५.२३.३
सोहाइ, ई : (१) सुहाई । रुचता है, रुचता हो । 'नीति बिरोध सोहाइ न मोही।' मा० ७.१०७.३ 'सुनहु करहु जो तुम्हहि सोहाई ।' मा० ७.४३.४ (२) सोहइ । 'चंपक हरवा बंग मिलि अधिक सोहाइ।' बर० १२
1120
_______________________________________________
सोहाए : सुहाए । शोभा सम्पन्न । 'बाल दसा के चिकुर सोहाए।' गी० १.२६.५
सोहाग : सं०पू० (सं० सौभाग्य>प्रा० सोहग्ग)। (१) सधवात्व, पतिपत्नी भाव । 'रहिअहु भरी सोहाग ।' मा० २.२४६ (२) पति-प्रणय ; स्वाधीन पति का होने का गर्व । 'तुम्हहि न सोचु सोहाग बल।' मा० २.१७
सोहागिनि : सं०+वि. स्त्री. (सं० सौभाग्यिनी>प्रा० सोहग्गिणी) । सौभाग्यवती (दे० सोहाग)। सधवा+पतिप्रेमिका । 'सदा सोहागिनि होहु तुम्ह ।' मा० २.११७
सोहागिल : वि० (सं० सौभाग्यवत् >प्रा० सोहग्गिल्ल) सौभाग्ययुक्त । 'स्वामि सोहागिल भाग बड़।' रा०प्र० ५.४.५ (यहाँ सौन्दर्यसम्पन्न का तात्पर्य है) ।
सोहागु : सोहाग+कए । 'सुखु सोहाग तुम्ह कहुं दिन दूना ।' मा० २.२१.४
सोहात : वकृ.पु= सुहात । रुचता-ते । 'तुम्ह तजि तात सोहात गृह"...।' मा० २.२६०
सोहाति, ती : (१) वकृ०स्त्री० । रुचती । 'जिन्हहि न रघुपति कथा सोहाती।' मा० ७.५३.६ (२) रुचती हुई । 'बानी सबिनय तासु सोहाती।' मा० २.३१.४ (३) क्रियाति स्त्री०ए० । तो क्या रुचती । 'केहि सोहाति रथ बाजि गजाली।' मा० २.८८.७
सोहाते : क्रियाति००ब ० । यदि रुचते। राम सोहाते तोहि तो तू सबहि सोहातो।' विन० १५१.४
सोहातो : क्रियाति.पु०ए० । तो रुचता । 'तो तू सबहि सोहातो।' विन० १५१.४
सोहान, ना : भूकृ.पु० । रुचा, अच्छा लगा। 'नहिं नारदहि सोहान ।' मा० १.१२७ 'मागेउँ जो कछु मोहि सोहाना ।' मा० २.४०.७
सोहानि, नी : भूक०स्त्री० । रुची, अच्छी लगी। 'सिख.. सीतहि न सोहानि ।' मा० २.७८ 'एक बात नहिं मोहि सोहानी ।' मा० १.११४.७
सोहाने : भूकृ.पु०ब० । रुचे, अच्छे लगे । तासु बचन अति सियहि सोहाने ।' मा० १.२२६.७
सोहाये : सोहाए।
सोहायो : भूक.पु.कए । सुशोभित हुआ । गी० १.६.१६
सोहावन : वि०पुं० (सं. शोभन>प्रा. सोहावण) । शोभा बिखेरने वाला,  मनोरम । रा०न०२
सोहावनि : वि० स्त्री० । शोभा बिखेरने वाली, मनोरम । गी० २.४६.१
सोहावने : सोहावन+ब० । सुन्दर । गी० १.५.१
सोहावनो : सोहावन+कए । 'सदन सदन सोहिलो सोहावनो।' गी० १.३.१
