696
_______________________________________________

बवै : बवइ।
बस : (१) सं०पू० (सं० वश) । अधीनता । 'बिधि बस सुजन कुसंगति परहीं।' मा० १.३.१० (२) वि० (सं० वश्य) । अधीन । 'किए जेहिं जुग निज बस निज बूते।' मा० १.२३.२ (३) बसइ । रहता है। 'जहँ बस श्रीनिवास ।' मा० १.१२८.४
बसंत, बसंता : सं०० (सं० वसन्त)। चैत्र-वैशाख मासों का ऋतु । मा० १.३७.१२
बसंतु : बसंत+कए । 'और सो बसंतु, और रति और रतिपति ।' कवि० २.१७
बस, बसइ : आ०प्रए० (सं० वसति>प्रा० वसइ) । रहता है, निवास करता है। 'तेहिं पुर बसइ सीलनिधि राजा' मा० १.१३०.२
बसई : बसइ । मा० २.१२३.३
बसउ : आ०-संभावना आदि-प्रए० (सं० वसतु>प्रा. वसउ)। चाहे रहे। 'बसउ भवन उजरउ नहिं डरऊँ ।' मा० १.८०.७
बसकरी : वि०स्त्री० (सं० वशकरी) । अधीन करने वाली । मा० ३.२६ छं०
बसत : वक.पु। निवास करता-करते (रहते) । 'भवन बसत भा चौथ पन ।' मा० १.१४२
बसति : (१) बसत+स्त्री० । निवास करती। 'तव मरति बिधु उर बसति।' मा० ६.१२ क (२) सं०स्त्री० (सं० वसति)। आवास, शिविर, राजधानी आदि (बस्ती) । 'बिरची बिरंचि की बसति बिस्वनाथ की।' कवि० ७.१८२
बसतु : बसउ । निवास करे । 'बसतु मनसि मम काननचारी।' मा० ३.११.१८
बसन : सं०० (सं० वसन) । वस्त्र । मा० १.१०.४
बसब : भक०० (सं० वस्तव्य>प्रा० वसिअन्व) । (१) रहना, निवास करना । 'इहाँ बसब रजनी भल नाहीं।' मा० २.२८७.७ (२) रहना होगा (रहोगे)। 'जेहिं आश्रम तुम्ह बसब पुनि ।' मा० ७.११३ ख
बसबर्ती : वि० (सं० वशवतिन् । अधीनस्थ । मा० १.१८२.१२
बससि : आमए० (सं० वससि) । तू रहता है । मा० ७.३४.७
बसहँ : बैल पर । 'बरु बौराह बसहँ असवारा ।' मा० १.६५.८
बसह : सं.पु. (सं० वृषभ>प्रा० वसह) । बैल । मा० १.३१५.३
बसहि, बसही : आप्रब० (सं० वसन्ति>अ. वसहि) । निवास करते हैं। 'बसहि राम सर चाप धर ।' मा० १.१७
बसहुं : आ०-संभावना-प्रब० । रहें, निवास करें। 'गुर गृह बसहं रामु तजि-गेहू ।' मा० २.५०.४
बसहु : आ०मब० (सं० वसथ-त>प्रा. वसह>अ० वसह) । निवास करो। 'बसहु जाइ सुरपति रजधानी ।' मा० १.१५१.८ _______________________________________________
697
बसा, बसाइ, बसाई : (१) आ० प्रए० (सं० वशायते>प्रा० वसाइ)। अपने वश में होता है । 'बिधि सन कछ न बसाइ।' मा० २.१६१ (२) (सं० वासायते> प्रा० वासाइ) गन्ध बिखेरता है। अगरु प्रसंग सुगंध बसाई।' मा० १.१०.६
बसाइ : पूक । बसाकर (सुस्थापित कर)। विधि को न बसाइ उजारो।' गी० २.६६.२
बसाइए : आ०कवा०प्रए० (सं० वास्यते>प्रा. वसावीआइ)। बसाया जाय। 'बैरख बांह बसाइए।' कवि० ७.६३
बसाइहौं : आ०भ० उए । बसाऊँगा-गी। 'आनंदनि भूपति भवन बसाइहौं ।' गी० १.२१.२
बसाई : (१) बसाइ । दे०/बसा। (२) बसाइ (पूक०)। बसाकर । 'नृप नगर बसाई-निज पुर गवने।' मा० १.१७५.८ (२) भूक०स्त्री० । निवास योग्य बनाई । 'बिरचि बनाई बिधि केसव बसाई है।' कवि० ७.१८१
बसाए : भूकृ००ब० । निवास कराये, स्थापित किये। 'लोक बिलोक बनाइ बसाए ।' मा० १.१६.३
बसानि : भूक०स्त्री० । वश में आई, निभी (चली) । 'बिधि सों न बसानि।' गी० ५.७.४
बसायो : भूक०० कए० । बसाया, स्थापित किया। 'कृपासिंधु सुग्रीव बसायो ।' गी० ६.२१.२
बसावत : वक०० (सं० वासयत्>प्रा. वसावंत)। बसाता-ते। 'आप पाप को नगर बसावत, सहि न सकत पर खेरो।' विन० १४३.४
बसावन : वि०पू० । बसाने वाला । “उथपे थपन उजारि बसावन ।' विन० १३६.१२
बसावौं : आ०उए० (सं० वासयामि>प्रा० वसावेमि>अ० वसावउँ) । बसाता हूं। 'हौं निज उर' 'खल मंडली बसावौं ।' विन० १४२.५
बसि : पूक० । बसकर, निवास करके । 'बन बसि कीन्हे चरित अपारा ।' मा० १.११०.७
बसिअ : आ०भावा० । निवास कीजिए। 'राम समीप बसिअ बन तबही ।' मा० २.२८०.५
बसिबे : भक०० । निवास करने । 'मुख्य रुचि होत बसिबे की पुर रावरे । विन० २१०.३
बसौं : आ०उए० (सं० वसामि>प्रा० वसमि>अ० वसउँ)। रहूं, रहता होऊँ। ____ क्यों बसौं जमनगर नेरे।' विन० २१०.३ .
बसिष्ट : बसिष्ठ । मा० १.१६७
बसिष्टु : बसिष्ठु । मा० १.३५८.३
698
_______________________________________________
बसिष्ठँ : वसिष्ठ ने । 'जनक दूत' मुनि बसिष्ठ.. बोलाए ।' मा० २.२७०.४
बसिष्ठ : सं०० (सं० वसिष्ठ) । रघुकुल के पुरोहित मुनिविशेष । मा० १.१८६.३
बसिष्ठु : बसिष्ठ+कए । केवल वसिष्ठ । 'तब नरनाह बसिष्ठु बोलाए।' मा० २.६.१
बसिहहिं : आ०भ०प्रब० (सं० वत्स्यन्ति>प्रा० वसिहिति>अ० वसिहिहिं) । रहेंगे । 'सब सुभ गुन बसिहहिं उर तोरें।' मा० ७.८५.६
बसिहि : आ०भ०ए० (सं० वत्स्यति>प्रा० वसिहिइ)। रहेगा-गी, निवास करेगा-गी। सिय बन बसिहि तात केहि भांती।' मा० २.६०.४
बसी : भू ..स्त्री० । बस गई (स्थिर हो गई)। 'कुमति बसी उर तोरें।' मा० २.३६.१
बसीठ : सं०० (सं० विसष्ट = भेजा हुआ>प्रा० वसिट्ठ) । दूत । 'प्रथम बसीठ पठउ सुन नीती।' मा० ६.६.१०
बसीठीं : दूत कार्य में, दूत कर्म वश । 'दसमुख मैं न बसीठी आयउँ ।' मा० ६.३०.२
बसीठी : संस्त्री० (सं० विसष्टि>प्रा. वसिट्टी)। दूतकर्म, दौत्य । 'गयउ बसीठी बीर बर।' मा० ६.६७ क
बसु : सं० पु. (सं० वसु) । (१) धन । जैसे, वसुधा । (२) आठ देवविशेष = आप, ध्र व, सोम, घर, अनल, अनिल, प्रत्यूष और प्रभास । (३) (उक्त आधार पर) माठ संख्या। दो० ४६६
बसुधा : संस्त्री० (सं० वसुधा) । पृथ्वी। मा० १.२०.७
बसुधातल : पृथ्वी पर । 'सोइ बसुधातल सुधा तरंगिनि ।' मा० १.३१.८
बसुधाहूं : पृथ्वी में भी। कीन्हेहु सुलभ सुधा बसुधाहूं।' मा० २.२०६.६
बसूला : सं०पू० (सं० वासि>प्रा. वासुल्ल)। बढ़ई का एक उपकरण जिससे लकड़ी काटने-छीलने का काम किया जाता है। मा० २.२१२.३
बसे : भूकृ००ब० (सं० उषित>प्रा० वसिय)। रहे, निवास किया । 'बसे सुखेन राम रजधानी ।' मा० २.३२२.८
बसेउँ : आ० - भूकृ.पु+उए । मैंने निवास किया, मैं रहा । 'बसेउँ अवध बिहगेस ।' मा० ७.१०४ ख
बसेउ, बसेऊ : भूकृ०० कए । बस गया, टिक गया। मा० १.८.८ मंदोदरी सोच उर बसेऊ ।' मा० ६.१४.६
बसेरा : सं०पू० । आवस, निवासस्थल । मा० २.३८.४
बसेरें : बसेरे से, बसने से । 'उजरें हरष बिषाद बसेरें।' मा० १.४.२
बसेरे : बसेरा+ब० । 'नपट बसेरे अघ भौगुन घनेरे नर ।' कवि० ७.१७४
बसै : बसहिं । निवास करें। 'बसै सुवास सुपास होहिं सब ।' कृ० ४८ _______________________________________________
699
बसै : बसइ । 'जनक नाम तेहि नगर बस नरनायक ।' जा०म० ६
बसैया : वि० निवास करने वाला-वाले । गी० १.६.६
बसैहैं : आ०म०प्रब० (सं० वासयिष्यन्ति>प्रा० वसाविहिति>अ० वसाविहिहिं)। बसाएंगे (स्थापित करेंगे) । 'अभय बाँह दे अमर बसे हैं ।' गी० ५.५१.४
बसैहौं : बसाइहौं । 'मन मधुकर पन करि तुलसी रघपति पद कमल बसहौं ।' विन० १०५.३
बस्तु : सं०स्त्री० (सं० वस्तु-न०)। मा० १.१०.१०
बस्य : वि. (सं० वश्य) । वशीभूत, अधीन । 'काल बस्य उपजा अभिमाना।' मा० ६.८.६
बस्यो : बसेउ । 'तुलसी चातक मन बस्यो घन सों सहज सनेह ।' दो० २६४
बह,  बहइ, बहई : आ०प्रए० (सं० वहति>प्रा. वहइ)। (१) प्रवाहित होता-ती है । 'बह समीप सुरसरी सुहावनि ।' मा० १.१२५.१ 'जल लोचन बहई ।' मा० २.६०.६ (२) तरङ्गों में गति लेता है-लेती है; चलता-ती है। त्रिबिध बयारि बहइ सुख देनी ।' मा० २.१३७.८ (३) कारगर होता है, कार्य में समर्थ गति लेता है। 'बहइ न हाथ दहइ रिपु छाती।' भा० १.२८०.१ (४) धारा में बहा कर ले चलता है । 'जलधि अगाध मौलि बह फेनू ।' मा० १.१६७.८ (५) धारण करता है। (६) भार ढोता है ।
बहत : वकृ०० । बहता-बहते । (१) चलता। 'बहत समीर पिबिध ।' मा० २.३११.६ (२) धारण करता । 'सेवक सुखद बांको बिरद बहत हौं।' विन बहति : वकृ०स्त्री० । बह रही । मा० ६.८७ छं.
बहतु : बहत+कए । अकेला वहन (धारण) करता। 'बाँको बिरुद बहतु हौं।' कवि० १.१८
बहते : क्रियातिपुब । यदि धारण करते, वहन करते। 'जो.. अति बांकुर बिरद न बहते । तो.तुलसी से सुगति न लहते ।' विन० ६७.५
बहनु : बहत= बाहन+कए । सवारी । 'वृषभ बहन है ।' कवि० ७.१६०
बहराइच : उत्तर प्रदेश में नेपाल सीमा का एक नगर जहाँ ग्राजी मियाँ (मुहम्मद गौरी के सेनानायक सैयद सालार) की कब्र है जिसे दरगाह कहते हैं । वहाँ मेला लगता है और माना जाता है कि दरगाह के पानी में नहाने से कोढ़ अच्छा होता है । यह भी कहा जाता है कि पहले यहाँ 'बालार्क कुण्ड' था जिसमें स्नान कर लोग रोगमुक्त होते थे, उसी पर मकबरा बनाया गया और अब उसी की मान्यता हो चली है। 'कब कोढ़ी काया लही, जग बहराइच जाइ।' दो० ४६६
700
_______________________________________________
बहरी : सं०० । बाज जाति का बड़ा शिकारी पक्षी (जो चील के आकार का होता है)। 'तीतर तोम तमीचर सेन समीर को सूनु बड़ो बहरी है ।' कवि० ६.२६
बहसि : वहसि । तू बहता-ती है। बिपुल बिमल बहसि बारि।' विन० १७.२
बहहिं, बहहीं : आ० प्रब० (सं० प्रा० वहन्ति>अ० वहहिं) । बहते-ती हैं । (१) धारा में विवश गति लेते हैं । 'बह भट बहहिं चढ़े खग जाहीं।' मा० ६.८८.६ (२) ढोते हैं । 'भार बहहिं खर बद।' मा० ६.२६ (३) धारा में ले चलते ती हैं। 'सरिता सब पुनीत जलु बहहीं।' मा० १.६६.१
बहहू : आ०मब० (सं० वहथ>प्रा. वहह>अ० वहह) । ढोते हो, धारण करते हो । 'मुधा मान ममता मद बहहू ।' मा० ६.३७.५
बहाइ, बहाई : (१) पूर्व० । बहाकर, प्रवाहित कर । 'बानरु बहाइ मारी महावारि बोरि के ।' कवि० ५.१६ (२) नष्ट करके । 'कुल समेत रिपु मूल बहाई । चौथे दिवस मिलब मैं आई।' मा० १.१७१.५
बहाओ : आ०मब० (सं वाहयत>प्रा. वहावह>अ० वहावहु) । प्रवाहित करो, दूर फेंको, हटावो। 'तुलसिदास सो भजन बहाओ जाहि दूसरो भाव ।' कृ० ३३
बहायो : भुकृ.पु०कए० । धो फेंका, नष्ट कर डाला । 'रावन सकुल समूह बहायो।' गी० ६.२१.३
बहावै : बहावइ । आ०प्रए० (सं० वाहयति>प्रा. वहावइ) । दूर करता है।  'मोह अंध रबि बचन बहाव ।' वैरा० २२
बहावौं : आ० उए० (सं० वाहयामि>प्रा० वहावमि>अ० वहावउँ)। धो डालं, प्रवाहित कर सकता हूं, मिटा डालता हूं। 'सबहि को पापु बहावौं।' गी०
बहि : प्रकृ० । बह कर, धारामग्न होकर । 'कपट प्रीति बहि जाउ।' गी० ५.४५.४
बहिनि, बहिनी : सं-स्त्री०। (सं० भगिनी>प्रा० भइणी-बहिणी)। बहन । मा० ३.१७.३
बहिबे : भकृ०० । धारा वाहिक गति लेने, निर्वाह करने । 'गाड़े भली उखारे __ अनुचित बनि आए बहिबे ही।' कृ० ४०
बहिबो : भकृ००कए। बहना। 'देखिबो बारि बिलोचन बहिबो।' गी० ५.१४.३
बही : भूकृ०स्त्री०। (१) बह चली। 'जुगल नयन जलधार बही ।' मा. १.२११ ई० (२) बह गयी, धुल गयी। 'प्रभु पद प्रीति सरित सो बही।' मा० ५.४६.६ (३) चली । 'बड़ी बयारि बही है।' गी० ५.२४.२
701
बहु : (१) वि० (सं०) । बहुत, अधिक, प्रचुर । मा० १.२.१३ (२) बधू । दे० सुत बहु ।
बहुत : वि० (सं० प्रभूत>प्रा० बहुत्त । अधिक, प्रचर । मा० १.८.१२
बहुतक : (बहुत+एक) बहुत सा, बहुत से । 'बहुतक बीर होहिं सत खंडा।' मा० ६.६८.५
बहुतन, बहुतन्ह : बहुत+संब० । बहुतों (के) । 'बहुतेन्ह सुख बहुतन मन सोका ।' मा०. ७.३१.२
बहुताई : सं०स्त्री० (सं० प्रभूतता>प्रा० बहुत्तया)। अधिकता, प्रचुरता, विशालता।' चितव कृपाल सिंधु बहुताई।' मा० ६.४,३
बहुते : बहुत (रूपान्तर) । 'बहुते दिनन्ह कीन्हि मुनि दाया। मा० १.१२८.६
बहुतेन्ह : बहुतन । मा० ७.३१.२
बहुतेरे : वि.पु.ब० (सं० प्रभूततर>प्रा० बहुत्तयर =बहुत्तयरय) । अति प्रचुर, ___अत्यधिक । 'पर उपदेस कुसल बहुतेरे।' मा० ६.७८.२
बहुतेरो : वि०पु०कए० । बहुत-सा, अत्यधिक । 'कहाँ लौं बनाइ कहौं बहुतेरो ।' कवि० ७.३५
बहुधा : अव्यय (सं.)। बहुत प्रकार, बहुत करके, अधिकतर । 'धनहीन दुखी ममता बहुधा ।' मा० ७.१०२.१
बहुनामिनी : वि०स्त्री० । बहुत नामों वाली । विन० १८.२
बहुबाहू : बहुत भुजाओं वाला=रावण । मा० ३.२६.१६
बहुमाना : (सं० बहुमान) । अतिशय सम्मान । मा० १.१०३.२
बहुमोल : वि० (सं० बहुमूल्य>प्रा० बहुमोल्ल) । महँगा । विन० १७६.४
बहुरंग, बहुरंगा : विविध रंगो वाला-वाले । मा० १.४०; १.१२६.२
बहुरहिं : आ०प्रब० । लौटते हैं, लौट सकते हैं । 'मातु कहें बहुरहिं रघुराऊ ।' मा०. २.२५३.४
बहुरि : पूकृ० । (१) लौट आकर । 'चलिहउँ बनहि बहुरि पग लागी।' मा० २.४६.४ (२) फिर, पुनः । 'बहुरि बंदि खलगन सति भाएँ ।' मा० १.४.१
बहरिअ, बहरिय : आ० भावा० । लौट चलिए। बहुरिअ सीय सहित रघुराई ।' मा० २.२६६.१
बहुरूप : वि० (सं.)। विविध रूपों तथा आकारों वाला-वाले । 'बहुरूप निसिचर जथ ।' मा० ५.३ छं० १
बहुरे : भूकृपु०ब० । लौट चले । 'बहुरे लोग रजायसु भयऊ ।' मा० १.३६१.३
बहुरो : फिर भी । 'बहुरो भरत कह्यो कछु चाहैं ।' गी० २.७३१
बहुल : वि० (सं०) । प्रचुर, अधिक, अतिमात्र । विन० ५४.६
702
_______________________________________________
बहुटिन्ह: बधूटिन्ह । 'सहित बधूटिन्ह कुऔर निहारे ।' मा० १.३५४.२
बहूता : बहत । तै निसिचर पति गर्ब बहता।' मा० ६.३०.७
बहे : भूकृपु । (१) धारा में पड़े हुए । 'बहे जात कइ भइसि अधारा ।' मा० २.२३.२ (२) प्रवाहित हुए। 'पुलक गात जल नयन बहे री।' गी० २.४२.३
बहेरे : (बहेरा का रूपान्तर) सं०० (सं० बिभीतक>प्रा० बहेडय) । फल वृक्ष विशेष (बहेड़ा त्रिफला में गिना जाता है) । 'बबुर बहेरे को बनाइ बागु लाइयत ।' कवि० ७६९
बहै : बहइ । बह जाता है । 'सुरसरी बहै गज भारी।' विन० १६७.२
बहोरि : वि.पु । बहोरने वाला, लोटा लाने वाला । 'गई बहोर ।' मा० १.१३.७
बहोरि : (१) बहुरि । 'जों बहोरि कोउ पूछन आवा।' मा० १.३६.४ (२) बहोरने की क्रिया अथवा बहोरने वाला=बहोर । 'गई बहोरि बिरद सदई है ।' विन. १३६.१२
बहोरी : बहोरि, बहुरि । फिर । 'प्रनवउ पुर नर नारि बहोरी ।' मा० १.१६.२
बह्यो : भूक००कए । बहा (बिगड़ा) । 'ह्या कहा जात बह्यो।' गी० २.८४.१
बाँक : बंक । टेढ़ा । होइहि बारु न बांक ।' रा०प्र० ६.३.४
बाँकी : वि०स्त्री० (सं० वा>प्रा. वंकी)। (१) टेढ़ी-+सुन्दर । चितवनि चारु भृकुटि बर बाँकी।' मा० १.२१६.८ (२) भङ्गिमायुक्त । 'पिय तन चितइ भौंह करि बाँकी ।' मा० २.११७.६ (३) तिरछी (चुभी हुई सी)। 'रघुबर बिरह पीर उर बाँकी।' मा० २.१४३.४ (४) कुटिल, प्रतिकूल । 'सोय मातु कह बिधि बुधि बाँकी ।' मा० २.२८१.८
बाँकुर : वि०० (सं० वक्र>प्रा० बंक =बंकुड) । कुटिल, उत्साही, निपुण । 'अति ___ बाँकुर बिरद न बहते।' विन० ६७.५
बाँकुरा : बांकुर । 'रन बांकुरा बालि सुत बंका ।' मा० ६.१८.२
बाँकुरे : (१) 'बाँकुरा'+ब० । 'रन बांकुरे बीर अति बाँके ।' मा. ६.३७.४ (२) सम्बोधन । हनु० २३
बाँकुरो : बाँकुरा+कए । हनु० ३
बाँके : बाँक+ब०। (१) विषम, दुर्गम । 'नाघत सरित सैल बन बाँके ।' मा० २.१५८.१ (२) दुर्लङध्य । 'लंका बाँके चारि दुआरा ।' मा० ६.३६.२ (३) क्रूर, कठोर । 'रन बाँकुरे बीर अति बाँके ।' मा० ६.३७.४ ।।
बाँको : बांक+कए। विषम, वक्र, ऋर । 'छोनिप छपन बांको बिरुद बहुत हौं ।' कवि० १.१८
बाँचत : वकृ०० (सं० वाचयत्) । पढ़ता-पढ़ते । 'बारि बिलोचन बाँचत पाती।' मा० १.२६०.४ _______________________________________________
703
बाँचा : भूकृ.पु. । (१) बचा, शेष रहा । 'सत्यकेतु कुल कोउ नहिं बांचा।' मा० १.१७५.७ (२) बचाया (उपेक्षित किया)। 'बाल बिलोकि बहुत मैं बाँचा ।' मा० १.२७५.४
बांचि : कृ० । बच (कर), रक्षित हो (कर) । 'बड़े ही की ओट बलि बांचि आए छोटे हैं।' विन० १७८.४ (२) पढ़कर।।
बाँचिअ : आ० भावा० । बचा जाय, बचे रहा जा सके। 'देखब कोटि बिआह जियत जो बाचिन ।' पा०म० १०७
बाँचिहै : आo-भ०-प्र०+मए । बचेगा, रक्षा पायेगा। 'बांचिहै न पार्छ त्रिपुरारिहू मुरारिहू के ।' कवि० ६.१
बाँची : (१) बचि । पढ़कर। 'नर के कर आपन बध बांची हसेउ ।' मा० ६.२६.२ (२) भूक०स्त्री०। पड़ी। पुनि धरि धीर पत्रिका बांची ।' मा० १.२६०.६ (३) ब ची, शेष रही। 'बांची रुचिरता रंचो नहीं।' जा०म०छं०४ (४) ब चा गई, छोड़ गयी। 'सो माया रघबीरहि बाँची ।' मा० ६.८६.७
बाँचे : भूकृ००ब । बचे रहे। 'जे नारि बिलोकनि बान ते बाँचे ।' कवि० ७.११८
बाँचो : (१) बाँच्यो । बच गया। 'बड़ी ओट राम नाम की जेहि लई सो बांचो।' विन० १४६.६ (२) आ०-प्रार्थना-मब० । पढ़ो। 'बिनय पत्रिका दीन की वापु आपु ही बांचो।' विन० २७०.३
बाँच्यो : भूकृ००कए । बच गया। तेहि कारन खल अब लगि बाँच्यो।' मा० ६.९४.७
बाँझ, बाँझा : वि०स्त्री० (सं० वन्ध्या>प्रा० वंझा>अ० वंझ)। प्रसवहीन स्त्री। मा० १.६७.४; २.१६४.४
बाँट : सं०० (सं० वट) । भाग (बँटवारे में प्राप्य अंश)। 'बिप्रद्रोह जनु बाट पर्यो।' विन० १४२.८
बाँटि : पूकृ० (सं० वण्टयित्वा>प्रा. वंटिअ>अ. वंटि)। बाँट कर, विभक्त ___ करके । 'जेहि जस जोग बाटि गृह दीन्हे ।' मा० १.१७६.७
बाँटी : भूक० स्त्री० । विभक्त कर ली। 'बाँटी बिपति सबहिं मोहि भाई ।' मा० २.३०६.६
बाँध, बाँधइ : आ०प्रए० (सं० बध्नाति>प्रा० बंधइ)। बांधता है। 'मम पद ___ मनहि बाँध बरि डोरी।' मा० ५.४८.५
बाँधत : वकृ.पु । बांधता-बांधते । 'जटजट बांधत ।' मा० ३.१८ छं०
बाँधहु : आ०मब० (सं० बध्नीत>प्रा० बंधह>अ० बंधह)। बांध लो (बन्दी बनाओ) । 'धरि बांधह नप बालक दोऊ ।' मा० १.२६६.३
704
_______________________________________________
बाँधा : (१) भूक०० । कसा । 'मग बिलोकि कटि परिकर बांधा। मा० ३.२७.७. (२) (बाँध) बनाया । 'बाँधा सेतु ।' मा० ६ ३.७ (३) सेतु द्वारा प्रवाह पर मार्ग बनाया। 'बांधा सिंध इहइ प्रभुताई ।' मा० ६.२८.१
बाँधि : पूकृ० । बाँध कर । (१) लपेट कर, कस कर । 'तेल बोरि पट बाँधि पुनि पावक देहु लगाइ ।' मा० ५.२४ (२) बन्दी बनाकर । 'बानरु बेचारो बोधि आन्यो हठि हार सों। कवि० ५.११ (३) सेतुबद्ध करके। 'बांधि बारिधि......" दोउ बीर मिलहिंगे ।' गी० ५.६.४ ।
बाँधिए, बाँधिये : आ० कवा०प्रए । बांधा जाय । बेगि बाँधिऐ ब्याधि ।' दो० २४२
बांधिबे : भकृ०० । बाँधने । 'बाँधिबे को भव गयंद रेन की रजु बटत ।' विन० १२६.३
बांधियेगी : आ.०भ० स्त्री०कवा०प्रए । बांधी जायगी। 'अब बाँधियगी कछु मोट कला की।' कवि० ७.१३४
बाँधिहै : आ०भ०प्रए० । बाँधेगा, बांधकर बनायेगा । 'अब तुलसी पूत रो बाँधिहै।' विन० २४१.५ (दे० पूतरो)।
बाँधी : (१) बाँधि । बन्दी बनाकर । 'तिन्हहि जीति रन आनेसु बाँधी ।' मा० १.१८२.३ (२) भूक०स्त्री० । बन्धन में पड़ी, रुद्ध की हुई । 'कामधेनु कृपा... मरजाद बाँधी रही है ।' गी० १.८७.४ (३) मर्यादाबद्ध की (प्रतिष्ठित की)। 'बेद बाँधी नीति ।' गी० ७.३५.२
बाँधें  : (१) बांधे हुए (स्थिति में) 'कटि तूनीर पीत बट बाँधे ।' मा० १.२४४.१ (२) दृढता से संभाले हुए । 'बाँधे बिरद बीर रन गाढ़े।' मा० १.२६६.१
बाँधे : भक०० ब० । (१) मर्यादित किये। 'बाँधे घाट मनोहर ।' मा० ७.२८ (२) बन्दी बनाये गये । 'के व भाजे आइहै के बांधे परिनाम ।' दो० ४२२ (३) बांधे जाने । 'मोहि न कछु बाँधे क इ लाजा।' मा० २.२२.६
बाँधेउँ : आ०-भूकृ०पु+उए । मैं बांधा गया-बन्दी बनाया गया। तेहि पर बाँधेउँ तनयँ तुम्हारे ।' मा० ५.२२.५
बाँधेउ : भूक.पु०कए० १ बाँध लिया। 'खर्ब निसाचर बाँधेउ नागपास सोइ राम।' मा० ७.५८
बांधेसि : आ०-भक००+प्रए० । उसने बाँधा । 'नागपास बाँधेसि ले गयऊ।' मा० ५.२०.२
बांधेसु : आ०-भ०+आज्ञा+मए । तू बाँधना, बन्दी बना लेना । 'मारसि जनि सुत, बाँधेसु ताही ।' मा० ५.१६.२
बाँधै : (१) बाँधइ । (२) मए । तू बाँध। 'तात बाँध जिनि बेरै ।' गी० ५.२७.३ तुलेसी शब्द-कोश
705
बाँधो : बाँध्यो । 'छटिबे के जतन बिसेष बांधो जायगो ।' विन०६८.४
बाँध्यो : बाँधे उ । सेतुबद्ध किया। 'बाँध्यो बननिधि ।' मा० ६.५
बाँभन : सं०पु० (सं० ब्राह्मण>प्रा० बम्हण>अ० बंभण) । विप्र । मा० २.१४७.३
बाँवो: सं.पु कए० (सं० वामम>प्रा० वामं>अ० वाउ) । बाँया। 'जो दसकंठ दियो बाँवो ।' गी० १.८६.२ (बायाँ देना== उपेक्षा करना, टालमटूल करना)।
बाँस : सं०० (सं० वंश>प्रा० वंस)। (१) वेणु वृक्ष । रान० ३ (२) लाठी (बांस की)। 'फरसा बांस सेल सम करहीं।' मा० २.१९१.५ (३) लग्गी। 'बांस पुरान साज सब अठकठ।' विन० १८९.२
बाँह : बाहु (सं० बाहुबाहा) । (१) भुज । मा० ३.२२.१ (२) आश्रय, शरण (मुहावरा) । 'लाज बांह बोले की ।' कवि० ६.५३
बाँहपगार : (दे० पगार) चारदीवारी के समान रक्षक बाहुबल वाला=शरणदाता । हनु० ३६
बाँहपगारु : बांहपगार+कए । एकमात्र शरणदाता । 'बांहपगारु बोल को रच्छक।' ___गी० ५.३५.४
बाँहबोल : शरण देने का वचन । विन० २७६.६
बाँहु : बाहु।
बाइ : पू० ! (सं० व्यादाय) । फैलाकर, फाड़कर । 'मुख बाइ धावहिं खान ।' मा० ६.१०१ छं० ३
बाउ, बाऊ : बाय+कए० । वायु । मा० १.२८०.४
बाउर : वि०पू० (सं० वातुल>प्रा० वाउल्ल प्रलापी)। (१) पागल या विक्षिप्त। 'तेहिं जड़ बरु बाउर कस कीन्हा ।' मा० १.६६.८ (२) प्रलापीकुछ का कुछ बक जाने वाला। 'मोन मलिन मैं बोलब बाउर ।' मा० २.२६३.५
बाउरि : बाउर+स्त्री० । विक्षिप्ता । 'बौरेहि के अनुराग भइउँ बड़ि बाउरि ।' पा०म० ६३
बाऊ : बाउ । 'सीतल मंद सुरभि बह बाऊ ।' मा० १.१६१.३
बाएँ : (१) क्रि०वि० (सं० वामे)। प्रतिकूल । 'जे बिनु काज दाहिनेहुं बाएँ ।' मा० १.४.१ (२) बांयी ओर । 'छोंक भइ बाएँ।' मा० २.१९२.४ (३) उलट कर । 'आयउँ लाइ रजायसु बाएँ।' मा० २.३००.१
बाक्यग्यान : (सं० वाक्य-ज्ञान) जीवनचर्या में बिना उतारे हुए कोरा शास्त्रीय अर्थज्ञान (आचार्य रामानुज ने ज्ञान की दो कोटियां की हैं-वाक्य ज्ञान और उपासना)। उपासनाहीन ज्ञान । बाक्यग्यान अत्यंत निपुन भय पार न पावै कोई।' विन० १२३.२
706
_______________________________________________
बाग : (१) सं०० (फा० बाग)। मेवा आदि का उद्यान । मा० १.३७ (२) सं०स्त्री० (सं० वाच-बाग ) वाणी। 'मदु मंजुल जनु बाग बिभूषन ।' मा० २.४१.६ (३) सं०स्त्री० (सं० वल्गा>प्रा. वग्गा>अ० वग्ग)। घोड़े की लगाम ।
बागत : व.पु. (सं० वल्गत-वल्ग गती>प्रा. वग्गंत) । चलता-चलते । 'जागत बागत बैठे बागत बिनोद मोद।' हनु० १२
बागन्ह : बाग+संब० । उद्यानों (में)। 'बागन्ह बिटप बेलि कुम्हिलाही ।' मा० २.८३.८
बागवान : सं०पू० (सं० बागबान)। बाग का रक्षक=माली । कवि० ५.३१
बागहिं, बागहीं : आ०प्रब० (सं. वल्गन्ते>प्रा. वगंति>अ० वग्गहिं)। बकवास करते हैं; (अपनी प्रशंसा में) उछलते हैं। 'एक करहिं कहत न बागहीं।' मा० ६.६० छं०
बागा : बाग । उपवन । मा० १.४०.६
बागिहै : आ.प्रएमए० (सं० वलिष्यति, वल्मिष्यसि>प्रा० वग्गिहिइ, वग्गिहिसि >अ० वग्गिहिइ, वग्गिहिहि) । भटकेगा, दौड़ता-भागता घूमेगा। 'पाइ परितोष तू न द्वार द्वार बागिहै ।' विन० ७०.४
बागीसा : (१) सं०स्त्री० (सं० वागीशा) । सरस्वती, वाणी । 'जानेहु तब प्रमान बागीसा ।' मा० १.७५.४ (२) सं+वि०पू० (सं० वागीश)। वाणी का अधिष्ठाता देव =बृहस्पति अथवा शब्दरूप ब्रह्म= शब्द ब्रह्म= ओंकार रूप परमात्मा । वाक्प्रेरक । 'व्यापक ब्रह्म बिरज बागीसा। मा० ७.५८.७
बागु : बाग+कए । उद्यान । 'देखन बागु कुअर दुइ आए।' मा० १.२२६.१
बागुर : संस्त्री०+पु० (सं० वागुरा)। पशु-पक्षियों को फंसाने का जाल । 'बागुर बिषम तोराइ मनहुं भाग मुगु भाग बस ।' मा० २.७५
बागुरौ : बागुर+कए । जाल । 'तुलसिदास यह बिपति-बागुरो तुम्हहि सों बन निबेरें। दिन० १८७.५
बागे : भूक००ब० । भटके, घूमते फिरे । 'चंचल चरन लोभ लगि लोलुप द्वार द्वार जग बागे।' विन० १७०.६
बाघ : सं०० (सं० व्याघ्र>प्रा० वग्ध)। चीता आदि । मा० १.३८.७
बाघउ : बाघ भी । 'बाघउ सनमुख गएँ न खाई।' मा० ६.७.१
बघिनि : बाघ-+स्त्री० (सं० व्याघ्री) । मा० २.५१.१
बाचत : वकृ०० (सं० वाचयत्) । पढ़ता-पढ़ते । 'बाचत प्रीति न हृदये समाती।' मा० १.६१.६
बाचा : (सं० वाचा)। (१) वाणी से। 'मनसा बाचा कर्मना ।' वैरा० २६ (२) सरस्वती द्वारा । 'सिव बिरंचि बाचा छले।' गी० ५.४१.२
707

बाचाल, बाचाला : वि.पु. (सं० वाचाल)। (१) अधिक बोलने वाला, वक्ता । 'मूक होहि बाचाल ।' मा० १.०.२ (२) व्यर्थ बकने वाला। 'धन मद मत्त परम बाचाला। मा० ७.६७.३
बाचि : बांचि । 'लगन बाचि अज सबहि सुनाई ।' मा० १.६१.७
बाची : बाँची। पढ़ी । 'पत्रिका...बांची बहुरि नरेस ।' मा० १.२६०
बाचु : आ०-आज्ञा-मए । तू पढ़ । 'लछिमन बचन बाचु कुलघाती।' मा० ५.५२.८
बाच्यो : बाँच्यो । मा० ६.६४.७ (पाठान्तर) ।
बाज : (१) सं०पू० (फा० बाज-एक शिकारी परिन्दः)। एक पक्षी जो दूसरे पक्षियों को मारकर आहार करता है । 'बाज झपट जन लवा लुकाने ।' मा० १.२६८.३ (२) बाजइ । बज रहा है। 'घर घर उत्सव बाज बधावा ।' मा० १.१७२.५ बाज बाजइ : (सं०. वाद्यते>प्रा०. वज्जइ) आ०प्रए । बजता है, बजती है। रान०११
बाजत : (१) वकृ.पुं० । बजता, बजते । 'बाजत बिपुल निसाना।' मा० १.२६७.५ (२) बजाते । 'बाजत बिबुध बधाई।' गी० १.५५.६
बाजति : वकृ०स्त्री० । बजती । पैजनी पायनि बाजति ।' गी० १.३२.२
बाजन : (१) बाजा । वाद्य । 'सुमन बुष्टि नभ बाजन बाजे।' मा० १.६१.८ (२) भकृ. अव्यय । बजने । 'बिपुल बाजने बाजन लागे।' मा० १.३४८.३
बाजने : बाजे । वाद्य । मा० १.३४८.३
बामने ऊ : बाजे भी । 'बोले बंदी बिरुद बजाइ बर बाजनेऊ ।' कवि० १.८
बाजपेयी : वि०० (सं० वाजपेयिन्) । वाजपेय यज्ञ करने वाला पवित्र व्यक्ति । 'कोन धौं सोमजाजी अजामिल अधम, कोन गजराज धौं बाजपेयी ।' विन० १०६.३ (यहाँ ब्राह्मण जातिविशेष से तात्पर्य नहीं; सोमयाजी के साथ उक्त अर्थ ही संगत है जो मुहावरों में आज भी चलता है)।
बाजहिं, बाजहीं : आ.प्रब० (सं० वाद्यन्ते>प्रा० बज्जति>अ० वज्जहिं) । बज रहे हैं । मा० १.६२.५; १.३१७ छं०
बाजा : (१) सं०० (सं० वाद्य>प्रा० वज्ज)। 'चले बसहँ चढ़ि बाजहिं बाजा।' मा० १.६२.५ (२) बाजइ । बजता है (आघात से रव करता है)। 'हतहिं कोपि तेहि घाउ न बाजा।' मा० ६.७६.८ (३) भूक.पु. (सं० वाज== युद्ध)। लड़ने लगा । 'तिन्हहि निपाति ताहि सन बाजा ।' मा० ५.१६.७
बाजार : बजार । मा० ७.२८ छं.
बाजि : सं०० (सं० वाजिन्) । अश्व । मा० १.१५६.३
बाजिमेष : अश्वमेध यज्ञविशेष । मा० ७.२४.१
708
_______________________________________________
बाजिहैं : आ०भ० प्रब० । बजेंगे। 'सुरपुर बाजिहैं निसान ।' गी० १.२२ १३
बाजी : (१) बाजि । अश्व । 'पावत देखि अधिक-ख बाजी।' मा० १.१५७.१ (२) भूक०स्त्री० । बज उठी । गहगहि गगन दुदुभी बाजी।' मा० १.१६१.७ (३) सं०स्त्री० (फा० बाजी) । खेल, खेल का दांव (प्रतिष्ठा) । 'तुलसी की बाजी राखी राम ही के नाम ।' कवि० ७.६७
बाजीगर : सं० (फा० बाजीगर) । कौतुक या जादू का खेल दिखाने वाला। विन० १५१.२
बाजु, बाजू : (१) बाज+कए । बाज पक्षी। मा० २.२८ (२) भूकृ००कए । बज उठा । 'बाजु बधावनो।' पा०म०/०६ (३) अव्यय (सं० वर्जम्>प्रा० वज्जं>अ० वज्जु) । विना, छोड़कर । दीनता दारिद दल को कृपा बारिधि बाजु ।' विन० २१६.४
बाजू : बाज । बाज पक्षी । 'लेइ लपेटि लवा जिमि बाज ।' मा० २.२३०.६ ।
बाजे : (१) भूकृ००ब ० । बज उठे, बजने लगे, बजे । नभ बाजन बाजे ।' मा १.६१.८ (२) वि०ब० (फा० बाज= अलग)। कोई, किसी, किन्हीं। 'बाजे. बाजे राजन के बेटा बेटी ओल हैं।' कवि० ५.२१
बाजैं : बाजहिं । कवि० १.१४
बाजै : बाजइ । 'सुसमय दिन हूँ निसान सब के द्वार बाजै ।' विन० ८०.३
बाट, बाटा : संपु० (सं० वाट) । मार्ग । मा० ५.३०; ३.७.४
बाटिकनि: बाटिका--संब० । वाटिकाओं (में) । 'खेलत चौहट घाट बोथी बाटिकनि ।' गी० १.४२.३
बाटिकाँ : वाटिका में । 'बिष बाटिकां कि सोह सुत सुभग सजीवनि मूरि ।' मा० २.५६
बाटिका : सं०स्त्री० (सं० वाटिका) । उद्यान, बाड़ी। मा० १.३७
बाढ़ : बाढ़इ । (१) बढ़ता है, बढ़े। जेहिं बाढ़ बिरोधु ।' मा० २.१८ (२) उन्नति करता-ती है। 'प्रजा बाढ़ जिमि पाइ सुराजा।' मा० ४.१५.११।
बाढ़, बाढ़द : बढ़इ । (१) ज्वार में आता है, उत्तरङ्गित होता है। 'देखि पूर बिधु बाढ़इ जोई।' मा० १.८.१४ (२) विस्तार पाता-ती है। 'बाढ़इ कथा पार नहिं लहऊँ ।' मा० १.१२.५ (३) उत्कर्ष लेता-ती है। 'बाढ़इ प्रीति न थोरि ।' मा० १.२३४
बाढ़त : बढ़त । 'नित नूतन सब बाढ़त जाई ।' मा० १.१८०.२
बाढ़ति : वकृस्त्री० । बढ़ती (हुई) । 'प्रेम तुषा बाढ़ति भली ।' दो० २७६
बाढ़न : भक० अव्यय । बढ़ने । 'जमुना ज्यों ज्यों लागी बाढ़न ।' विन० २१.१
बाढ़हिं : बढ़हिं । 'बाढहि असुर अधम अभिमानी।' मा० १.१२१.६
बाढ़ा : भूकृ०० । बढ़ गया । 'ब्याज बहु बाढ़ा।' मा० १.२७६.३
709
बाढ़ि : सं०स्त्री० (सं० वृद्धि>प्रा० वढि, वड्ढी)। बढ़ना। 'सिर भुज बाढ़ि देखि रिपु केरी।' मा० ६.६८.१।
बाढ़ी : (१) बाढ़ि । 'दसमुख देखि सिरन्ह के बाढ़ी ।' मा० ६.६३.१ (२) भूकृ० स्त्री० । बढ़ी। 'बहु लालसा कथा पर बाढ़ी।' मा० १.१०४.२
बाढ़ें : बढ़ने पर । 'प्रबल अनल बातें जहाँ काढ़े तहाँ ठाढ़े।' मा० ५.२३
बाढ़े : बढ़े । 'बाढ़े खल बहु चोर जुआरा ।' मा० १.१८४.१
बाढ़ेउ : बढ़ यो । 'बलि बांधत प्रभु बाढ़ेउ ।' मा० ४.२६
बाढ़ै : बाढ़इ । 'संसार बाढ़े नित नयो।' विन० १३६.७
बाण : सं०पू० (सं०) । तीर । मा० ३ श्लोक २
बात : (१) सं०० (सं० वात) वायु । 'आतप बरषा बात।' मा० २.२११ (२) त्रिदोष में अन्यतम वात व्याधि । 'ग्रह ग्रहीत पुनि बात बस ।' दो० २७१ (३) सं०स्त्री० (सं० वार्ता>प्रा० वत्ता>अ० वत्त)। उक्ति, कथन । 'सत्य कहहु सब बात ।' मा० १.५५ (४) खबर, हवाला । 'नगर ब्यापि गइ बात सुतीछी।' मा० २.४६.६ (५) व्यति कर, कार्य गति । 'बड़ें भाग बिधि बात बनाई।' मा० १.३१०.८ (६) विषय । 'चिन्ता कवनिहुं बात के ।' मा० २.६५
बातजात : वायु पुत्र हनुमान् ! कवि० ६.६
बातनि, बातन्ह : बात+संब० ! बातों, उक्तियों (से) । 'बातन्ह मनहि रिझाइ सठ।' मा० ५.५६ क
बाता : बात । (१) वायु । 'सहत दुसह बन आतप बाता।' मा० ४.१.६ (२) उक्ति, कथन आदि । 'जौं बालक कह तोतरि बाता ।' मा० १.८.६
बाति, बाती : सं०स्त्री० (सं० वर्ति>प्रा० वत्ति, वत्तो) । दीप की बत्ती । 'दीप बाति नहिं टारन कहऊँ ।' मा० २.५६.६, ७.१२०.३
बातु : बात+कए । वायु । 'समय पुराने पात परत डरत बातु ।' कवि० ५.१
बातुल : वि० (सं० वातुल) । वातग्रस्त, पागल । 'बातुल भूत बिबस मतवारे ।'  मा० १.११५.७
बातें, बातै : बात+ब० । वार्ताएं, उक्तियाँ । 'कहि बातें मृदु मधुर सुहाई।' मा० १.२२५.८
बातो : बात भी। 'जो पं कहुं कोउ पूछत बातो।' विन० १७७.५
बाद : सं०० (सं० वाद)। (१) तर्क-वितर्क पूर्ण मत, विवादग्रस्त अप-सिद्धान्त । 'पाखंडबाद ।' मा० ४.१४ (२) प्रमाणित सिद्धान्त । परमार्थवाद, हेतुवाद आदि (दे० परमारथबादी; हेतुबाद)। (३) शर्त, दाँव । 'उपरी-उपरा बदि बाद ।' गी० ५.२२.४
710
_______________________________________________
वादबिबाद : सं०० (सं० वाद-विवाद)। तर्क-वितर्क, पक्ष-विपक्ष की यक्तियों से युक्त वार्ताक्रम । दो० ४७०
बादर : सं०० (सं० वार्दल>प्रा० वद्दल)। मेघ (आकाश)। 'उमगि चलेउ आनंद भुवन भुई बादर ।' जा०म० १८७
बादले : बादल (बादर) ब० (प्रा० वद्दलय)। मा० ६.४६ छं.
बादहिं : आ०प्रब० (सं० वादयन्ति)। वितण्डावाद फैलाते हैं, विवाद करते हैं, वितर्कपूर्ण मतवाद प्रस्तुत करते हैं; शर्त लगाते हैं । 'बादहि सूद्र द्विजन्ह सन ।' मा० ७.६६ ख
बादि : अव्यय (सं० वादि-बोलने वाला ?) कहने में = अर्थहीन शब्दमात्र में= व्यर्थ । 'बादि गलानि करहु मन माहीं।' मा० २.३०५.८
बादी : (१) बादि । वृथा। 'देबि मोहबस सोचिअ बादी।' मा० २.२८२.६ (२) वि.० (सं० वादिन) । सिद्धान्तविशेष मानने वाला—'परमारथ बादी।' मा० ३.६.५
बादु : बाद+कए । तर्क, मतभेद । 'को करि बादु बिबादु विषादु बढ़ावइ ।' पा०म० ६५
बाधक : वि.पु(सं०) । बाधा पहुंचाने वाला, व्याघात देने वाला । मा० ४.७.१७
बाधको : बाधक भी । 'जाकी छाँह छुएं सहमत ब्याध बाधको।' कवि० ७.६८
बाधा : सं०स्त्री० (सं.)। (१) प्रतिबन्ध, विघ्न । 'जिमि हरि सरन न एकउ बाधा ।' मा० ४.१७.१ (२) रुकावट, रोकथाम । 'निसरत प्रान करहिं हठि. बाधा ।' मा० ५.३१.६ (३) शङका, भय, आतङ्क । 'कहु, सठ, तोहि न प्रान कइ बाधा ।' मा० ५.२१.३ (४) दु:ख =आध्यात्मिक, भौतिक तथा दैविक क्लेश । 'आधिभौतिक बाधा भई ।' विन० ८.३ (५) बाधइ। बाधा पहुंचाता है । 'करम सुभासुभ तुम्हहि न बाधा ।' मा० १.१३७.४
बाधी : भूकृ०स्त्री० (सं० बाधिता)। बाधित हुई, रुद्ध हुई, रुक गई । 'सुमिरत हरिहि साप गति बाधी ।' मा० १.१२५.४
बान : (१) बाण । तीर । मा० ६.६३.३ (२) बाणासुर । 'रावन बान छुआ नहिं चापा ।' मा० १.२५६.३ (३) सं०० (सं० वर्ण>प्रा० वण्ण)। रङ्ग, चमक, शोभा, दीप्ति । 'कनकहि बान चढ़इ जिमि दाहें ।' मा० २.२०५.५
बानइत : वि०० (सं० बाणवत् =बाणवित्त>प्रा० बाण इत्त)। तीरन्दाज, धनुर्धर । कवि० ६.३०
बानक : सं०० (सं० वर्णक) । (१) समञ्जस सम्बन्ध, उचित योग । 'मैं पतित तुम पतित पावन दोउ बानक बने ।' विन० १६०.१ (२) सजावट । पा०म०
711
बानति : वक०स्त्री० । बनती। 'मुख सुषमा कछु कहत न बानति ।' गी० ७.१७.१
बानन्ह : बान+संब० । बाणों, तीरों (से, के)। 'पुनि निज बानन्ह कीन्ह प्रहारा।' मा० ६.८३.५
वानर : सं०पू० (सं० वानर)। बंदर । मा० १.१८७
बानराकार : बानर की आकृति वाला । विन० २७.१
बानरु : बानर+कए । यह एक बानर । 'बानरु बड़ी बलाइ घने घर चालिहै ।' कवि० ५.१०
बानवान : बानइत (सं० बाणवान्) । हनु० ३६
बाना : बान । (१) तीर । 'देखि कुठारु सरासन बाना।' मा० १.२७३.४ (२) (सं० वर्णक>प्रा० वण्णम) । वेषरचना, स्वरूप । 'जनु बानत बने बहु बाना ।' मा० ३.३८.३ (३) स्वभाव, शील । 'मषा न कहउँ मोर यह बाना ।' मा० ७.१६.७
बानि : (१) बानी (सं० वाणी)। 'भइ मृदु बानि सुमंगल देनी ।' मा० २.२०५.६ (२) सरस्वती । 'बानि बिनायकु अंब रबि ।' रा०प्र० १.१.१ (३) सं०स्त्री० (सं० वान जीवन, गति, बुनावट)। शील, स्वभाव । 'एक बानि करु नानिधान की । सो प्रिय जा के गति न आन की।' मा० ३.१०.८ (४) व्यसन (लत)। 'मैया इनहि बानि पर घर की नाना जगुति बनावहिं ।' क० ४
बानिक : सं०स्त्री० (सं० वणिका)। सजावट, बेषरचना । 'आपनी आपनी बर बानिक बनाइ के ।' गी० १.८४.१
बानीं : वाणी से, में । 'अति निर्मल बानी अस्तुति ठानी।' मा० १.२११ छं० ।
बानी : सं०स्त्री० (सं० वाणी)। (१) सरस्वती देवी । 'कवि उर अजिर नचाहिं बानी ।' मा० १.१०५.६ (२) अर्थ बोधक शब्द । 'सब गुन रहित कुकबि कृत बानी।' मा० १.१०.५ (३) कथन । 'करउँ प्रनाम करम मन बानी ।' मा० १.१६.७ (४) ध्वनि । 'मनहुँ सिखिनि सुनि बारिद बानी ।' मा० १.२६५.३ (५) वागिन्द्रिय। 'बिनु बानी बकता।' मा० १.११८.६ (६) बानि । स्वभाव, व्यसन । 'सुन खगेस प्रभु के यह बानी ।' मा० ६.११४.३
बानु : बान+कए। (१) बाणासुर । 'रावनु बानु महा भट भारे।' मा० १.२५०.२ (२) तीर । 'बानु बानु जिमि गयउ ।' जा०म० ६२
बानत : बानइत । 'जनु बानत बने बहु बाना ।' मा० ३.३८.३
बाप : सं०० (सं० वप्र, वप्त>प्रा० वप्प) । पिता। पा०म०/० ६
बापिका : बापी (सं० वापिका) । बावड़ी । मा० १.८६.७ ।।
बापी : सं०स्त्री० (सं० वाणी)। बावड़ी एक प्रकार का चौड़ा कुआ जिसमें उतरने हेतु सीढ़ियाँ बनी रहती हैं । मा० १.१५५.७
बापु : बाप+कए । पिता । विन० २७०.३
712
बापुरें : बेचारे ने । 'बापुरे बिभीषन पुकारि बार-बार कह्यो।' कवि० ५.१०
बापुरे : बपुरे । मा० ७.१२२.४
बापुरो : बापुरा (बपुरा) कए । अत्यन्त तुच्छ । 'चंद बापुरो रंक ।' मा० १.२३७
बापू : बापु । मा० २.२६३.२
बाबू : (फा० बाबा-बाप, पितामह, नाना, सरदार, मुखिया) (हिन्दी में) सम्मान्य पुरुष । कवि० ७.१४०
बाम : (१) वि० (सं० वाम)। कुटिल । 'तहूं बंधु सम बाम ।' मा० १.२८२ (२) प्रतिकूल । 'बिधि बाम की करनी कठिन ।' मा० २.३०१ (३) पंथ विशेष (वाममार्ग) जिसमें पञ्च मकारी साधना की जाती है (मत्स्य, मांस, मदिरा, मुद्रा और मैथुन) । 'तजि श्रुति पंथु बाम पथ चलहीं।' मा० २.१६८.७ (४) बायाँ (दक्षिण का विलोम)। 'बाम भाग आसनु हर दीन्हा ।' मा० १.१०७.३ (५) सं०स्त्री० (सं० वामा)। सुन्दरी=स्त्री। 'आनि पर बाम बिधि बाम तेहि ।' कवि० ६.४
बामता : संस्त्री० (सं० वामता)। प्रतिकूलता। कवि० ५.२०
बामदेउ : बामदेव+कए। (१) ऋषिविशेष । मा० १.३३० (२) शिव । पा०म० २६
बामदेव : सं०० (सं० वामदेव) । (१) ऋषि विशेष । मा० १.३२० (२) शिव । हनु०६
बामन : सं०० (सं० वामन) । विष्णु का अवतार विशेष । मा० ६.११०.७
बामपथ : (दे० बाम) । बाम मार्ग (तान्त्रिक शाक्त साधना, पञ्चमकार साधना मार्ग)। मा० २.१६८.७
बामा : बाम । (१) प्रतिकूल । 'फूलत फलत भयउ बिधि बामा ।' मा० २.५९.४ (२) सुन्दरी स्त्री । 'नारि बेष जे सुर बर बामा।' मा० १.३२२.५
बामु, बामू : बाम+कए। प्रतिकूल । 'भयउ कुठाहर जेहिं बिधि बामू ।' मा० २.३६.२
बामै : बाम ही, प्रतिकल ही। 'लागे दाहिनेउ बाम ।' गी० ५.२५.४
बामो : वाम भी, कुटिल जन भी, प्रतिकुल भी। भए बजाइ दाहिने जो जपि तुलसिदास से बामो।' विन० २२८.५
बायेँ : बाम । प्रतिकूल । 'सृज्यो हौ बिधि बायें ।' गी० ७.३१.५
बाय : सं°० (सं० वात>प्रा० वाय) । (१) वायु । 'सपूत पूत बाय को।' हनु० ३१ (२) वातव्याधि । हनु० ३७ (३) आयुर्वेद में त्रिदोष (वात-पित्त कफ) में अन्यतम । 'भयो त्रिदोष भरि मदन बाय ।' विन० ८३.२ _______________________________________________
713
बायन : सं०० (सं० उपायन>प्रा० वायन)। व्यावहारिक उपहार जो परस्पर भेजते हैं । 'बायन देना' मुहावरा व्यक्त करता है कि जैसा किया है, वैसा फल बदले में मिलेगा (जिस प्रकार वायन बदले में देने की प्रथा है)। भले भवन अब बायन दीन्हा । पावहुगे फल आपन कीन्हा ।' मा० १.१३७.५
बायनो : बायन+कए । 'है बायनो दियो घर नीके ।' ०६
बायस : सं०० (सं० वायस) । (१) पक्षी (२) कोआ । 'बायस पलिअहिं अति अनुरागा।' मा० १.५.२ ।।
बायों : बाय+कए । बायाँ (उपेक्षित) । 'बायों दियो बिभव कुरुपति को।' विन० २४०.३ (बायां देना मुहावरा उपेक्षा करने के अर्थ में है)।
बायो : भूक पु०कए । बाया=फैलाया। 'परी न छार मुह बायो।' विन० २७६.२
बार : (१) सं०० (सं० वार) । दिन । (२) रविवार आदि दिन । 'नौमी भौम बार ।' मा० १.३४.५ (३) अवसर, समय । 'एक बार भरि मकर नहाए।' मा० १.४५.३ (४) क्रम (बारी) (सं० वारा) । 'बूढ़ भए बलि मेरिहि बार ।' हनु०१७ (५) आवृत्ति । 'करत सुरति सय बार ।' मा० १.२६.५ 'बारहिं बार ।' मा० १.७२.७ (६) विलम्ब, देर । 'तनहि तजत नहिं बार लगाई।' कृ० २५ (७) सं०० (सं० वाल) । केश, रोम । 'छूटे बार बसन उघारे ।' कवि० ५.१५ (८) सं०५० (सं० बाल)। बालक । (६) (सं० वार) बाजार । दे० बारबधू ।
बारंबार : क्रि०वि० (सं० वारं वारम्) । पुनः पुनः । मा० ३.३४
बारक : (बार---एक)। एक बार । 'बारक नाम कहत जग जेऊ।' मा० २.२१७.४
बारन : सं०० (सं० वारण) । हाथी । मा० ६.१११.२
बारनि, बारन्हि : बार+संब० । वारों=आवृत्तियों (में)। 'तिल ज्यों बहु बारनि पेरो।' विन० १४३.२
बारबधू : सं०स्त्री० (सं० वारवधू)। बाजारू स्त्री-वैश्या । 'तारन बारन बार बध को।' कवि० ७.६०
बारबार : बारंबार । गी० २.७४.१
बारय : आ०-प्रार्थना-मए० (सं० वारय)। निवारण कर, तू रोक दे । मा०
बारह : संख्या (सं० द्वादश>प्रा. वारह)। दो० ३०७
बारहबाट, बारहबाटा : (बारह+बाट)। बारह मार्गों में, अनेकधा विच्छिन्न, नष्टभ्रष्ट । 'रावन सहित समाज अब जाइहि बारहबाट ।' रा०प्र० ५.६.२ 'घालेसि सब जगु बारहबाटा।' मा० २.२१२.५
बारहें : (सं० द्वादशे>प्रा० बारहये>अ० बारहवें । दो० ४६६
714
_______________________________________________
बारहौं : सं०'कए० (सं० द्वादश:>प्रा० बारहमो>अ० बारहवों=बारहउँ)। पुत्र जन्म से बारहवां दिन जब नामकरण संस्कार होता है । 'छठी बारहौं लोक बेद बिधि ।' गी० १.४.१२
बारा : बार। (१) समय । 'मरती बारा।' मा० ६.५८.५ (२) आवृत्ति । 'तदपि कही गुर बारहिं बारा ।' मा० १.३१.१ (३) अवसर । 'नारद श्राप दीन्ह एक बारा ।' मा० १.१२४.५ (४) विलम्ब । 'कहहु सो करत न लावउँ बारा।' मा०१.२०७.८
बारानसीं : वाराणसी में । 'बीसी बिस्वनाथ की बिसाद बड़ो बारानसीं ।' कवि०. ७.१७०
बारानसी : सं०स्त्री० (सं० वाराणसी)। काशी नगर । हनु० ४२
बारि : (१) सं०० (सं० वारि)। जल । मा० १.६ (२) सं०स्त्री० (सं. वाटी=वाटिका>प्रा. वाडी)। उपवन या छोटा खेत। 'बई बनाइ बारि बदाबन ।' कृ० २६ (३) खेत की रक्षा हेतु घेरा-दे० बारी। (४) (सं० बाला) तरुणी स्त्री। (५) पू० (सं० ज्वालयित्वा>प्रा. वालिअ>म. वालि)। जला कर । 'जारि बारि के बिधूम बारिधि बताइ लम।' कवि० ५.२६
बारिवाहि : वारिअहिं । मा० १.२२० (पाठान्तर)।
बारिक : वि० (फा० बारीक) । सूक्ष्म, महीन । 'है निर्गुन सारी बारिक बलि ।' कृ. ४१
बारिचर : सं+वि.पुं० (सं० वारिचर)। (१) जलचर, जलजन्तु । 'होइ. बारिचर बारि बियोगी।' मा० २.१६६.२ (२) मछली । कृ० २१
बारिचरकेतू : जलचरकेतु-मकरध्वज कामदेव । मा० १८४.६
बारिज : सं०० (सं० वारिज)। कमल । मा० २.३१७.६
बारिद : सं०० (सं० वारिद) । मेघ । मा० १.१६६.१
बारिखनाद : मेघनाद । मा० १.१८०.७
बारिद : बारिद-+कए । मेघ । 'बीरु बारिद जिमि गज्जत ।' कवि० ६.४७
बारिधर : सं०० (सं० वारिधर) । मेघ । मा० ६.७०.४
बारिधि : सं०० (सं० वारिधि) । समुद्र । मा० १.१४ ङ
बारिनिधि : बारिधि । मा० २.८६.३
बारिपुर : किसी गांव या नगर का नाम । कवि० ७.१३८
बारिये : वारिए । कवि० १.१२
बारी : (१) बारि। जल । 'बरहिं राम सुजस बर बारी।' मा० १.३६.४ (२) बाड़ी, घेरा (सं० वाटी>प्रा० वाड़ी) । रूधहु करि उपाउ बर बारी।' मा० २.१७.८ (३) (सं० बाला) तरुणी, स्त्री । (४) छोटा खेत या उपवन (वाटिका)। 'सिय सनेह बर बेलि बलित बर प्रेम बंधु बर बारी ।' गी० ७.१४.१ (५) सं०पु० । 'एक मानव जाति जो पत्तल बनाने आदि का काम करती है । 'नाऊ बारी भाट नट ।' मा० १.३१६ (६) भूकृ०स्त्री० । जला डाली। 'बारी बारानसी।' कवि० ७.१७२
बारीस, बारीसा : सं०० (सं० वारीश) । समुद्र । मा० ६.५; २८.२
बार : बार+कए । एक भी बाल । 'होइहि बारु न बाँक ।' रा०प्र० ६.३.४
बारुनि, बारुनी : संस्त्री० (सं० वारुणी) । मदिरा । मा० १.७०.१; १.१४ ख
बारू : (१) बालू । (२) बारु । दिन । 'ग्रह तिथि जोग नखत बर बारू ।' मा० १.३१२.६
बारें : क्रि०वि० । बरा कर, छोड़कर । 'बानर मनज जाति दुइ बारें।' मा० १.१७७.४
बारे : (१) सं०० ब० (सं० बालक>प्रा० बालय)। बच्चे, पुत्र । 'भआ कहह कुसल दोउ बारे ।' मा० १.२६१.४ (२) छोटे, बचकाने । 'बारे बारे बार बिलसत सीस पर ।' गी० १.१०.१ (३) (सं० बाल्य) बचपने, बाल्यावस्था । 'मानो बारे तें पुरारि ही पढ़ायो है ।'
बारेहि, बारेही : बचपने से ही । 'बारेहि तें निजहित पति जानी।' मा० १.१६८.३
बारो : सं००कए० (सं० बालः>प्रा० बालो) । छोटा बालक । कृ. १६ (२) पुत्र । 'केहरि-बारो।' हनु० १६
बाल : (१) सं०० (सं.)। १५ वर्ष के आसपास का बालक । 'बालके लि।' मा० १.१६८.२ (२) बालक। 'बाल बुझाए बिबिध बिधि ।' मा० १.६५ (३) अज्ञानी, मूर्ख । 'सो श्रम बादि बाल कबि करहीं।' मा० १.१४.८ 'कुलहि लजावें बाल ।' गी० १.६५.२ (४) अपरिपक्व, अल्पबुद्धि । 'बाल विनय सुनि।' मा० १.१४ ग (५) सुकुमार । 'बाल मराल कि मंदर लेहीं।' मा० १.२५६.४ (६) सं०स्त्री० (सं० बाला)। तरुणी, किशोरी स्त्री। 'पठयो है.."खवासु खासो कूबरी सी बाल को।' कवि० ७.१३५
बालक : सं०० (सं.)। (१) १५ वर्ष के आसपास वयस् वाला=बाल । १२) बच्चा, शिशु । 'जौं बालक कह तोतरि बाता।' मा० १.८.६ (३) पुत्र । 'रे नृप बालक ।' मा० १.२७१
बालकनि, न्ह, न्हि : बालक+संब० । बालकों। 'खेलउँ तहाँ बालकन्ह मीला।'  मा० ७.११०.४; ७.२८.४
बालकु : बालक+कए । मा० १.२७२.५
बालचंद्र : शुक्ल द्वितीया का चन्द्रमा । कवि० ७.१५६
बालचरित : बाललीला । मा० १.४०
बालदसा : बचपन (१५ वर्ष के आसपास वयस्) । विन० २६१.२
716
_______________________________________________

बालधि, बालधी : सं०स्त्री० (सं० वालधि) । पंछ । 'बालधि बंधाइ।' गी० ५.१६.४ कवि० ५.३, ४, ५
बालपतंग : उदयकाल का सूर्य । मा० १.२५४
बालपन : सं०पू० (सं० बालत्व>प्रा० बालत्तण>अ० बालप्पण) । बचपन । मा० १.३० क
बालपने : बाल दशा में । 'बालपने सूधे मन राम सनमुख भयो।' हनु० ४०
बालबिधु : बालचंद्र । मा० १.१०६
बालब्रह्मचारी : (दे० ब्रह्मचारी)-'बालश्चासो ब्रह्मचारी बालब्रह्मचारी।' वह पुरुष जो बालदशा में ही ब्रह्मविद्या और वेदों का ज्ञाता रहा हो। (बाल्यावस्था में वीर्य स्खलन की संगति न होने से यहाँ ब्रह्मचर्य का वीर्य रक्षा अर्थ नहीं है) 'बालब्रह्मचारी अति कोही।' मा० १.२७२.६
बालमीक, बालमीकि : सं.पु. (सं० वाल्मीक, वाल्मीकि)। रामायण के रचयिता आदि कवि । मा० १.३.३; १.३३०
बाला : सं०स्त्री० (सं०) । षोडषी कन्या, तरुणी । 'हे बिधि मिलइ कवनि बिधि बाला ।' मा० १.३१.८
बालार्क : (सं0--बाल-+अर्क) उदय लेता हुआ सूर्य । विन० २८.२
बालि : (१) सं०पू० (सं० वालि) । सुग्रीव का अग्रज वानर राज । मा० ४.१.५ (२) सं०स्त्री० (सं० वल्ली)। बाली=धान आदि की मञ्जरी जिसमें दाने पैदा होते हैं । 'फरइ कि कोदव बालि सुसाली।' मा० २.२६१.४५
बालिका : सं०स्त्री० (सं०) । बाला । लड़की, पुत्री । 'हिम-सैल-बालिका ।' विन०
बालिके : बालिका+संबोधन (सं०) । 'मातु भूमिधर-बालिके ।' कवि० ७.१७३
बालिस : वि० (सं० बालिश)। मूर्ख । 'बालिस बजावै गाल ।' गी० १.६५.२
बालिसो : बालिस+ सम्बोधन बहु० (अ. हे बालिस-हो) । ऐ मूर्यो । 'यही बल, ___बालिसो ! बिरोधु रघुनाथ सों।' कवि० ५.१३ ।।
बाली : बाली ने । 'तब बाली मोहि कहा बुझाई।' मा० ४.६.५
बाली : बालि । वानर-राज । मा० ४.६.३
बालु : (१) संस्त्री० (सं० वालु) । बालू, रेत । 'पुनि लाग बरष बालु ।' मा० ६.१०१.४ (२) बाल-+कए । बालक । (३) मूर्ख । 'अजहूं न छाड़े बालु गाल को बजावनो।' कवि० ५.१८
बालू : बाल । रेत । मा० ६.८१.७
बालेंदु : बालचंद्र (सं.)। मा० ७.१०८.६
बावन : बामन (अवतार) । दो० ३६४, ६५, ६६
बावनो : बावन भी, वामन भगवान् को भी। 'बड़ाई जित्यो बावनो।' कवि० ५.६ _______________________________________________
717

बावरि, बावरी : बाउरि । “सोइ बावरि जो परेखो उर आने ।' कृ. ३८ मा० २.२०१ छं०
बाबरें : बावरे ने, पागल ने (दे० बाउर) 'बावरें सुरारि बैरु कीन्हो राम राय सों।' कवि० ५.२४
बावरे : (१) सं०० (सं० वातुल चक्रवात>प्रा० वाउल =वाउलय)। बवंडर । 'पाप के प्रभाव को सुभाय बाय बावरे ।' हनु० ३७ (२) विक्षिप्त, पागल । 'मालवान रावरे के बावरे से बोल हैं ।' कवि० ५.२१
बावरो : (बाउर) बावर+कए० । पागल । बरेहु कलेस करि बरु बावरो।' पा०म० छं०६
बावौं : बाँवो (उपेक्षा)। लेहु अपनाइ अब देहु जनि बावौं।' विन० २०८.४ (२) प्रतिकूल । 'मो को आजु विधाता बावौं ।' गी० ३.६३.१
बास : सं०० (सं० वास) । (१) निवास (वस निवासे) । 'उचित बास हिम भूधर दीन्हे ।' मा० १.६५.८ (२) गन्ध (वस स्नेहे) । “ग्रहइ घ्रान बिनु बास असेषा।' मा० १.११८.७ (३) वासना (वास उपसेवायाम्) । (४) वस्त्र (वस आच्छादने)।
बासन : (१) सं०पू० (सं० वासन) । पात्र, बर्तन । लेहि न बासन बसन चोराई ।' मा० २.२५१.३ (२) वासना । 'निरखि बहु बासनहि ।' विन० २०६.२
बासना : सं०स्त्री० (सं० वासना)। (१) संस्कार, भावना । 'काम क्रोध बासना नसानी।' वैरा ६० (२) कामना । 'पूजी सकल बासना जी की।' मा० १.३५१.१ (३) विषय की भावना, भोगेच्छा । 'मन ते सकल बासना भागी।' मा० ७.११०.६ (४) विषयाकार मनोवृत्ति । 'उर कछ प्रथम बासना रही।' मा० ५.४६.६ (५) आराध्य से एकाकार चित्त-दशा, अखण्डाकार रति भावना। 'अचर चर रूप हरि सरबगत सरबदा बसत, इति बासना धूप दोर्ज।' विन० ४७.२
बासर : सं०० (सं० वासर)। (१) दिन (रात का विलोम)। 'निसि बासर ध्यावहिं ।' मा० १.१८६ छं० २ (२) दिन (सूर्योदय से दूसरे सूर्योदय तक) । जनकु रहे पुर बासर चारी।' मा० २.३२२.६ (३) दिन (रवि आदि) । सनि बासर बिश्राम।' रा०प्र० ७.२.२
बासरनि, बासरन्हि : बासर+संब० । दिनों (से)। 'निज बासरनि दिवस पुरवंगो बिधि ।' गी० ५.१७.२
बासरु : बासर+कए । एक दिन । 'सो बासरु बिन भोजन गयऊ।' मा० २.३२२.३
बासव : सं०० (सं० वासव) । देवराज इन्द्र । मा० २.१४१
718
_______________________________________________
बासा : बास । (१) निवास । 'भगत होहिं मुद मंगल बासा।' मा० १.२४.२ (२) निवास+गन्ध । 'इहां कहाँ सज्जन कर बासा ।' मा० ५.६.१
बासि : पू० । सुवासित करके, सुगन्ध से ओत-प्रोत करके । 'दै द सुमन तिल बासि के अरु खरि परिहरि रस लेत ।' विन० १६०.३
बासिन्ह : बासी+संब० । निवासियों। 'अवधपुरी बासिन्ह कर सुख संपदा समाज ।' मा० ७.२६
बासी : (समासान्त में) वि०पू० (सं० वासिन) । निवासी। 'जाति जीव जल थल नभ बासी ।' मा० १.८.१
बासु, बासू : बास+कए. । (१) निवास । 'दूतन्ह बासु देवाइ ।' मा० १.२६४ (२) गन्ध । 'लहसुनहू को बासु ।' दो० ३५५
बासुदेव : सं०० (सं० वासुदेव) । विष्णु, नारायण (वैष्णव मत की चतुव्यूह स्थापना में संकर्षण, प्रद्युम्न और अनिरुद्ध अंशों के ऊपर व्यापक परमात्मा बासुदेव है) । 'बासुदेव पद पंकरह दंपति मन अति लाग ।' मा० १.१४३
बासू : बासु । निवास । मा० १.३५२.७
बाह, बाहइ : (सं० वाहयति>प्रा० वाहइ) आ०प्रए । निर्वाह करता है। चलता-चलाता है । 'सपनेहूं नहीं अपने बर बाहै ।' कवि० ७.५६
बाहन : सं०० (सं० वाहन)। अश्व आदि सवारी का साधन । मा० १.६१
बाहनी : बाहिनी । मा० ६.५५.४
बाहर : बाहिर । कवि० ७.४४
बाहरी : वि० । बाहर की (ऊपरी) । 'रागिन में सीठ डीठि बाहरी निहारि हैं।' __कवि० १.२४०
बाहाँ : बांह । 'बैठारे रघुपति गहि बाहाँ ।' मा० २.७७.५
बाहिज : वि० (सं० वाह्य) । बाहरी, ऊपरी । 'बाहिज चिंता कीन्हि बिसेषी।' मा० ३.३०.१
बाहिनी : संस्त्री० (सं० वाहिनी)। (१) सेना (२) नदी । बिबिध बाहिनी बिलसति सहित अनंत । जलधि सरिस को कहै राम भगवंत ।' बर० ४२
बाहिर : बाहेर । दो० ४६
बाहिरो : (१) बाहिर । गी० ६.८.२ (२) वाह्य, वहिभूत । 'भगति बिहीन बेद ___ बाहिरो।' विन० २७२.३
बाही : बाँह । 'लोज गहि बाहीं ।' विन० १४५.५
बाहु : सं००+स्त्री० (सं.) । भुज। मा० १.१४७.७
बाहुक : सं० । बाहुपीडा (के अर्थ में) । हनु० ३६
बाहुदंड : दण्डसदृश सुदृढ भुज । कवि० ६.१
बाहू : बाहु । मा० १.६३.७ _______________________________________________
719
बाहेर : क्रि०वि० (सं० वहिः>प्रा० वाहिर) । बाहर (भीतर का विलोम) । मा० १.१११
बाहेरहूं : बाहर भी । 'तुलसी भीतर बाहेरहुं जौं चाहसि उजिआर ।' मा० १.२१
बाहैं : बाह+ब० । भुजाएँ । 'तुलसी बढ़ाई बादि साल तें बिसाल बाहैं।' कवि०
बाहै : बाहइ।
बिंग्य : वि० (सं० व्यङग्य) । व्यञ्जना शब्द शक्ति से आने वाला (अर्थ)। गूढ  आशय । विनोद पूर्ण । 'हरि के बिग्य बचन नहिं जाहीं।' मा० १.६३.३
बिंजन : सं०० (सं० व्यजन) । सालन, मुख्य भोजन में सहायक लवण युक्त खाद्य सामग्री । मा० १.१७३.२
बिंदक : वि०पू० । प्राप्त करने वाला । 'परम साधु परमारथ बिंदक।' मा० ७.१०५.४
बिंदु : सं०० (सं०) । (१) बूंद । 'रूप बिंदु जल होहिं सुखारी।' मा० २.१२८.७ (२) कण । 'कनक बिंदु दुइ चारिक देखे ।' मा० २.१६६.३ (३) बिंदी। पर मसि बिंदु बिराजत ।' गी० १.२२.६
बिंदुमाधव : काशी में प्राचीन विष्णमति (जिसके मन्दिर के स्थान पर अब ___ मस्जिद है जिसे 'माधव का धौरहरा' कहते हैं) । विन० ६१.१; ६२.१
बिंधि : बिंध्य । मा० २.१३८.८
बिंध्य : सं०० (सं० विन्ध्य)। भारत के मध्य का पर्वत विशेष । गी० २.४१.१
बिंध्याचल : बिंध्य । मा० १.१५६.४
बिंध्याद्रि : बिध्याचल । विन० ४३.४
बिंब : सं०० (सं.)। कुंदरू (फल विशेष) । विन० ५१.४
बिंबोपमा : वि० (सं० बिम्बोपम) । कुंदरू के समान । 'अधर बिंबोपमा ।' विन० ५१.४
बिआधि : सं०स्त्री० (सं० व्याधि)। रोग । मा० १.१७१.४
बिआनी : भक स्त्री. (सं० विजाता>प्रा. विआणी) । प्रसव किया, जन्म दिया। 'नतरु बांझ भलि बादि बिआनी ।' मा० २.७५.२ (यह क्रिया पशुओं के लिए ही प्रायः प्रयुक्त है।
विआहँ : विवाह में, से । 'एहि बिहे बड़ लाभु सुनचनी ।' मा० १.३१०.७
बिआह : सं०० (सं० विवाह>प्रा० विआह) । ब्याह, पाणिग्रहण संस्कार । मा० १.२४५.६
बिआहबि : भक०स्त्री० (सं० विवाहयितव्या>प्रा० विआहिअव्वी)। ब्याहनी (होगी), व्याही जायगी। 'सीय विआहबि राम ।' मा० १.२४५
720
_______________________________________________
बिआहा : (१) बिआह । 'करनबेध उपबीत बियाहा।' मा० २.१०.६ (२) बिआहइ । ब्याहता है, ब्याह सकता है। 'बिनु तोर को कुअरि बिआहा ।' मा० १.२४५.६
बिआहि : पूकृ० । ब्याह करके । 'भाइन्ह सहित बिआहि घर आए रघुकुल चंदु ।'  मा० १.३५० क
बिआही : भूक०स्त्री० । ब्याही गई। 'भंजि धनुष जानकी बिआही।' मा० ६.३६.११
बिआहु, बिआहू : बिआह+कए । मा० १.३१४; २६६.३
बिआहेसि : आ०-भकृ००+प्रए० । उसने विवाहित किये । 'पुनि दोउ बंधु ____ बिआहेसि जाई ।' मा० १.१७८.४
बिकट : विकट । (१) विकृत, कुरूप । 'बिकट बेष मुख पंच पुरारी।' मा० १.२२०.७ (२) भयानक । 'काटै बिकट पिसाच ।' मा० ६.६८ (३) दुर्जय, विशाल । 'देखि बिकट भट ।' मा० १.१७९.४ (४) कुटिल+सघन । 'भकुटी बिकट मनोहर नासा ।' मा० १.२४३.५ (५) गूढ, रहस्य । 'नट कृत विकट कपट खगराया।' मा० ७.१०४.८
बिकटानन : वि० (सं० विकटानन)। विकत भयानक मख वाला-वाले । 'बिकटानन बिसाल भयकारी।' मा० ५.५४.६
विकटासि : (१) सं०+वि.पु० (सं० विकटास्य-आस्य=मुख । भयानक मुख  वाला (२) एक वानर यूथप । मा० ५.५४
बिकटी : बिकट+स्त्री० । 'बिकटी भकूटी बड़री अखियां ।' कवि० २.१३
बिकरार, बिकरारा : वि० (सं० विकराल)। भयानक । 'नाक कान बिन भइ बिकरारा।' मा० १.१८.१
बिकराल : वि० (सं० बिकराल)। विषम, दुर्दान्त, क्रूर, भयानक, आतङककारी।  'प्रभु सनमुख भएँ नीच नर होत निपट बिकराल ।' दो० ३७५
बिकल : वि० (सं० विकल) । (१) कलाहीन, खण्डित, अंशत: अल्प (सकल का विलोम) । (२) व्याकुल, विक्लव, आर्त, व्यथित । 'बिरह बिकल नर इव रघुराई ।' मा० १.४६.७
बिकलई : बिकलता । 'प्रभु कत खेल सुरन्ह बिकलई ।' मा० ६.६४.३
बिकलतर : अधिक विकल । मा० ६.८४ छं.
बिकलता : विकलता । मा० ६.६.१
बिकलाई : बिकलइ । मा० ६.६१.५
बिकसत : वकृ०० । विकसित होते, खिलते। 'सबै सुमन बिकसत।' गी० १.१.१०
बिकसहि : आ०प्रब० (सं० प्रा० विकसन्ति>अ० विकसहिं) । खिलते हैं । 'मनहुँ कुमुद बिधु उदय मुदित मन बिकसहि ।' जा०मं० १९२
