_______________________________________________
821
भेंटे : भूकृ०० ब० । लिपटा लिये । 'भेंटे हृदय लगाइ ।' मा० ७.५
भेटेउ : भूकृ०पू०कए । लिपटा लिया । केवट भेटेउ राम ।' मा० २.२४१
भेट् यो : भेंटेउ । 'भेट्यो केवट उठि ।' विन० १३५.४
भे : भकृ००० (सं० भूत>प्रा० भविअ) । हुए । 'भगत सिरोमनि भे प्रहलादू ।' ___मा० १.२६.४
भेई : भूकृ०स्त्री० (सं० भेदिता>प्रा० भेइआ)। सराबोर, ओत-प्रोत । सरल सुभायें भगति मति भेई ।' मा० २.२४४.७
भेउ, ऊ : भेदु (अ.) । मर्म, रहस्य । मा० १.१३३ 'जौं जननी जानौं यह भेऊ।' मा० २.१६८.८
भेक : सं०० (सं.)। मेंढक । मा० १.३१.८
भेका : भेक । मा० ३.४४.३
भेट : भेंट । मिलन । मा० १.५७.२
भेटहिं : भेंटहिं । 'बहुरि बहुरि भेटहि महतारी ।' मा० १.३३४.८
भेटा : भेट । मुठभेड़ । 'कतहुँ होइ निसिचर मैं भेटा।' मा० ४.२४.१
भेटि : भेटि । मा० १.१०२.८
भेटी : भेंटीं। 'प्रभु सब मातु भेटी।' मा० ७.६ ई.
भेटे : भेटे । मा० ५.२६
भेटेउ : भेंटेउ । 'हरषि राम भेटेउ हनुमाना।' मा० ६.६२.१
भेट् यो : भेटेउ। विन० १४५.२
भेड़ी : संस्त्री० (सं०) । पशुविशेष =भेड़ । 'तुलसी भेड़ी को धंसनि जड़ जनता सनमान ।' दो० ४६५
भेद : सं०० (सं.)। (१) प्रकार, वर्ग । 'भाव भेद रस भेद अपारा ।' मा० १.६.१० (२) रहस्य, मर्म । 'बिभव भेद कछु कोउ नहिं जाना ।' मा० १.३०७.२ (३) अन्तर । 'ईस्वर जीव भेद ।' मा० ३.१४ (४) द्वेष । 'देखि मोहि जिय भेद बढ़ावा ।' मा० ४.६.१० (५) भेद नीति, कूट मीति में अन्यतम उपाय । 'साम दान भय भेद देखावा ।' मा० ५.६.३ (६) छिद्र', गुप्त दोष या दुर्बलता । 'भेद हमार लेन सठ आवा ।' मा० ५.४३.७ (७) परिवर्तन, मोड़, अङ्ग विक्षेप प्रकार (८) फूट, भेदनीति । 'भेद जहँ नर्तक नृत्य समाज ।' मा० ७.२२ (8) भेदन, फोड़ना, भङ्ग । 'सप्राबरन भेद करि ।' मा० ७.७६ ख (१०) द्वैत, जीव और ईश्वर में नितान्त पार्थक्य की भावना; एक ही तत्त्व से निर्मित पदार्थों को पृथक् समझने की प्रवृत्ति । 'मुधा भेद जद्यपि कृत माया ।' मा० ७.७८.८
822

भेदबुद्धि : जीव ब्रह्म का अंश है, ब्रह्म ही जगत का उपादान है अत: जड़-चेतन विश्व ब्रह्मरूप (राममय) है-यह 'अभेद बद्धि है; इससे भिन्न 'भेदबद्धि' है जो जीव और जगत् को ब्रह्म से पथक भासित कराती है तथा एक ही उपादान तत्त्व से बनी सृष्टि में विविधता लाती है। जागतिक भ्रम, घ्रान्त बुद्धि, विपर्यय, अज्ञान । 'तुलसिदास प्रभु मोहनित भ्रम भेद-बुद्धि कब बिसरावहिंगे ।' गी० ५.१०.५
भेदभगति : ऐसी भक्ति जिसमें अपने को आराध्य-लीन करने का संकल्प नहीं होता, प्रत्युत ब्रह्म के अंशरूप में पृथक सत्ता रख कर भक्त लीलादर्शन करता है। दास्य, वात्सल्य, माधुर्य तथा भ्रातृत्व भक्तियाँ इसी कोटि की हैं । यहाँ भक्ति चरम साध्य (परम पुरुषार्थ) मान्य है जब अभेद भक्ति में ब्रह्मलीनता ही चरम लक्ष्य रहता है- भक्ति उसका साधन है (शाङ र मत में अभेद भक्ति मान्य है) । 'तातें मुनि हरि लीन न भयऊ । प्रथमहिं भेद-भगति बर लयऊ।' मा०
भेदमति : भेदबुद्धि । 'तुलसिदास प्रभु हरहु भेदमति ।' विन० ७.५
भेदमाया : भेदबुद्धि लाने वाली व्यामोहिका माया जो जीव के साथ अज्ञान या अविद्या नाम से जानी जाती है (यह परमेश्वर की आदि शक्ति महामाया की अंश-सृष्टि है) । 'भक्ति अनवरत गत-भेदमाया ।' विन० १०.६
भेदा : भेद । मा० ७.११५.१३
भेदि : पूकृ० । भेदन कर, चीर कर । 'भेदि भुवन करि भानु बाहिरो तुरत राहु दे तावौं।' गी० ६.८.२
भेदु : भेद+कए । (१) एकमात्र अन्तर । सुनि गुन-भेदु समुझिहहिं साधू ।' मा० १.२१.३ (२) गुप्त रहस्य । 'बुझि न बेद को भेदु बिचारै ।' कवि० ७.१०४
भेदै : आ०प्रए । भेदन करे, फाड़ कर प्रवेश कर जाए। ऐसी बानी संत की जो ___ उर भेद आइ।' वैरा० २०
भेरि, री : सं०स्त्री० (सं०) । वाद्य विशेष, बड़ा ढोल या नक्कारा । मा० १.२६३.१; ६.३६.१०
भेवहिं : आ.प्रब० । भिगोते-ती हैं, ओत-प्रोत करते-ती हैं । देहिं गारि बर नारि मोद मन भेवहिं ।' पा०म० १३८
भेवहि : आ०-आज्ञा-मए । तू भिगो, ओत-प्रोत कर । भगति मन भेवहि ।" पा०म० २४
भेषज : सं०० (सं०) । दवा । मा० १.७ क
भैंसा : सं० पुं० (सं० महिष>प्रा० महिस) । मा० ६.७६.१
भै : भइ। हुई । 'चलत गगन भै गिरा सुहाई। मा० १.५७.४
_______________________________________________
823

भैआ, या : सं०पू० (सं० भ्रातक>प्रा० भाइअ) । (१) भ्राता, सहोदर, बन्धु । 'पगनि कब चलिही चारो भैया। गी० १.६.१ (२) मित्र । अतिहित बचन कहेउ बल भैया।' कृ० १६ (३) (स्नेह में) पुत्रादि । 'पितु समीप तब जाएहु भेआ ।' मा० २.५३.२ (४) (सम्मान में) सम्बोध्य व्यक्ति । 'भया कहह कुसल दोउ बारे ।' मा० १.२६१.४
भैख : सं०+वि०० (सं.)। (१) भयानक । (२) संहारकर्ता शङकर । कवि० ७.१५२ (३) शिव के रूप दण्ड भैरव (काशी में) । विन० ११.१
भैषज : भेषज । विन० ५७.६
भैषज्य : सं०५० (सं.)। भेषज विद्या में निपुण, चिकित्सक । विन० ५७.६
भैहै : भाइहै । रुचेगा । 'पैहैं मांगने जो जेहि भै है ।' गी० ५.५०.६
भोंड़े : वि०पू० (सं० भुण्ड -शूकर) सम्बोधन । सुअर, अभद्र । 'अभागे भोंड़े भागि रे ।' कवि० ५.६
भोंड़ो : वि.पु.कए । सुअर के समान भद्दा, अभव्य । 'नाम तुलसी 4 भोंड़ों भांग तें।' कवि० ७.१३
भो : भयो । हुआ । 'दूध दधि माखन भो।' कृ० १६
भोग, गा : सं०० (सं० भोग) । (१) सांसारिक सुख । 'जोग भोग महँ राखेउ गोई।' मा० १.१७.२ (२) कर्मफल-प्राप्ति । 'सकल सुकृत फल भूरि भोग से ।' मा० १.३२.१३ (३) कामक्रीडा I 'करहिं बिबिध बिधि भोग-बिलासा ।' मा० १.१०३.५ (४) आस्वाद । 'बिषय-भोग ।' मा० २.८४.८ (५) सुख सामग्री । कीन्ह बादि विधि भोग बिलासू ।' मा० २.११६.५ 'सक चन्दन बनितादिक भोगा।' मा० २.२१५.८ (६) विस्तार, व्याप्ति, वृत्त । दे० भूरिभोग। (७) सर्प का शरीर । 'भुजग भोग भुजदण्ड ।' विन० ६२.८
भोगावति : सं०स्त्री० (सं० भोगावती)। पाताल में शेषनाग की नगरी । मा० १.१७८.७
भोगी : वि.पु. (सं० भोगिन्) । (१) खाने वाला। 'द्विजामिष-भोगी।' मा० ६.४५.३ (२) भोगने वाला, आस्वादकर्ता । 'सकल रस भोगी।' मा० १.११८.६ (३) विलासी, विषयी : समुझि कामसुख सोहिं भोगी। मा० १.८७.८
भोग, गू : भोग+कए० । 'और पाव फल भोगु ।' मा० २.७७; ७४.२
भोगौघ : (भोग+ओघ) भोग समूह । विन० ५६.६
भोजन : सं०पु० (सं.)। (१) खाने की क्रिया । मा० १.१६८.६ (२) खाद्य सामग्री। 'भप गयउ जहँ भोजन खानी ।' मा० १.१७४.६ (३) भोज्य के चार प्रकार-चव्यं, चूष्य, लेह्य और पेय। 'चारि भांति भोजन बिधि गाई।' मा० १.३२६.४
824
_______________________________________________
भोजनु : भोजन+कए । 'करि भोजनु बिश्रामु ।' मा० १.२१७.४
भोर : सं००। (१) प्रभात । 'बड़े भोर भूपति मनि जागे ।' मा० १.३३०.३ (२) भूल-भटक, भ्रम । 'कीदहुं रानि कोसिलहि परिगा भोर हो ।' रा० न० १२ (३) वि०पू० (सं० भोल)। मुग्ध, भोला । 'बिसरि गयउ मोहि भोर सुभाऊ ।' मा० २.२८.२
भोरा : भोर । भूल चूक । 'तिन्ह निज ओर न लाउब भोरा ।' मा० १.५.१
भोरानाथ : भोलानाथ । (१) शिव । कवि० ७.१५६ (२) शिवावतार-हनुमान् । हन० ३४
भोरि, री : वि०स्त्री। भोली, मुग्ध, भ्रान्त । 'नारि बिरहँ मति भोरि ।' मा० १.१०८; ६.६.१
भोरु, रू: भोर+कए० । सबेरा । मा० २.३७.२, ८६.१
भोरें : भूल में, अनजान में । “चहत न भरतु भूपतहि भोरें।' मा० २.३६.१
भोरे : (१) वि.पुं०ब० । मुग्ध, बेसुध । 'लोग भए भोरे ।' मा० २.२५५.४ (२) भ्रान्त । 'सब भए मगन मदन के भोरे ।' गी० ३.२.५ (३) क्रि०वि० । भोरें। भूल कर । 'ता की सिख ब्रज न सुनगो कोउ भोरे ।' कृ० ४४ (४) भोलेपन में । 'भोरानाथ भोरे ही सरोष होत ।' हनु० ३४
भोरेहुं, हु : भूल में भी। 'भोरेखें भरत न पेलिहहिं मनसहं राम रजाइ ।' मा० २.२८६
भोरो : भोरा+कए । भोला । 'दानि है बावरो भोरो ।' कवि० ७.१५३
भोलानाथ : (१) (सं० भोलनाथ) मुग्ध (निरपेक्ष+अनजान) लोगों में श्रेष्ठ= शिव । (२) शिवावतार हनुमान् । हनु० ४३
भौं : सं०स्त्री० (सं० भ्रू-प्रा० भमुहा) । भौंह । रा०न० ८
भौंतुवा : सं०पू० । जल प्रवाह में तैरने वाला एक काला कीड़ा । विन० २२९.३
भौंर : भवर । (१) आवर्त, प्रवाह चक्र । 'कलिकालहिं कियो भौंतुवा भौंर को हौं।' विन० २२६.३ (२) चकरी, चरखी। 'झरकत मरकत भौंर ।' गी० ७.१६.३
भौंरा : भौंर । एक प्रकार का खिलोना (लट) जो नचाने पर ध्वनि करता है। ____ खेलत अवधखोरि, गोली भौंरा चकडोरि ।' गी० ४३.३
भौंह : भौं । मा० २.११७.६
भौंहैं : भौंह+ब० । भवें, भ्रुकुटियाँ । 'कुटिल भइँ भौंहैं।' मा० १.२५२.८
भौ : भो । हुआ । 'भो न मन बावौं ।' विन० ७२.३
भौतिक : वि० (सं.)। त्रिविध क्लेशों में अन्यतम (दे० दैविक, अधिभूत)। ___ 'दैहिक दैविक भौतिक तापा ।' मा० ७.२१.१
भौन : भवन+भुवन । पति पठए सुर-भोन ।' गी० २.८३.१
825
भौम : सं०पू० (सं०) । भूमिपुत्र=मङ्गल ग्रह । 'कंज दलनि पर म नहुं भौन दस बैठे।' गी० १.१०८.२
भौमबार : मङ्गलवार (सप्ताह का एक दिन)। मा० १.३४.५
भ्रम : (१) संपु० (सं.)। विपर्यय ज्ञान, मिथ्याबोध । मा० १.३१.८ (२) संसार तथा देहादि को सत्य मानना । 'अनुभव सुख उतपति करत भव भ्रम धरै उठाइ।' वैरा० २० (३) अनिश्चय। 'चकित भए भ्रम हृदय बिसेषा ।' मा० १.५३.१ (४) आ०प्रए० । (सं० भ्रमति)। भटकता है, भ्रमण करता रहता है । 'लोलुप भ्रम गृहपसु ज्यों जहँ तहँ ।' वि० ८६.३ (५) गोस्वामी जी ने जगत् के विषय में (रामानुचार्य के अनुसार) तीन भ्रम माने हैं (क) सांख्य में प्रकृति को तथा चार्वाकमत में महाभूतों को सत्य माना जाता है । (ख) बौद्ध तथा शाङकर मत जगत्प्रपञ्च को असत् (मिथ्या) मानते हैं । (ग) न्यायदर्शन परमाणु, आकाश, काल, दिक, आत्मा और मन को नित्य मानता तथा स्थूल पृथ्वी, जल, तेज और वायु को अनित्य कहता है। तीनों से पथक मत है कि सम्पूर्ण प्रपञ्च नित्य परमेश्वर का अंश होने से नित्य है तथा देहादि संसार अनित्य है। 'कोउ कह झूठ सत्य कह कोऊ उभय प्रबल कोउ मान । तुलसिदास परिहरै तीनि भ्रम सो आपन पहिचाने।' विन० १११.४
भ्रमत : वकृ.पु । घूमते, भटकते, भ्रान्त होते । 'भव पंथ भ्रमत ।' मा० ७.१३.२
भ्रमति : वकृ०स्त्री० | चकराती । 'भ्रमति बुद्धि अति मोरि ।' मा० १.१०८
भ्रमबात : सं.पु० (सं० भ्रमवात) । चक्रवात, बवंडर । कवि० ६.३७
भ्रमबारि : मृग बारि । मृगमरीचिका । विन० १३६.२
भ्रमर : सं+वि.पु. (सं.)। भ्रमणशील+भौंरा । गी० ७.६.३
भ्रमहिं, हीं : आप्रब० । घूमते हैं, चकराते हैं । 'बालक नहि न भ्रमहिं गृहादी।' मा० ७.७३.६ (२) उब० । हम घूमते हैं, गतागत करते हैं । 'करमबस भ्रमहीं।' मा० २.२४.५
भ्रमाहीं : भ्रमहीं । 'हरिमाया बस जगत भ्रमाहीं।' मा० १.११५.६
भ्रमि : पूकृ. । भटक कर, चक्कर खाकर । 'मैं खगेस भ्रमि भ्रमि जग माहीं...... जनमेउ ।' मा० ७.६६.८
भ्रमित : वि० । भ्रम युक्त । 'भयउँ भ्रमित मन मोह बिसेषा ।' मा० ७.८२.८
भ्रमु : भ्रम+कए । अनिश्चय । मा० २.६६.२
भ्रष्ट : वि० भकृ० (सं.) । पतित, नष्ट । मा० १.१८३ छं०
भ्राज, भ्राजइ : आ०प्रए० (सं० भ्राज दीप्तो)। शोभित होता है, प्रकाशमान है। 'भ्राज बिबधापगा आप पावन परम ।' विन० ११.३ 'तरुण रबि कोटि तन तेज भ्राज ।' विन० १०.२
826
_______________________________________________
भ्राजत : वकृ०० । विराजता, शोभा बिखेरता। भ्राजत भाल तिलक गोरोचन ।' मा० ७.७७.५
भ्राजति : वकृ.स्त्री० । शोभा बिखेरती । 'कुंकुम रेख भाल भलि भ्राजति ।' गी० ७.१७.१५
भ्राजमान : वकृ०वि० (सं.)। विराजमान, प्रकाशमान । विन० ५१.५
भ्राजहिं, हीं : आ०प्रब० । प्रकाशमान हैं, शोभा बिखेरते हैं। मा० ७.२७.८
भ्राजा : (१) भ्राजइ। 'कुंडल मकर मुकुट सिर भ्राजा।' मा० १.१४७.५ (२) भूक००। शोभित हुआ। 'दूसर तेज पुज अति भ्राजा। मा० १.३०१.८
भ्राजी : भूकृ.स्त्री० । शोभित हुई । 'रमा प्रगटि त्रिभवन भरि भ्राजी।' कृ० ६१
भ्राजै : भ्राजइ । 'तिलक भाल भ्राज ।' विन० ६३.७
भ्रात, ता : भाई । मा० १.२२४; ७.२.१२
भ्रातन, न्ह : भ्रात+संब० । भाइयों। 'राम करहिं भ्रातन्ह पर प्रीती।' मा० ७.२५.३
भ्रुकुटि, टी : भकुटी (सं.)। भौंह, भौंहों की वक्रता । जा०म० ५१
भ्रुकुटिन्ह : भृकुटि+संब० । भौंहों। तैसिये लसति भृकुटिन्ह की नवनि ।' गी० ३.५.३
भ्रुकुटिया : भ्रुकुटि (सं० भ्रकुटिका)। गी० १.३२.५
भ्रू : सं०स्त्री० (सं०) । भौं । मा० ७.१०८.७
भ्रूबिलास : भ्रूभङ्ग, भृकुटिनर्तन । मा० ७.७२.२
## म
मँगि : माँगि । 'बिधि मनाइ मगि लीजै ।' गी० ३.१५.२
मँझारि : मझारी । में, मध्य । 'राजसभा मॅझारि ।' विन० २१४.४
मँदोई : मंदोदरि (अ० मंदोअरि)। कवि० ५.१०।।
मंगन : वि०पू० (सं० मार्गण>प्रा. मग्गण) । याचक । मा० १.२३१.८
मंगल : (१) सं०० (सं.)। कल्याण । :मंजल मंगल मोद प्रसूती।' मा० १.१.३ (२) माङ्गलिक वस्तु । दे० मंगलन्हि । (३) विवाहादि शुभ कार्य । दे० मंगलु । (४) भीमग्रह । 'मंगल मंगलमूल ।' रा०प्र० १.१.३ (५) वि० । कल्याणमय, शुभ । 'जग मंगल भल काजु बिचारा ।' मा० २.५.७
मंगलकारी : वि.० (सं०) । कल्याण कर, शुभ । मा० १.३६.४
मंगलगान, ना : माङ्गलिक अवसर (विवाहादि) के उत्सव गीत । मा० १.३५५.१%; ६९.३
मंगलचार : सं०० (सं०) । माङ्गलिक कार्यकलाप । मा० १.२६३
मंगलदाइ, ई : वि०० (सं० मंगलदायिन्) । शुभप्रद । विन० ७.३३.१
मंगलदाता : मंगलदाई। मा० २.२१७.५
मंगलदायक : मंगलदाता । मा० २.१३७.५
मंगलनिधि : कल्याणकर, मङ्गल से परिपूर्ण । मा० १.३५०.३
मंगलन्हि : मंगल+सब० । मंगल द्रव्यों (से) । 'कनक थार भरि मंगलन्हि ।' मा० १.३४६
मंगलमइ, ई : मंगलमय+स्त्री० (सं० मङ्गलमयी) । कल्याणपूर्ण । पा०म० छं० २
मंगलमय : वि.पु० (सं०) । कल्याणपूर्ण । मा० १.२.७
मंगलमूरति : मङ्गल की मूर्ति, साकार मङ्गल । मा० २.२४६.४
मंगलमूल, ला : मङ्गल का जनक । मा० २.२.५; २५९.३
मंगलरूप : साकार मङ्गल । मा० ४.१३.५
मंगला : संस्त्री० (सं०) । दुर्गा, पार्वती। पा०म०छं० २
मंगलागार : मंगलनिधि । विन० २७.१
मंगलाचरे : (मंगल+आचरे) मङ्गलाचार किये, मङ्गल प्रदान किये । 'भज्यो भवजाल परम मंगलाचरे ।' विन० ७४.४
मंगलायतन : मंमलागार । मा० १.३६१
मंगलालय : मंगलागार । विन० २६.१
मंगलु : मंगल+कए । अद्वितीय शुभकर्म । 'एकु यहु मंगल महा।' मा० १.३२५ छं०१
मंच : सं०० (सं०) । उच्चासन, बैठने का उत्तम आसन । मा० १.२५४
मंचन्ह : मंच+संब० । मंचों। 'सब मंचन्ह तें मंचु एक सुंदर सुखद बिसाल ।'  मा० १.२४४
मंचु : मंच+कए । अनोखा मंच । मा० १.२४४
मंजरि, री : सं०स्त्री० (सं.)। छोटे फूलों का लम्बा गुच्छा।' मा० १.३४६.५ 'तुलसी मंजरी।' रा०प्र० ३.४.७
मंजरिय : मंजरी (सं० मञ्जरिका>प्रा. मंजरिया>अ० मंजरिय)। कवि० ७.११५
828
_______________________________________________
मंजीर : सं०० (सं.)। (१) नूपुरवर्ग का पादाभरणविशेष। 'मंजीर नूपुर कलित कंकन ।' मा० १.३२२ छं० (२) कटिभूषणविशेष । 'कटितट रट मंजीर ।' गी० ७.२१.११
मंजु : वि० (सं.)। सुन्दर, स्वच्छ, पावन, उत्तम । मा० १.७.११
मंजुतर : वि० (सं०) । अति सुन्दर । 'गुज मंजतर मधुकर श्रेनी ।' मा० २.१३७.८
मंजुल : मंजु (सं०) । मा० १.१.३
मंजुलताई : सं०स्त्री० (सं० मञ्जलता) । सुन्दरता । 'कंज की मंजुलताई हरै।' कवि० १.३
मंडन : सं०पुं० (सं०) । (१) अलंकरण । 'सिरनि सिखंह सुमन दल मंडन ।' गी० १.५६.५ (२) वि००। अलंकृत करने वाला। 'सब बिधि कुसल कोसला मंडन ।' मा० ७.५१.८
मंडप : सं०० (सं.)। वितान । मा० १.१०० छं०
मंडपहिं : मण्डप में । एहि बिधि राम मंडपहिं आए ।' मा० १.३१६.८
मंडप : मंडप+कए । मा० १.३२६.२
मंडल : सं०० (सं.)। (१) विस्तृत गोलाकर क्षेत्र । 'नभ मंडल ।' मा० ३.१८.१० (२) घेरा, वृत्त । 'रबि मंडल ।' मा० १.२५६.८ (३) विशाल क्षेत्र । 'अवनिमंडल ।' मा० १.१५४.८ (४) गोलाकार, वृत्ताकार । 'पुनि नभ धनु मंडल सम भयऊ ।' मा० १.२६१.६ (५) समूह (६) प्रान्त, भाग, स्थल । 'गंडमंडल ।' गी० ७.४.३
मंडलिहि : मंडली (समूह) को। 'मुनि मंडलिहि जनक सिरु नावा।' मा. १.३४१.१
मंडलीं : मण्डली (समूह) में । 'खल मंडली बसह दिन राती।' मा० ५.४६.५
मंडली : सं० स्त्री० (सं०) । चक्र, वर्ग, समूह । 'अपर मंच मंडली बिलासा ।' मा० १.२२४.४
मंडलीक : सं०पू० (सं०)। सामन्त, राजा । 'मंडलीक मनि रावन ।' मा० १.१८२ क
मंडलु : मंडल+कए । 'परब उदधि उमगेउ जनु लखि बिधु मंडलु ।' पा०म० १०२
मंडि : प्रकृ० । मण्डित करके, व्याप्त करके । 'मंडि मेदिनी को मंडलीक लोक लोपिहैं।' कवि० ६.१
मंडित : भूकृ०वि० (सं०) । सुसज्जित, अलंकृत (प्रसिद्ध)। 'सोइ महि मंडित पंडित दाता ।' मा० ७.१२७.१
_______________________________________________
829
मंतु : सं०० (सं० मन्तु)। मन्तव्य, सम्मति । 'मैं जो कहीं कंत, सुनु मंतु ।' कवि० ६.१८
मंत्र : सं०० (सं०)। (१) जप योग्य शब्द । 'जोग जुगुति तप मंत्र प्रभाऊ ।' मा० १.१६८.४ (२) गुप्त विचारणा । 'तापस नृप मिलि मंत्र बिचारा ।' मा० १.१७०.७
मंत्रराजु : मंत्रराज+कए० । एक मात्र श्रेष्ठ मन्त्र-राम नाम । मा० २.१२६.६
मंत्रिन्ह : मंत्री+संब० । मन्त्रियों। मंत्रिन्ह सहित ।' मा० ४.५.३
मंत्रिहि : मन्त्री को । 'मंत्रिहि राम उठाइ प्रबोधा।' मा० २.६५.२
मंत्री : सं०पू० (सं० मन्त्रिन्) । राजा को उचित सम्मति देने वाला पदाधिकारी। सचिव । मा० २.५.४
मंत्रु : मंत्र+कए । एक मात्र मन्त्र (विचार) ! 'चले साथ अस मंत्रु दृढाई ।' मा० २.८४.७
मंथरा : संस्त्री० (सं.) । कैकेयी की एक दासी । मा० २.१२
मंद : (१) वि.पु. (सं०) । नीच, अधम । मा० १.१३७.२ (२) दुष्ट । 'मंद यह बालकु।' मा० १.२७४.१ (३) निकृष्ट, विकृत । 'रूप धरहिं बहु मंद।' मा० ५.१० (४) अनिष्ट, प्रतिकूल । 'मंद करत जो करइ भलाई ।' मा० ५.४१.७ (५) धीमा, शनैः गति करने वाला । 'सीतल मंद सुरभि बह बाऊ ।' मा० १.१६१.३ (६) सुस्त, दीर्घसूत्री, विलम्ब से चेतने वाला। 'अहह मंद मन अवसरु चूका।' मा० २.१४४.६
मंदतर : अधिक मन्द । मा० ७.१२१.११
मंदमति : वि० (सं.)। क्षुद्र बुद्धि । मा० १.६४.६
मंदर : सं०पू० (सं०) । (१) पर्वत विशेष जिसे मथान बनाकर समुद्र मंथन किया गया था। मा० ६.७३.७ (२) पर्वत । 'गहि मंदर बंदर भाल चले।' कवि०
मंदरु : मंदर+कए । 'मंदरु मेरु कि लेहिं मराला ।' मा० २.७२.३
मंदा : मंद । मा० २.६२.५
मंदाकिनि, नी : सं०स्त्री० (सं० मन्दमकति गच्छतीति मन्दाकिनी)। (१) चित्रकटः में नदी विशेष । मा० २.१३२.६ (२) गङ्गाजी। विन० ४६.५
मंदात्म : वि० (सं० मन्दात्मन्) । मलिनचित्त, दुष्ट । विन० ५५८
मंदि : मंद+स्त्री० । नीच, दुष्टा । 'मातु मंदि मैं साधु सुचाली।' मा० २.२६१.३
मंदिर : सं०० (सं.)। (१) भवन, प्रासाद । ‘मंदिर मंदिर प्रति करि सोधा ।" ___ मा० ५.५.५ (२) देवालय । 'मंदिर माझ भई नभ बानी ।' मा० ७.१०७.१
मंदिरनि, न्ह : मंदिर+संब० । मन्दिरों (पर)। 'कपि भाल चढ़ि मंदिरन्ह ।' मा. ६.४१ छं.
830

मंदिराजिर : भवन का भीतरी आँगन । गी० ७.१६.१
मंदिराम : वि० (सं.)। मन्दिर के समान । 'रचित इंद्र मंदिराभ ।' गी० १.२५.२
मंदिरायत : (मन्दिर+आयत) गृह रचना के अनुसार लम्बाई में अधिक । 'सुन्दर ___ मनोहर मंदिरायत अजिर ।' मा० ७.२७ छं.
मंदेहि : मन्द को । 'मंदेहि भल करहू ।' मा० १.१३७.२
मंदोदरि, री : सं०स्त्री० (सं० मन्दोदरी)। रावण की पटरानी। मा० १.१७८.२,
मंदोदरी : मन्दोदरी ने । 'मंदोदरी रावनहि बहुरि कहा समझाइ ।' मा० ६.३५ ख
मइके : सं०० अधिकरण (सं० मात के>प्रा० माइक्के) । मैके में, नहर में । मा० २.९६
मइत्री : संस्त्री० (सं० मंत्री>प्रा० मइत्ती)। मित्रता । गीध मइत्री पुनि तेहि गाई।' मा० ७.६६.१
मई : (१) मय (प्रत्यय) स्त्री० । एक रूप, अभिन्न । 'मम मूरति महिदेव मई है।' विन० १३६.२ (२) पूर्ण, व्याप्त । 'रीति कृपा-सीलमई है।' गी० २.३४.१
मकर : सं०० (सं.)। (१) एक नक्षत्र राशि जिस पर उत्तरायण होकर सूर्य माघ में आता है । 'माघ मकरगत रबि जब होई ।' मा० १.४४३ (२) मगर, घड़ियाल-जल जन्तु विशेष । 'संकुल मकर उरग झष जाती।' मा० ५.५०.६ (३) एक प्रकार का मत्स्य (जिसके आकार के कुण्डल बनते हैं) । 'कुंडल मकर मुकुट सिर भ्राजा।' मा० १.१४०.५
मकरंद, दा : सं०पू० (सं० मकरन्द) ! पुष्परस-मधु । मा० ७.५१.२, १.२३१
मकरंद : मकरंद+कए । 'मकरंदु जिन्ह को संभु सिर ।' मा० १.३२४ छं० २
मकरीं : मकरी (स्त्री मगर) ने । “पद गहा मकरी ।' मा० ६.५७
मकु : अव्यय (सं० माकिम्, भकिम् )। (१) न कि; क्यों न । 'दुइ के चारि मागि मकु लेहू।' मा० २.२८.३ (२) चाहे कि; संभवतः, हो सकता है कि । 'गगुन मगन मकु मेघहि मिलई ।' मा० २.२३२.१
मख : सं०० (सं०) । यज्ञ । मा० १.६०
मखपाल : यज्ञ का रक्षक । विन० ४३.३
मखबिधि : यज्ञ-विधान, यज्ञ क्रिया। मा० १.२७.३
मखभूमि : यज्ञभूमि, यज्ञ का पण्डाल । गी० १.८१.२
मखसाला : (सं० मखशाला) यज्ञ गृह, यज्ञ मण्डप । मा० १.२२५.५
मखु : मख-+कए । यज्ञ । 'मख राखिबे के काज ।' कवि० १.२१
मग : सं०० (सं० मार्ग)। (१) पथ । 'सती दीख कौतुक मग जाता।' मा० १.५४.४ (२) रीति, पद्धति, आचार । 'चलहिं कुपंथ वेद मग छोड़े।' मा० १.१२.२ (३) रन्ध्र द्वार । 'सकिलि श्रवन मग चलेउ सुहावन ।' मा० १.३६.८ (४) (सं० मगध) मगध देश । 'कासी मग सुरसरि मनासा ।' मा० १.६.८ (५) बीच, अन्तराल, मध्य ।
मगजोगु : वि.पु.कए० (सं० मार्ग योग्यम>प्रा० मग्गजोगं>अ. मग्गजोग्गु) । मार्ग चलने योग्य । 'मगजोगु न कोमल क्यों चलि हैं।' कवि० २.१८
मगता : वि०पू० (सं० मार्गयित)। भिखारी, याचक । 'सब जाति कुजाति भए मगता।' मा० ७.१०२.८
मगन : वि० (सं० मग्न)। डूबा हुआ। (१) डुबकी लगाए हुए। 'तहँ मगन मज्जसि ।' विन० १३६.२ (२) तल्लीन। 'फिरत सनेहें मगन सुख अपनें ।' मा० १.२५.८ (३) प्रसन्न । 'बीथिन्ह फिरहिं मगन मन भूले।' मा० २.१९६.५ (४) अन्तभूत, अन्त:प्रविष्ट । 'गगनु मगन मकु मेघहिं मिलई ।' मा० २.२३२.१
मगनु : मगन+कए० । मग्न, प्रसन्न । 'भा मनु मगनु ।' मा० २.१६७.४
मगबास : मार्ग में रुकना, मार्ग का विश्राम या विश्रामस्थल । 'ओध तजी मगबास के रूख ज्यों ।' कवि० २.१
मगबासी : मार्ग के पास रहने वाले । मा० २.२२१
मगहँ : मगध देश में । 'मगहें गयादिक तीरथ जैसे।' मा० २.४३.७
मगह : सं०० (सं० मगध>प्रा० मगह)। महाजनपद-विशेष । 'तीरथहू को नाम भो गया मगह के पास ।' दो० ३६२
मगाइ : पू० । मंगा कर । 'मंगलद्रव्य मगाइ.. सिरु नायउ आइ ।' मा० ७.१० ख
मगाई : भकृस्त्री०ब० । आनीत करायीं । 'धेन मगाई।' मा० १.३३१.२
मगाई : भक०स्त्री० । आनीत करायी । 'नाव मगाई।' मा० २.१५१.३
मगाए : भूक००ब० । आनीत कराये। 'कंद मूल फल मधुर मगाए।' मा० २.१२५.३
मगावत : वकृ०० । मंगाता, मँगाते। 'गज रथ तुरग मगावत भयऊ।' मा० ७.५०.३
मगावा : भूकृ.पु । मंगाया। 'बट छीर मगावा ।' मा० २.६४.३
मगु : मग+कए । मार्ग । 'सकल कहहिं मगु दीख हमारा ।' मा० २.१०६.४
मगे : वि०० (सं० मग्न>प्रा० मग्न =मग्गय) । डूबे हुए। 'महेस आनंद रंग मगे।' पा०म०ई० ११
मघवा : सं०० (सं० मघवन्) । इन्द्र । मा० २.३०१
मघवान : मघवा । 'सदस स्वान मघवान जुबान । मा० २.३०२.८
मघा : सं०स्त्री० (सं.)। नक्षत्रविशेष (जिस पर सूर्य वर्षा में होता है)। मा० ६.७३.३

मचत : वकृपु (सं० मचमान-मच कल्कने-कल्कनं दम्भः शाठ्यं च>प्रा. __मच्चंत) । मचता-सघनता के साथ आडम्बरपूर्वक हो रहा । गी० ७.१६.४
मचला : भूकृ.पु । मचल गया, हठ कर बैठा (बच्चों के समान लोट गया)। 'हौं मचला ले छोडिहौं, जेहि लागि अर्यो हौं ।' विन० २६७.३
मचलाई : सं०स्त्री० । मचल, बचकाना हठ । 'सागर सन ठानी मचलाई।' मा० ५.५६५
मचा : भूकृ०० (सं० मचित>प्रा० मच्चिअ) । मच गया, व्याप्त हुआ । 'सब लंक ससंकित सोरु मचा।' कवि० ६.१५ ।।
मची : भूकृस्त्री० । मच गयी, लगातार हो चली । मा० १.१९४.८
मच्छर : मत्सर (प्रा०) । 'लोभ मोह मच्छर मद माना ।' मा० ५.४७.१
मजा : सं०पू० (सं० मज्जन - मज्जा- हड्डी के भीतर का सार)। वृक्षादि के भीतर के सार से बना हुआ वर्षा का फेन जो मछली के लिए विषाक्त होता है । 'दीन मलीन छीन तनु डोलत, मीन मजा सों लागे।' कृ. ३५
मजूरी : संस्त्री० (फा० मज्दूरी) । दैनिक पारिश्रमिक पर सेवावत्ति । मा० २.१०२.६
मज्जत : वकृ०० (सं० मज्जत् >प्रा० मज्जत) । डुबकी लगाता-ते । 'मज्जत पय पावन पीवत जलु ।' विन० २४.५
मज्जन : सं०० (सं०) । डुबकी, स्नान । मा० १.३.१
मज्जनु : मज्जन+कए । 'सोइ सादर सर मज्जन करई ।' मा० १.३६.६
मज्जसि : आ०मए० (सं० प्रा०) । डुबकी लेता है, तू नहाता है । 'तहं मगन मज्जसि पान करि ।' विन ० १३६.२
मजहि : आ०प्रब० (अ०) । डुबकी लेते हैं, नहाते हैं । 'मजहिं सज्जन बृद बहु पावन सरजूनीर ।' मा० १.३४
मज्जा : सं०स्त्री० (सं०) । अस्थि-सार; हड्डी के भीतर का पीला सत्त्व ।' मा०. ६.८७
मज्जि : पू० (अ०) । बुड़की लेकर, नहाकर । 'मकर मज्जि गवनहिं मुनिबृदा ।" मा० १.४५.२
मज्जित : भूकृ०वि० (सं०) । डुबाया हुआ । 'बिनु अवगुन कुकलास कूप मज्जित कर गहि उधर्यो ।' विन० २३६.३
मझारी : क्रि०वि० (सं० मध्ये>प्रा० मज्झआरे>अ० मज्झआरि) । में, मध्य में, बीच में । 'कदि परा कपि सिंधु मझारी।' मा० ५.२६.८
मटुकी : सं०स्त्री० (सं० मटची, मातिकी)। मृत्पात्र, मिट्टी का घड़ा या विशेष प्रकार की गगरी। कृ० ४०
मठी : सं०स्त्री० (सं.)। मठ, आगार, आवास । गी० १.५.३
_______________________________________________
833
मड़रानी : भूकृ०स्त्री० । मण्डलाकार उड़ी। 'छमकरी-मंडल के मड़ रानी ।' गी० ६.२०.३
मढ़ : सं०० (सं० मठ>प्रा० मढ) । मकान । कवि० ६.१०
मढ़ि : पूक० (सं० मठित्वा>प्रा० मढिअ>अ० मढि) । मढ़कर, आवृत कर । ____ 'कमठ खपर मढि खाल निसान बजावहिं ।' पा०म० ६६
मढ़ी : (१) मठी (प्रा.)। (२) भूक स्त्री । आवत । 'मंगल मोद मढ़ी मुरति ।' गी० १.५.३
मढ़े : भूक००ब० (सं० मठित>प्रा० मढिय)। आच्छादित । 'मढ़े स्रवन नहिं सुनत पुकार ।' गी० ५.१८.२
मढ़ेहौं : आ०भ० उए । मढ़ाऊँगा-गी; आवृत कराऊँगा-गी । 'सोने चोंच महौं।' ___ गी० ६.१६.२
मणि : मनि (सं.)। भूमिपाल मणि ।' विन० ३६.१
मणे : मणि+सम्बोधन (सं०) । विन० २६.१ ।।
मत : सं०० (सं०) । (१) विचार । 'मोरें मत बड़ नाम दुहूंतें।' मा० १.२३.२ (२) सिद्धान्त । 'बेद पुरान संत मत एह ।' मा० १.२७.२ (३) प्रस्ताव । 'मातु पितहि पुनि यह मत भावा ।' मा० १.७३.२ (४) मन्त्रणा । 'राम मातु मत जानब रउरें।' मा० २.१८.२ (५) दर्शन, पन्थ । दार्शनिक मान्यता । 'निर्गुन मत नहिं मोहि सोहाई ।' मा० ७.११०.१६ (६) गुप्त-अभिमत । 'मार खोज लं, सौंह करि, करि मत लाज न त्रास ।' दो० ४०६ (७) निश्चित अभिप्राय । राखति प्रान बिचारि दहन मत ।' गी० ५.६.३
मतंठा : सं०० (सं०) । हाथी । कवि० ७.४४
मतवारे : वि.पु.ब. (सं० मत्त>प्रा० मत्त=मत्तवाल)। मदिरा पीकर मतवाले, नशे में धुत्त । 'जिमि मद उतरि गएँ मतवारे ।' मा० १.८६.३ .
मति : सं०स्त्री० (सं.) । मनन शक्ति । (१) बुद्धि, अन्तःकरण की निश्चयात्मक प्रज्ञा । 'लघु मति मोरि चरित अवगाहा।' मा० १.८.५ (२) अन्त:करण, चित्त । 'चाहत उठन करत मति धीरा।' मा० १.१६३.४ (३) विचार, समझ, सूझ-बूझ । 'मति हमारि असि देहि सुहाई।' मा० १.२४६.३ (४) कल्पना शक्ति । 'दंभिन्ह निज मति कल्पि करि ।' मा० ७.६७ क (५) अव्यय (सं० मा+इति>प्रा० मत्ति) । मत, नहीं । 'अस बिचारि मति सोचहि माता ।' मा० १.६७.६
मतिगति : बुद्धि की चाल, प्रज्ञा की पहुँच । 'जब अंगदादिन की मति-गति मंद __भई ।' कवि० ४.१
मतिधीर, रा : स्थिर बुद्धि वाला, स्थित निश्चयी, स्थिर प्रज्ञ । मा० १.१८५; ५३.२
834
_______________________________________________
मतिबिलास : बौद्धिक कल्पना, तर्क-विस्तार । 'अपनिहि मतिबिलास अकास मह चाहत सिर्यान चलाई।' कृ० ५१
मतिभ्रम : बुद्धि की चकराहट, अन्यथा प्रतीति, उलटा बोध, अयथार्थ प्रत्यय । ___हरहु नाथ मम मतिभ्रम भारी।' मा० १.१०८.४
मतिमंद : बुद्धि में मन्द, क्षुद्रबुद्धि, विवेक में शिथिल बुद्धि वाला। मा० १.४६
मतु : मत+कए । अद्वितीय सिद्धान्त । 'तात धरम मतु तुम्ह सबु सोधा ।' मा० २.६५.२
मतें : मत में, मन्त्रणा से । 'रहइ न नीच मतें चतुराई।' मा० २.२४.८
मते : (सं० पद) । (१) मत में, मन्त्रणा में (सम्मिलित) । 'मातु मते महुँ मानि मोहि ।' मा० २.२३३ (२) (गुप्त मन्त्रणा के योग्य) एकान्त में। 'नृपहि मते सब कहि समुझावा।' मा० १.१७२.८ (३) मत+ब० । मान्यताएँ । 'बुध किसान, सर बेद, निज मते खेत, सब सींच।' दो० ४६५ ।।
मतेई : संस्त्री० (सं० मातका =धात्री) । (१) धाय। (२) विमाता (उपमाता)। ____ 'काय मन बानीहूं न जानी के मतेई है।' कवि० २.३
मतो : मत। (१) अभिमत, सम्मति । 'सुनहि रावन मतो।' कवि० ६.२० (२) मान्यता, सिद्धान्त । एतो मतो हमारो।' विन० १७४.४
मत्त : वि० (सं०) नशे में धुत्त, मतवाला+सुधबुध भूला हुआ । 'रन मद मत्त फिरइ जग धावा ।' मा० १.१८२.६ (२) लीन+मदयुक्त । 'गुंजत मंजु मत्त रस भृगा।' मा० १.२१२.७ (३) मदयुक्त, मदजल बहाने वाला+मतवाला। 'मत्त मंजु बर कुंजर गामी ।' मा० १.२५५.५
मत्त-करि : मद बहाता हुआ मतवाला हाथी; मदकल । विन० ५६.७
मत्तेभ : (मत्त+इभ) मत्तकारी । मा० ६ श्लोक १
मत्वा : पू० (सं०) । मानकर, विचार करके । मा० ७.१३० श्लोक १
मत्सर : सं० (सं.) । दूसरे की उन्नति से अकारण द्वेष = ईर्ष्या (परसंताप) । मा० ३.४४.३
मथ मथइ : आ०प्रए० (सं० मथति-मथ विलोडने) । मथता है, मथे । 'मर्थ पानि पंकज निज मारू ।' मा० १.२४७.८
मथत : वक००। (१) मथता-ते। 'मानहुं मथत पयोनिधि बिपुल अपसराजूथ ।' गी० ७.२१.२० (२) मथते समय । 'मथत सिंधु रुद्रहि बौरायहु ।' मा० १.१३६.८
मथन : वि०पुं० । मथने वाला। (१) मानमर्दनकारी। 'हर गिरि मथन निरखु मम बाहू।' मा० ६.२८.८ (२) विनाशक । 'कलिमल मथन नाम ।' मा. ७.५१.६
मथहिं : आ.प्रब० । मथते हैं । 'महिं सिंधु दुइ मंदर जैसें।' मा० ६.४५.८
_______________________________________________
835
मथा : भूकृपु । मथ डाला (मसल-कुचल कर रख दिया)। 'सभा माझ जेहि तव बल मथा।' मा० ६.३७.३
मथानी : संस्त्री . (सं० मन्थानी) । मथने का उपकरणविशेष । मा० ७.११७.१५
मथि : पू० । मथ कर (बिलोकर)। 'सब मथि काढ़ि लेइ नवनीता।' मा० ७.११७.१६
मथुरा : सं०स्त्री० । नगरीविशेष ।।
मथें : मथने से । 'बारि मथे बरु होइ घृत ।' मा० ७.१२२ क
मथे : मथें । 'बृथा."घत हित मथे पाथ।' विन० ८४.२
मथै : मथइ । 'मुदितां मथै बिचार मथानी ।' मा० ७.११७.१५
मथ्यो : भूकृ००कए० । मथ डाला। 'जलनिधि खन्यो मध्यो बंध्यो।' गी०
मद : सं०० (सं.)। (१) मद्य, सुरा । 'जिन्ह कृत महामोह मद पाना ।' मा० १.११५.८ (२) मद्य का नशा । 'जिमि मद उतरि गएँ मतवारे।' मा० १.८६.३ (३) अहंकार । 'लोभ मोह मच्छर मद माना।' मा० ५.४७.१ (४) अहंकार+नशा । 'धन मद मत्त परम बाचाला ।' मा० ७.६७.३ (५) युवा हाथी के कान आदि के पास बहने वाला सुगन्धित द्रव । 'झूमत द्वार अनेक मतंग जंजीर जरे मद अंबु चुचाते ।' कवि० ७.४४
मदन : सं०० (सं.) । (१) कामदेव । मा० १.८५.५ (२) मोम । दे० मन ।
मदनमोहन : कामदेव को मोहने वाला । गी० २.१६.१
मदनारी : (सं० मदनारि) कामशत्रु =शिवजी। मा० ७.५५.२
मदनार्क : (मदन+अर्क) कामदेव तथा सूर्य । विन० ६०.२
मदनु : मदन+कए । अकेला कामदेव । तेहि पर चढ़ेउ मदनु मन माखा ।' मा० १.८७.१
मदपान : मद्य-पान । मा० २.१४४
मदमोचन : अहंकार रूपी नशा दूर करने वाला । गी० २.३६.३
मदहीन, ना : गर्व रूपी नशे से रहित। 'सावधान मानद मदहीना।' मा० ३.४५.६
मदा : मद । मा० ७.१४.१३
मदातीत : अभिमानरहित, निरहंकार। विन० ५६.६
मदादि, दिक : मद इत्यादि =षड्वर्ग । मा० ३.४ छं०; ७.११७ घ
मदिरा : सं०स्त्री० (सं०) । सुरा। मा० ६.६४.१
मदु : मद+कए । 'तजि इरिषा मदु कोहु ।' मा० १.२६६
मदोदरी : मंदोदरी। हनु० २७
836
_______________________________________________
मधु : सपु० (सं.)। (१) पुष्परस, मकरन्द । 'गुजत मधुपनि कर मधु लोभा। मा० ४.१३.१ (२) शहद । 'देति मनहुं मधु माहुर घोरी।' मा० २.२२.३ (३) मिठास । 'जनक बचन मृदु मंजु मधु भरे।' गी० १.६५.५ (४) मधुर । 'मधु सुचि सुंदर स्वादु सुधासी।' मा० २.२५०.१ 'अंगद संमत मधु फल खाए।' मा० ५.२८.७ (५) मद्य, मदिरा । 'मनि भाजन मधु ।' दो० ३५१ 'प्रेम मधु छाके हैं।' गी० १.६४.२ (६) वसन्त ऋतु । 'जनु मधु मदन मध्य रति लसई।' मा० २.१२३.३ (७) चैत्रमास । 'नौमी भोमबार मधमासा । मा० १.३४.५ (८) सृष्टि के आदिकाल में (कैटभ का अग्रज) असुर विशेष । 'अतिबल मधु कैटभ जेहिं मारे ।' मा० ६.६.७ (९) त्रेतायुग में एक राक्षस जो मधु वन में रहता था और शत्रुघ्न द्वारा मारा गया।
मधुकर : सं०० (सं.)। (१) भ्रमर । मा० २.१३७.८ (२) मधुमक्षिका तद्यथा मक्षिका मधुकर-राजानमुत्क्रामन्तं सर्वा एवोत्क्रामन्ते, तस्मिश्च प्रतिष्ठ माने सर्वा एव प्रातिष्ठन्त । (प्रश्नोपनिषद् २.४) । मधुकर सरिस संत गुन ग्राही।'
मधुकरी : सं०स्त्री० (सं.)। उपलों की आग पर सेंकी जाने वाली आटे की गोल बाटी । 'मागि मधुकरी खात जे। दो० ४६४
मधुकरु : मधुकर-+कए० । एकाकी भ्रमर । पति पद कमल मनु मधुकरु तहाँ ।'  मा० १.१०० छं०
मधुप : सं०० (सं०) । (१) मधु (पुष्परस) पीने वाला=भ्रमर । मा० १.१७.४ (२) मदिरा पीने वाला+भ्रमर । 'संभु सुक मुनि मधुप प्यास पदकंज मकरंद मधुपान की।' विन० २०९.४
मधुपर्क : सं०पू० (सं०)। दधि, घृत, शर्करा, मधु और जत्न का विशेष मिश्रण (जो विवाह के पूर्व वर के स्वागत में अर्पित किया जाता है)। मा० १.३२३. छं० १
मधुपान : मधु (पुष्प रस+मदिरा) का पीना । दे० मधुप ।
मधुपुरी : सं०स्त्री० (सं०) । मथुरा नगरी जिसमें पहले सधु राक्षस रहता था जो रामानुज शत्रुघ्न द्वारा मारा गया (इसका प्राचीन नाम 'मधुरा' था)। कृ०४७
मधुबन : सं०पुं० । (१) सुग्रीव (बाली) का रक्षित वन । मा० ५.२६.१ (२) त्रेता में मधु नामक राक्षस का वन, जिसकी नगरी मधुरा (मथुरा) थी। (३) मथुरा नगरी। 'अब नंदलाल गवन सुनि मधुबन ।' कृ० २५
मधुर : वि० (सं०)। (१) मीठा । 'सुचि फल मूल मधुर मृदु जानी।' मा० २.८६.८ (२) सुस्वादु । 'जो मन भाव मधुर कछु खाइ।' मा० २.५३.१ (३) सरस, प्रिय, रुचिकर । 'तिन्ह कहुं मधुर कथा रघुबीर की।' मा० १.६.६. (४) स्वर योजना में हृदय ग्राही । ‘गारी मधुर स्वर देहि ।' मा० १.६६ छं. (५) द्रुति लाने वाला-ली; हृदय द्रावक । 'प्रभु हँसि दीन्ह मधुर मुसुकानी ।' मा० १.२०१.८ (६) माधुर्य (काव्य गुण) से युक्त । 'कहि मृदु मधुर मनोहर बचना ।' मा० १.२२५.३
मधुरतर : अतिशय मधुर । विन० ५१.५
मधुरता : स० स्त्री० (सं०) । माधर्य-मिठास, सरसता, स्वादिष्ठता आदि । मा० १.३६.६
मधुराधर : (मधुर-+अधर) सुन्दर सरस ओष्ठ । 'पुट सूखि गए मधुराधर वै ।' कवि० २.११
मध्य : सं०+वि.पु. (सं.)। (१) देश-सीमा का केन्द्र । 'मध्य मंडप ।' मा० १.१०० छं० (२) काल सीमा का बीच। 'संबत मध्य ।' मा० १.१७४.३ (३) आदि और अन्त का बीच । 'नहिं तब आदि मध्य अवसाना ।' मा० १.२३५.७ (४) मझला-छोटे-बड़े के बीच का। 'नारि पुरुष लघु-मध्य बड़ेरे ।' मा० २.३१६.८ (५) उदासीन-जो न शत्रु हो न मित्र । 'बुझि मित्र अरि मध्य गति ।' मा० २.१६२ (६) भीतर । 'बसहु मध्य तुम्ह जीव असंका।' मा० ६.३४.३ (७) में । 'छबि ललना गन मध्य ।' मा० १.३२२
मध्य दिवस : (१) मध्याह्न (२) सम दिवस । 'मध्य दिवस अति सीत न घामा।' मा० १.१६१.२
मध्यम : वि० (सं.)। (१) बीच का, अन्तरालवर्ती । 'उत्तम मध्यम नीच लघु ।' मा० १.२४० (२) उदासीन-जो शत्र या मित्र न हो । 'हित अनहित मध्यम।' मा० २.६२.५
मन : सं०० (सं० मनस)। (१) अन्तःकरण, चित्त । 'जन मन मंजु मुकुर मल हरनी।' मा० १.१.४ (२) चित्त की संकल्प-विकल्प वृत्ति। 'मन मति रंक मनोरथ राऊ।' मा० १.८.६ (३) मनोभाव, भावना । 'राम भगत तुम्ह मन क्रम बानी ।' मा० १.४७.३ (४) अन्तःकरण चतुष्टय में अन्यतम । दे० बुद्धि । (५) विराट तत्त्व के सन्दर्भ में समष्टि मनस् । मा० ६.१५ क
मनक : सं०० (सं० मण =मणक) । चालीस सेर की तौल तथा उस तौल की वस्तु । 'रतिन के लालाचन प्रापति मनक की।' कवि० ७.२०
मनकाम : सं०० (सं० मन:काम) । मनोरथ, इच्छा । मा० २.१०५
मनकामना : संस्त्री० (सं० मन:कामना) मनकाम। मा० २.१०३
मनजात : सं० पु. (सं० मनोजात) मनोज । कामदेव । मा० ३.३७
मनतेउँ : क्रियाति०० उए । तो मैं मानता। पिता बचन मनतेउँ नहिं ओह ।' मा० ६.६१.६
मननशीला : वि०पू०ब० (सं० मननशीलाः) । मनीषी, चिन्तन परायण । 'शंभु सनकादि मुनि मननशीला ।' विन० ५२.१
838
_______________________________________________
मनपर : मन से परे, मन से अज्ञेय, अतीन्द्रिय । मा० ७.१३ छं०६
मनभंग : सं०० (सं० मनोभङ्ग) । (१) मन की टूटन, साहस का टूट जाना । (२) वदरिकाश्रम के मार्ग का एक पर्वत (जो पथिक के मनोबल को तोड़ देता है) । 'मान मन भंग, चितभंग मद, क्रोध लोभादि पर्बत दुर्ग ।' विन० ६०.६
मनभाई : मनचाही, मनोवाञ्छित । गी० ५.२६.३
मनभाए : मनचाहे । 'भए सकल मनभाए।' गी० ६.२२.४
मनभायो : (दे० भायो) । मनचाहा । 'कीजै नाथ उचित मनभायो।' विन० २४४.५
मनभावत : वि.पु । मन को भावित करने वाला, मनचाहा । तुम सौं मनभावत पायो न के।' कवि० ७.३८
मनभावति, ती : मनभावत+स्त्री० । मनचाही । 'बिहसि मागु मनभावति बाता।' मा० २.२६.७; १.३०८.६
मनभावतो : मनभावत+कए । मनचाहा। 'मनभावतो धेन पय स्रवहीं । मा० ७.२३.५
मनभावा : भूकृ.पु । मनोनुकूल, मनचाहा । मा० २.२७.२
मनमथ : मन्मथ । कामदेव । विन० २६.३
मनमय : (दे० मय) मनरूपी+मनोमय कोश (पाँच ज्ञानेन्द्रिय+मन) अन्त:-- करण । 'तुल सिदास मनमय मारग में राजत ।' गी० २.३६.३
मनमानी : वि.स्त्री० । मनचाही । कृ० ४६
मनमोदक : मनोराज । मा० १.२४६.१
मनमोहनी : वि० स्त्री० । मनों को मुग्ध करने वाली । गी० १.३४.५
मनरंजन : वि.पु.। मन को रंगने (अनुरक्त करने) वाला । 'मनरंजन रंजित अंजन नैन ।' कवि० १.१ ।।
मनसहिं : मनसा (इच्छा) में, भावना में । 'प्रभु मनसहि लय लीन मनु ।' मा०
मनसहुं, हु : मनसा से भी, भावना में भी । 'भोरेहुं भरत न पेलिहहं मनसहं राम रजाइ।' मा० २.२८९
मनसा : (१) संस्त्री (सं० मनस्या)। इच्छा, भावना । जिमि परद्रोह निरत मनसा के ।' मा० ६.९२.४ (२) (सं०) मन से । 'मनमा बिस्व बिजय कह चीन्ही ।' मा० १.२३०.२
मनसि : (सं०) मन में । ‘बसत मनसि मम कानन चारी ।' मा० ३.११.१८
मनसिज : सं०० (सं.)। मन में जन्म लेने वाला=कामदेव । मा० १.८५
मनसिजु : मनसिज+कए० । मा० १.३१६ छं०
_______________________________________________
839
मनस्वी : वि०० (सं० मनस्विन) । उदात्त मन वाला, दढ़ व्रत, स्थितप्रज्ञ, ज्ञानी, सतर्क, निपुण । विन० ५५.४
मनहरनी : वि०स्त्री० । मन को हरने वाली । गी० १२८.३
मनहारी : वि०पू० (सं० मनोहारिन्) मनोहर । गी० २.५४.२
मनहिं, हीं : मन में । 'तदपि मनाग मनहिं नहिं पीरा । मा० १.१४५.४ 'मनहीं मन __महेसु मुसुकाहीं।' मा० १.६३.३
मनहि : मन को । 'एहि प्रकार बलु मनहि देखाई। मा० १.१४.१
मनहुं : (१) मन भी, मन से भी, मन में भी । 'तुलसी प्रभु गयो चाहत मनहुं तें ।' कृ० ४३ । (२) उत्प्रेक्षार्थक अव्यय । मानों। 'ससि समाज मिलि मन हुं सुराती।' मा० १.१५.६
मनहु : मनहुँ । मानों। मा० ६.२३ ङ
मनहूं : मनहुं । मन में भी। 'जो मनहूं न समाइ।' मा० ७.८० क
मना : मन । 'सुनहि संतत सठ मना ।' मा० ५.६० छं०
मनाइ : पूक (सं० मानयित्त्वा>प्रा० मणाविअ>अ० मणावि) । मना कर । (१) अभ्यर्थना करके । 'कहहिं मनाइ महेसु । मा० २.१ (२) उत्सव आदि मान कर, अनुभव कर । 'लोचन आँजहिं फगुआ मनाइ ।' गी० ७.२२.७
मनाइऐ : आ०कवा०प्रए । मनाया जाय । 'जो परि पार्य मनाइऐ।' दो० ४३०
मनाइबे : भक०० । मनाने, मनुहार करने । 'भरत मनाइबे को आवत हैं ।' गी० २.४१.२
मनाइबो : भक०कए०। मनाना, प्रार्थनापूर्वक अनकल करना। 'इनको भलो मनाइबो।' दो० ४६०
मनाई : मनाइ । प्राथित कर । 'मागहि हृदय महेस मनाई।' मा० २.१५७.८
मनाए : भूक०० ब० । प्रार्थित किए। 'नर नारिन्ह सुर सुकत मनाए।' मा० १.२६०.३
मनाक : अव्यय (सं० मनाक्) । जरा सा, थोड़ा सा भी। औत पावै न मनाक सो।' कवि० ५.२५
मनाकु : मनाक+कए । (विशेषणात्मक प्रयोग)। तुच्छ । जेहि हरगिरि कियो है मनाकु ।' गी० १.८६.२
मनाग : मनाक (सं० मनाग) । तदपि मनाग मनहिं नहिं पीरा।' मा० १.१४५.४
मनाय : मनाइ । रा०प्र० ४.३.६
मनाये : मनाए । प्रार्थना करने से । 'देवता मनाये अधिकाति है।' हनु० ३०
मनाव, मनाव : (१) आ० प्रए० (सं० मानयति>प्रा० माणावइ)। (२) (प्रा० मण्णावइ)। मनीती करता-ती है, अनुरोध करता-ती है-+समझाता ती है। 'मनहीं मन मनाव अकुलानी ।' मा० १.२५७.५ 'सुर मनाव धरि धीर ।' मा० १.२५७
मनावउँ : आ० ए० (सं० मानयामि-मान पूजायाम् >प्रा० माणावामि>म. माणावउँ)। पूजता हूं, प्रार्थित करता हूं । 'ता के जुग पद कमल मनावउँ ।' मा० १.१८.८
मनावत : वकृ०० । प्राथित करता-करते । 'अहनिसि बिधिहि मनावत रहहीं।' मा० ७.२५.२
मनावति : वकृ०स्त्री० । मनाती, कामना करती। 'बैठी सगुन मनावति माता ।' गी० ६.१६.१
मनावन : भकृ० अव्यय । मनाने, अनुरोध करने । 'रामहि भरतु मनावन जाहीं।' मा० २.१६२.६
मनावहिं, हीं : आ.प्रब० । (१) चाहते हैं । 'भरत आगमनु सकल मनावहिं ।' मा० २.११.२ (२) सोचते या कल्पित करते हैं । 'बिघन मनावहिं देव कुचाली।' मा० २.११.६ (३) प्रार्थना करते हैं। 'सकल सिवहि मनावहीं।' जा०म०/०७
मनि : सं०स्त्री० (सं० मणि)। (१) रत्न । मा० १.१.८ (२) सर्प मणि। 'फनि मनि सम निज गुन अनुसरहीं।' मा० १.३.१० (३) गजमुक्ता । 'सिंधुर मनिमय सहज सुहाई।' मा० १.२८८.७ (४) कौस्तुभ नामक रत्न । 'आपु रमा मनि चारु।' मा० १.१३६ (५) मणि के समान श्रेष्ठ (शिरोमणि)। . 'मंडलीक मनि रावन ।' मा० १.१८२ क
मनिअत : मानिअत । माना जाता, संमान पाता। 'तुलसी-सो जग मनिअत महामुनि-सो।' कवि० ७.७२
मनिआरा : (१) वि.पु. (सं० मणिकार>प्रा० मणिआर)। मणियों को गढ़ने बनाने वाला । (२) (सं० मणि+आकर>प्रा० मणि आर)। मणियों खानों से युक्त । 'गिरिगन मनिआरा ।' मा० १.१६१.४
मनिकर्णिका : सं० स्त्री० (सं० मणिकणिका)। काशी में गङ्गाजी का श्मशान घाट विशेष+तीर्थविशेष । विन० २२.५
मनिगन : विविध मणि-समूह । मा० २.१.४
मनिजटित : मणियों से गुम्फित । गी० ७.१६.३
मनिजाला: (१) मणिसमूह (२) मणियों की जाली। 'पदिक हार भषन मनि. - जाला ।' मा० १.१४७.६
मनिदीप : मणि का दीपक (जो कभी न बुझे और न तले अंधेरा ही हो)। मा० १.२१
_______________________________________________
841
मनिमंदिर : मणिजटित अथवा मणिरचित भवन (जिसमें सब ओर प्रतिबिम्बन हो) । मा० १.३५६.३
मनिमय : वि० (सं० मणिमय)। (१) मणि जटित । 'मनिमय रचित चारु चौबारे।' मा० १.६०.८ (२) मणि निर्मित । ‘बेन हरित मनिमय सब कीन्हे ।' मा० १.२८८.१ (३) मणिरूप । 'दीप मनोहर मनिमय नाना ।' मा० १.२८६.३
मनिहार : मणियों का हार, रत्नहार । मा० १.१६६.६
मनिमाल : मणियों की माला । 'मंजु बनी मनिमाल हिएँ ।' कवि० १.२
मनियत : मनिअत । विन० १८३.१
मनियाँ : मनि+ब । मणियाँ । 'कठुला कंठ मंजु गजमनियाँ ।' गी० १.३४.३
मनिहैं : मानिहैं>मानिहहिं । मानेंगे । 'भगत सिरोमनि मनिहैं।' विन० ६५.३
मनी : (१) मनि । 'चहं पास बनि गजमनी ।' गी० ७.५.६ (२) सं०स्त्री० (सं० मणी = अजागलस्तन)। बकरी के गले में लटकते स्तनाकार मांसखण्ड के समान निरर्थक विषयाभिमान । 'होय भलो अजहूं गये रामसरन परिहरि मनी ।' गी० ५३६.६
मनु : (१) सं०० (सं.)। मानव जाति के आदि पुरुष । मा० १.१४८.६ (२) मन+कए । 'भा मनु मगनु मिले जनु रामू ।' मा० २.१६७.४ (३) मनहुँ । मानों। 'नासिक कीरबचन पिक सुनि करि संगति मनु गुनि रहति बिचारी।' कृ० २२
मनुज : सं०० (सं०) ! मन-सन्तति =मानव, मनुष्य । मा० १.४६.१
मनुजमनुसृत्य : मनुष्यचरित का अनुसरण करके । विन० ५०.५
मनुजा : मनुज। मा० ७.१०२ छं०
मनुमात : मनुज । (सं०) ।
मनुजाद, दा : वि०+सं०० (सं० मनुज+आद) । मनुष्य भक्षी, राक्षस । मा०
७.३६: ६.३३.६ .
मनुजैर् : (सं०) मनुष्यों द्वारा । विन० ५५.८
मनुष्य : मनुज (सं०) । मा० ५ श्लो० १
मनुसाई : सं०स्त्री० (सं० मनुष्यता) । पौरुष, वीरता। 'मुएहिं बधे नहिं कछु ___ मनुसाई ।' मा० ६.३१.१।
मनुहारि, री : सं०स्त्री० (सं० मन्यहारिका-?>प्रा० मण्णुहरिमा>अ० मण्णुहारी=मण्णुहारि) । दूसरे के रोषादि को दूर करने की क्रिया; अनुनय विनय । “पठवत नपन को मनुहारि ।' गी० ७.२६.२ 'क्यों सौंप्यो सारंग हारि हिय करी है बहुत मनुहारी।' गी० १.१०६.४
842
_______________________________________________
मने : वि० (अरबी--मन)। वजित । रोका गया। 'जानि नाम अजानि लीन्हें नरक सुरपुर मने ।' विन० १६०.३
मनो : मनहुँ। मानों। 'स्याम सारस जुग मनो ससि सवत सुधा सिंगारु।' कृ० १४
मनोगति : (१) सं०स्त्री० (सं०) । मनोदशा । 'दुबिध मनोगति प्रजा दुखारी।' मा० २.३०२.६ (२) वि० । मन के समान तीव्र गति से युक्त --- अतिवेगशील । 'तीर्ख तुरंग मनोगति चंचल ।' कवि० ७.४४
मनोज : मनसिज (सं०) । मा० १.५०.३
मनोजनि : मनोज+संब० । कामदेवों (को)। 'लाल कमल जनु लालत बाल मनोजनि ।' जा०म० ६४
मनोभवँ : कामदेव ने । 'मनहं मनोभवं फंद संवारे।' मा० १.२८६.१
मनोभव : मनोज (सं.) । कामदेव । मा० १.८६ छं०
मनोभूति : मनोभव (सं.)। मा० ७.१०८.५
मनोमल : सं०० (सं.)। मन के मल (१) मायिक मल-अज्ञान । (२) कार्ममल = शुभाशुभ कर्म-वासना । 'आस पिआस मनोमल हारी।' मा० १.४३.२
मनोरथ : सं०० (सं.)। मनरूपी रथ =अभिलाष । मा० १.८.६
मनोरथ : मनोरथ+कए । एक मात्र इच्छा । 'मोर मनोरथ जानहु नीके।' मा०. १.२३६.३
मनोरम : वि० (सं०) । मन को रमाने वाला=मनोहर । मा० १.३७.३
मनोराजु : (दे० राजु) मनोराज्य, दिवास्वप्न, असंभव कल्पनाओं से मन को मिथ्या सुख देने की क्रिया (मन ही मन राजा बनने की प्रवृत्ति)। 'मनोराज करत अकाजु भयो आजु लगि ।' कवि० ७.६६
मनोहर : वि० (सं.)। मन को हरने वाला, मोहक, सुन्दर । मा० १.१५.१
मनोहरता : सुन्दरता से, में । 'मनोहरता जिति मैनु लियो है। कवि० २.१६
मनोहरता : सं०स्त्री० (सं०) ! सुन्दरता, मनोमोहकता । मा० १.२४१.१
मनोहरताई : मनोहरता । मा० १.४०.८
मनोहरताउ : मनोहरता भी। 'निपट असमंजसह बिलसति मुख मनोहरताउ ।' गी० ७.२५.४
मनोहरतैया : मनोहरता । गी० १.६.३
मनोहरायत : (१) मनोहर तथा चौड़ा (विशाल)। 'मनोहरायत उर।' मा० ६.८६ छं० (२) आयताकार-लम्बाई के अनुपात में चौड़ाई वाला तथा सुन्दर । 'बापी तड़ाग अनूप कूप मनोहरायत सोहहीं।' मा० ७.२६ छं.
_______________________________________________
843
मनौ : मनहुँ । मानों । 'रावन कहें मनो चुनौती दीन्ह ।' मा० ३.१७
मन्मय : सं०० (सं०) । कामदेव ।
मन्मथारी : (सं० मन्मथारि)। कामशत्र =शिव । मा० ७.१०८.१२
मन्यु : सं०पु० (सं.)। रोष, अमर्ष । विन० ५७.५
मम : सर्वनाम (सं.)। (१) मेरा-मेरी-मेरे । 'सोइ मम इष्टदेव रघबीरा ।' मा. १.५१.८ (२) ममता (अपने पराये का भाव), नश्वर जागतिक विषयों के प्रति अपनेपन की बुद्धि । 'अहमम मलिन जनेषु ।' मा० २.२२५
ममता : संस्त्री० (सं.)। (१) आत्मीयता, मेरेपन की भावना जो स्नेह, कृपा आदि से होती है-सात्त्विक निजत्व । 'जेहि जन पर ममता अति छोहू ।' मा० १.१३.६ (२) राग, विषयों के प्रति राजस-तामस स्वत्व भावना । 'ममता केहि कर जस न नसावा ।' मा० ७.७१.२ ।।
ममताहन : (दे० हन)। आसक्ति मूलक ममत्व बुद्धि का नाशक । मा० ७.५१.६
मम्ले, मम्लौ : आ० भूतकाल-प्रए० (सं०) । मुरझाया, कुम्हलाया। मा० २ श्लो० २
मय : मयदानव ने । 'सोइ मय दीन्हि रावनहि आनी ।' मा० १.१७८.३
मय : (क) सं०पू० (सं.)। एक दानव = मन्दोदरी का पिता। मा० १.१७७.६ (ख) प्रत्यय । (१) विरचित । 'अमिअ मूरिमय ।' मा० १.१.२ (२) पूर्ण, ओत-प्रोत । ‘मोहिमय जग देखा।' मा० ३.१६.३ (३) एकरूप, तद्रूप, अभिन्न.। 'बिधि हरि हरमय बेदप्रान सो।' मा० १.१६.२
मयंक, का : सं०० (सं० मृगाइ क>प्रा० मयंक) । चन्द्रमा । मा० १.२२१.५%; ५.२३.२
मयंद : सं०पु० (सं० मृगेन्द्र>प्रा० मइंद) । (१) सिंह । (२) एक वानरयूथप । मा० ५.५४
मयंदु : मयंद+कए० । 'अंगदु मयंदु नल नीलु बलसील महा ।' कवि० ५.२६
मयतनयाँ : मन्दोदरी ने । 'मयतनयाँ कहि नीति बुझावा ।' मा० ५.१०.७
मयतनया : मयदानव की पुत्री=मन्दोदरी।
मयत्री : मइत्री। (१) मित्र भाव, सखित्व । तेहि सन नाथ मयत्री कीजे ।' मा० ४.४.३ (२) योग में चित्त की निर्मलता का साधन विशेष जिसमें सुखी जनों के प्रति ईर्ष्याहीन सम्बन्ध बनाने का उपदेश है । ईर्ष्या-द्वेषादि-रहित मनोदशा । 'श्रद्धा छमा मयत्री दाया।' मा० ३.४६.४
मयन : मदन (प्रा० मयण)। (१) कामदेव । मा० २.१४०.७ (२) मोम । दे० मैन ।
मयनंदिनी : मयतनया। कवि० ६.२१
844
_______________________________________________
मयनपुर : कामदेव का नगर । गी० २.४७.८
मयनाँ : मेना ने । 'पुनि गहे पद पाथोज मयनों ।' मा० १.१०१ छं०
मयना : सं० स्त्री० (सं० मेना) । पार्वती की माता । मा० १.६६.१
मयसुता : मयतनया । मा० ६.८.१
मया : सं०स्त्री० (सं० ममता>प्रा० ममया) । स्नेह, ममत्व । 'जानकीनाथु मया करिहै ।' कवि० ७.४७
मयूखन्हि : मयूख+संब० । किरणों (से) (सं० मयूख = किरण) । 'बिधु महि पूर ___ मयूखन्हि ।' मा० ७.२३
मयूर : सं०० (सं.)। मोर पक्षी । दो० ३३२
मर : मरइ । मर सकता है। 'उमा काल मर जाकी ईछा।' मा० ६.१०२.३
मरंद : मकरंद (सं.)। पियत राम मुखारबिंद मरंद ।' गी० ७.२३.३
मरंदु : मरंद+कए० । 'अरबिंदु सो आननु रूप मरंदु ।' कवि० १.२ /
मर, मरइ, ई : आ०ए० (सं० म्रियते>प्रा० मरइ)। मरता है, प्राण त्याग करता है । मा० ६.१०२.२; ६६.५
मरउँ, ऊ : आउए० (अ०) मर रहा हूं, मरा जा रहा हूं। दिन बहु चले अहार बिन मरऊँ ।' मा० ४.२७.३
मरकट : मर्कट। मा० ४.४.४
मरकत : सं०० (सं.)। हरित मणिविशेष । मा० १.२८८
मरकतमय : (दे० मय) मरकत मणिस्वरूप, मरकत-तुल्य । 'मरकतमय साखा सुपत्र ।' कवि० ७.११५
मरक्कत : मरकत । कवि० ६.५१
मरजाद, दा : संस्त्री० (सं० मर्यादा) । (१) सीमा। 'सुदरता मरजाद भवानी।' मा० १.१००.८ (२) आचार पद्धति । 'मरजाद तजि भए सकल बस काम ।' मा० १.८४ (३) व्यवस्था, विधान । 'मरजादा पुनि तुम्हरी कीन्ही।' मा० ५.५६.५ (४) परम्परागत नियम । 'निमि नप के मनजाद मिटाई।' गी० १.१०८.६
मरजादाँ : मर्यादा में, सीमा में । 'सागर निज मरजादा रहहीं।' मा० ७.२३.६
मरत : (१) वकृ०० । मरता-मरते; मरणान्तिक कष्ट सहता (ते)। 'मन मृग मरत जहाँ तहँ धाई।' कृ० २६ (२) मरते समय । 'मरत न मैं रघुबीर बिलोके ।' गी० ३.१२.३
मरतहुं, हु : मरते समय भी। 'मरतहुं लगी न खोंच।' दो० ३०२ 'मरतह बैर सँभार्यो ।' गी० ३.६.१
मरती : (१) वकृस्त्री० । प्राण त्याग करती। (२) मरने की । 'निज तन प्रगटेसि मरती बारा।' मा० ६.५८.५
_______________________________________________
845
मरतेउँ : क्रियाति पु० उए । मैं मारता । 'बूढ़ भएसि न त मरतेउँ तोही।' मा० ६.४६.३
मरतो : क्रियाति ००ए० । मर जाता । 'मरतो कहाँ जाइ को जाने ।' गी० ५.२८.८
मरदन : मर्दन । गी० २.१८.३
मरन, ना : (१) सं०० (सं० मरण) । मृत्यु । मा० १.४६.१ (२) भकृ. अव्यय । मरने । 'लागे अमर मरन ।' विन० २४८.३
मरनसीलु : वि० (सं० मरणशील) कए। म्रियमाण, मरणोन्मुख । 'मरनसीलु जिमि पाव पियूषा ।' मा० १.३३५.५
मरनिहार : वि.पु.। मरणोन्मुख । 'अब यहु मरनिहार भा साँचा ।' मा० १.२७५.४
मरनु : मरन+कए । 'होइ मरनु जेहिं बिनहिं श्रम ।' मा० १.५६
मरब : भकृ०० (सं० मर्तव्य>प्रा० मरिअन्व) । मरना । 'भूपति जिअब मरब उर आनी ।' मा० २.२८२.७
मरम : मर्म । (१) तत्त्व, यथार्थ स्वरूप (रहस्य) । 'मरम न जाने कोई ।' मा० १.१८६ छं. १ (२) गुप्त भेद । जब तेहिं जाने उ मरम ।' मा० १.१२३ (३) मारक अङ्ग (जिस पर प्रहार से मृत्यु हो सके) । 'मरम ठाहरु देखई ।' मा० २.२५ छं० (४) दुर्बल तथ्य की ओर संकेत । 'मरम बचन सीता जब बोला।' मा० ३.२८.५
मरमु : मरम+कए० । एकमात्र रहस्य । 'सती न जानहिं मरम सोइ ।' मा०. १.४८ ख
मरसि : आ०मए० (सं० म्रियसे>प्रा. मरसि)। तू मर रहा है । बिनु जाने कस मरसि पिआसा। विन० १३६.२
मरहिं, हीं : (१) आ०प्रब० (अ०) । मरते हैं, मर सकते हैं । 'हरि बिनु मरहिंः ने निसिचर पापी ।' मा० १.२०६.५ (२) उए । हम मर रहे हैं । 'लाज हम मरहीं।' मा० ६.११८.६ (३) हम मर सकें । 'हम काहू के मरहिं न मारें।" मा० १.१७७.४
मरहुं : आ०-कामना-प्रब० ! मरें, मर जायें । 'असही दुसही मरहुं मनहिमन ।' ___ गी० १.२.१०
मरहु : आ०मब० (अ०) । मरते हो, मरो । 'व्यर्थ मरह जनि गाल बजाई।' मा० १.२४६.१
मरा : (१) भूकृ०० (सं० मृत) । मर गया। (२) 'राम' का उलटा 'मरा । 'राम बिहाइ मरा जप तें बिगरी सुधरी कबि को किलह की।' कवि० ७.८६
