_______________________________________________
578 
(४) प्रणाम करता-करते । 'चरन परत नप राम निहारे।' मा० २.४४.३ (५) रखा जाता-रखे जाते । 'तब पथ परत उताइल पाऊ।' मा० २.२३४.६ (६) लेटता-ते । “परत पराई पोरि ।' दो० ६६ (७) शक्य होता । 'कह्यो 
क्यों परत मो पाहीं।' विन० ४.२
परति : वक०स्त्री०। (१) गिरती, प्रणत होती। परति गहि चरना।' मा० १.१०२.७ (२) शक्य होती। 'न परति बखानी ।' मा० १.२१.७ (३) बिखेरी जाती । 'नभ पुर परति निछावरि ।' गी० १.४५.६ (४) आती, प्राप्त होती। 'नींद न परति राति ।' गी० १.६६.२
परतिय : परकीया स्त्री, पराई पत्नी। मा० १.२३१.७
परतिहुं : गिरती (वेला) में भी। परतिहुं बार कटकु संधारा ।' मा० ५.२०.१ 
परतीति, ती : प्रतीति । 'असि परतीति तजहु जनि भोरें।' मा० १.१३८.६, ४.७.१३
परत्र : अव्यय (सं.)। परलोक में । 'सो परत्र दुख पावइ ।' मा० ७.४७
परत्रिय : परतिय । मा० ७.११२.४
परदखिना : सं०स्त्री० (सं० प्रदक्षिणा) । दाहिनी ओर से परिक्रमा । 'परदखिना करि करहिं प्रनामा ।' मा० २.२०२.३
परदा : सं०० (फा० पर्दः) । (१) चिलमन, चिक । चित्र विचित्र चहूं दिसि परदा ।' गी० ७.१६.३ (२) परिधान+आवरण । 'सेवक को परदा फट तू समरथ सी ले ।' विन० ३२.४ (३) घेरा। भांग की टाटिन्ह के परदा हैं।' कवि० ७.१५५ (४) छिपाव-दुराव । 'नारद सों परदा न ।' कवि० १.१६ 
परदार, रा : परायी स्त्री, परकीया । मा० १.१८४.१
परदेस : पराया देश, विदेश । गी० २.१३.२
परदोषा : दूसरे के दोष । मा० ३.३६.४
परद्रोह : अन्य के प्रति द्वेष, ईर्ष्या आदि । मा० ६.६२.४
परद्रोही : परद्रोह-शील । मा० १.१८४.५
परधन : पराया धन । मा० १.१८४.१
परधनु : परधन+कए । 'जे लाकहिं परधनु परदारा।' मा० २.१६८.३
परधान : प्रधान । दो० ४६८ (यहाँ प्रकृति-पर्याय भी है)।
परिधान : परधान+कए । एकमात्र प्रधान, सर्वोपरि । जहँ नहिं राम पेम पराधानू ।' मा० २.२६१.२
परषामा : (१) (सं० पर+धामन्) परम धाम, चरन अधिष्ठान, सर्वाधार, सर्वोच्च प्राप्य, परमेश्वर-सालोक्य का स्वरूप । (२) परम प्रकाश । 'अज सच्चिदानंद परधामा।' मा० १.५०.७ 
372 
_______________________________________________
परन : (१) भक० अव्यय । गिरने । 'जहें तह लगे महि परन ।' मा० ३.२०.६ (२) डाले जाने । 'सादर लगे परन पनवारे।' मा० १.३२८.८ (३) सं०० (सं० पर्ण) । पत्ता, पत्ते । 'तहें रचि रुचिर परन तन साला।' मा० २.१२६.६
परनकटी : (सं० पर्णकुटी) । पत्तों से छायी-बनायी कुटी । मा० २.१०४.५ 
परनकुटीर, रा : परनकुटी। मा० २.३२१
परनगृह : (सं० पर्णगह) पत्तों का घर=पर्णकुटी। मा० ३.१३
परनसाल : (सं० पर्णशाला) पर्णकुटी । मा० २.६५
परना : परन । पत्ते । 'मुनि परिहरे सुखानेउ परना।' मा० १.७४.७
परनामा : प्रनाम । मा० १.१४.४ 
परनारि, री : पर-स्त्री, परकीया। मा० १.२३१६, ६.३०.६
परनिदक : दूसरों की निन्दा करने वाला । मा० ७.१०२ छं०
परनि : सं०स्त्री० । पड़ने की क्रिया, गिरना । “उठि चलनि गिरि गिरि परनि ।' गी० १.२८.२
परपंच : प्रपंच । भौतिक सृष्टि । 'रचइ परपंच बिधाता ।' मा० २.२३२.५
परपति : उपपति, अन्य स्त्री का पति । मा० ३.५.१३-१६
परपुर : (१) पराया नगर । 'हँसी करहहु पर-पुर जाई ।' मा० १.६३.१ (२) शत्रु का नगर । 'निपट निसंक परपुर गलवल भो ।' हनु० ६
परबंचनता : संस्त्री० । दूसरे को धोखा देने का कम । मा० ७.१०२.११
परब : सं०० (सं० पर्वन्) । (१) शुभ तिथि आदि। 'परब जोग जन जुरे समाजा।' मा० १.४१.७ (२) पूर्णिमा तिथि । 'सरद परब बिधु ।' मा० २.११५ (३) अमावस्या तिथि । 'भयउ परब बिनु रबि उपरागा।' मा० ६.१०२.६ (४) पोर, गाँठ । दे० सपरब (५) भकृ.पु. (सं० पतितव्य>प्रा० पडिअव्व) । पड़ना (होगा) । 'बहुरि परब भवकूप ।' विन० २०३.६
परबत : सं०० (सं० पर्वत) । पहाड़ । मा० ३.२६.१०
परबस : वि० (सं० परवश) । पराधीन । (१) पराधीनचित्त, मानसिक रूप से सुधबुध रहित । 'परबस सखिन्ह लखी जब सीता।' मा० १.२३४.५ (२) दास भाव से पराधीन । 'करि कुरूप बिधि परबस कीन्हा ।' मा० २.१६.५ (३) शरीर से पराधीन । 'परबस परी बढ़त बिलपाता।' मा० ४.५.४ (४) प्रकृति से पराधीन । 'परबस जीव ।' मा० ७.७८.७
परबसताई : सं०स्त्री० (सं० परवशता) । पराधीनता । गी० १.३०.५
परबास : (पर=ऊपर+वास=वस्त्र) ऊपरी आवरण । 'कपट सार सूची सहस बांधि बचन परबास ।' दो० ४१०
परब्बत : परवत । कवि० ६.५४ _______________________________________________
573. 
परमात : प्रभात । मा० २.१८६.१
परम : (१) वि० (सं.)। अन्तिम, सर्वोपरि, श्रेष्ठ। 'परम धरम यह नाथ हमारा । मा० १.७७.२ (२) सं० । रहस्य, मर्म । परम तम्हार राम कर जानिहि।' मा० २.१७५.७ (३) क्रि०वि० । अतिशय । 'परम सुभट रजनीचर भारी।' मा० ५.१७.८
परमतत्व : ब्रह्म । 'पावा परम तत्त्व जन जोगीं।' मा० १.३५०.६
परमपद : परम धाम, चरम साध्य, सर्वोत्तम लक्ष्य, परम पुरुषार्थ-मोक्ष । 'कासा मरत परम पद लहहीं।' मा० १.४६.४
परमफल : (दे० फलु) (१) एकमात्र परम पुरुषार्थ । 'इहै परम फल इहै बड़ाई।' विन० ६२.१ (२) सबसे बड़ी उपलब्धि । 'मन इतनोइ या तन को परमफलु ।' मा० ६३.१ 
परमाणु, नु : सं०पू० (सं०) । (१) न्याय के अनुसार पृथ्वी, जल, तेज और वायु के सूक्ष्मतम कण जो नित्य माने गये हैं। (२) सांख्य में पञ्चतन्मात्र रुपतन्मात्र=सूक्ष्म तेज; स्पर्शतन्मात्र=सूक्ष्म वायु; रसतन्मात्र=सूक्ष्म जल; गन्धतन्मात्र=सूक्ष्म पृथ्वी और शब्दतन्मात्र= सूक्ष्म आकाश । ये ही पाच ज्ञानेन्द्रियों के विषय हैं और इन्हीं से महाभूतों की सृष्टि परिणत होती है । विन० ५४.२
परमातमा : परमात्मा। मा० १.११६.५
परमातुर : अत्यन्त आतुर, अत्यधिक हड़बड़ी से बिकल, अतिशीघ्रगामी। 'परमातुर बिहंगपति आयउ ।' मा० ७.६०
परमात्मा : सं०० (सं.)। परम तत्त्व, सर्वोपरि आत्मतत्त्व, परमेश्वर=ब्रह्म । 'भव कि परहिं परमात्मा बिंदक ।' मा० ७११२.५ ।।
परमानंद : (१) अत्यन्त आनन्दमय जिसमें सर्वोपरि सुख हो, आत्यन्तिक आनन्द मय = ब्रह्म (वल्याण गुण सम्पन्न ) । 'परमानंद परेस पुराना।' मा० १.११६.८ (२) आत्यन्तिक सुख । 'परमानंद सुर मुनि पावहीं ।' मा० ७.१२.१
परमानंदा : परमानंद । मा० १.१८६ छं०
परमानु : परमाणु । मा० ६.०.१
परमायतन : (परम+आयतन) अन्तिम आश्रय, चरम 
अधिष्ठान, परधाम : मा० ७.१४.१०
परमारथ : सं०पू०+वि० (सं० परमार्थ) । (१) सत्य, यथार्थ । 'सपनेहुं प्रभु परमारथ नाहीं ।' मा० ७.४७.६ (२) प्रातिभासिक तथा व्यावहारिक प्रत्ययों से पृथक् वस्तु सत्य । 'मायाकृत परमारथ नाहीं ।' मा० ४७.१८ (३) सर्वोपरि सत्य तत्त्व परब्रह्म । 'परमारथ पथ परम सुजाना।' मा० २ ९३.७ (४) स्वार्थ 
574 
तुलसी शब्दकोश 
भिन्न वस्तु तत्त्व । 'नीति प्रीति परमारथ स्वारथ ।' मा० २.२५४.५ (५) परम 
पुरुषार्थ =मोक्ष+भक्ति । 'चहत सकल परमारथ बादी ।' मा० ३.६.५
परमारथबादी : वि०० (सं० परमार्थवादिन्) । ब्रह्मवादी, सत्य तत्त्व को ही सिद्धान्त रूप में मानने वाला । मा० १.१०८.५
परमारथमई : वि० स्त्री. (सं० परमार्थमयी)। ब्रह्म स्वरूप। परम सत्यरूप । 'म रति मनोहर चारि बिरचि बिरंचि परमारथमई ।' गी० १.५.३
परमारथी : वि० (सं० परमाथिन्) । परमार्थ तत्व (ब्रह्म) का ज्ञाता, सत्य का द्रष्टा=मुक्त । 'परमारथी प्रपंच बियोगी।' मा० २.६३.३
परमारथु : परमारथ+कए । (१) एकमात्र सत्य, परम पुरुषार्थ । 'सखा परम पुरुषारथ एहू ।' मा० २.६३.६ (२) निरपेक्ष तत्त्व, ब्रह्म । 'जनु जोगी परमारथ पावा।' मा० २.२३६.३
परमिति : सं०स्त्री० (सं.)। (पर+मिति) चरम सीमा, अन्तिम छोर । 'रघुपति भगति प्रेम परमित सी।' मा० १.३१.१४
परमोसा : (सं० परमेश; परमीश-परम् + ईश>प्रा. परमीस) परमेश्वर । 'माया मोह पार परमीसा ।' मा० ७.५८.७
परमेस्वर : (सं० परमेश्वर) परमात्मा । अखिल विश्व पर स्वतन्त्र प्रभु ।' दो० ४६८
परमेस्वरु : परमेस्वर+कए० । अदंत ब्रह्म । 'पाहन तें परमेस्वर काढ़े।' कवि० ७.१२७ 
परलोक, का : (इहलोक का विलोम) वर्तमान जीवन से परे लोक = आमष्तिक  गति । मा० १.२०.२ 
परलोकु, कू : परलोक+कए । 'सुकृतु सुजसु परलोकु नसाऊ ।' मा० २.७६.४ 
परवान, ना : (१) प्रमान । प्रमाणित, सिद्ध, सत्य । “कियो प्रेम परवान ।' गी० २.५६.४ (२) स०प० (सं० परिमाण-प्रमाण>अ० परिवाण) । पर्यन्त । 'रखिहउँ इहाँ बरष परवाना।' मा० १.१६६.५
परवाह : सं०स्त्री० (फा० परवा खौफ, दहशत) । (अपेक्षा) आशङका, डर, सोच । 'परवाह है ताहि कहा नर की।' कवि० ७.२७
परशु : सं०० (सं०) । कुल्हाड़ा । विन० ५२.६ ।।
परस : (१) परसइ । छूता है, छ सकता है। 'तन बिनु परस नयन बिनु देखा।' मा० १.११८.७ (२) सं०० (सं० परश)। पारस पत्थर, जिसके स्पर्श से लोहा सोना बन जाने की किंवदन्ती है । 'गुजा ग्रहइ परस मनि खोई।' मा० ७.४४.३ (३) सं०० (सं० स्पर्श>प्रा०
फरिस): छुवन, छूना । पारस परस कुधातु सुहाई।' मा० १.३.६ (४) वायु का असाधारण गुण । 'परस कि _______________________________________________
575 
Chry 
होइ बिहीन समोरा ।' मा० ७.६०.७ (५) पाँच विषयों में अन्यतम (स्पर्श 
तन्मात्र) । 'परस रस सब्द गंध अरु रूप ।' विन० २०३.६ /परस
परसइ : (सं० स्पृशति>प्रा० फरिसइ) आ०प्रए । स्पर्श करता है, छूता है, छ सकता है । 'परस बिना निकेत ।' वैरा०३
परसत : (१) वकृ०० (सं० स्पृशत् >प्रा० फरिसंत)। छूता-वृते, छूते हो। 'परसत तुहिन तामरसु जैसें।' मा० २.७१.८ (२) (सं० परिवेषयत्>प्रा० परिवेसंत)। परोसते, भोजन देते हुए । 'परसत पनवारो फारो ।' विन ० ६४.३
परसति : वकृस्त्री० । छूती । 'नहिं परसति पग पानि ।' मा० १.२६५
परसपर : परस्पर । मा० १.४२
परसमनि : सं०० (सं० परशमणि) । पारस पत्थर जिसके लिए प्रसिद्ध है कि लोहे को सोना बना देता है। 'तेहि कि दरिद्र परसमनि जा के ।' मा० ७.११२.१
परसा : भूक०० । छुआ । 'कर परसा सुग्रीव सरीरा ।' मा० ४.८.६
परसि : पू० । छूकर । 'परसि अखयबटु हरहिं गाता।' मा० १.४४.५ 
: भूकृ०स्त्री० । छुई, स्पर्श पाई हुई । 'नाम बल बिपुल मति मल न परसी।' विन० ४६.६
परसु : परशू । मा० १.२७२
परसुधर : बि+सं०० (सं० परशुधर) । कुठार धारी; परशुराम । मा० १.२८४.६
परसुपानि : परसुधर । गी० ७.१३.५
परसुराम : जमदग्नि मुनि के पुत्र राम जो कुठारधारी होने से 'परशुराम' कहे जाते हैं । मा० १.२८०
परसें : स्पर्श करने से । परसें पद पापु लहौंगो।' कवि० ७.१४७
परसे : भूकृ००ब० । छुए। सिर परसे प्रभु निज कर कंजा ।' मा० १.१४८.८
परसेउ : भूकृ००कए । छुआ। 'कर सरोज सिर परसेउ ।' मा० ३.३०
परसेन : शत्रु की सेना । कवि० ६.४७
परसै : परसइ।
परस्पर : क्रि०वि० (सं०) । एक-दूसरे से, आपस में, आपसी तौर पर । मा० १.४१.३
परस्यो : परसेउ । 'ज्यों चह पांवर परस्यो।' विन० १७०.४ 
परहि, हीं : आ०प्रब० (सं० पन्ति >प्रा० पडंति >अ० पडहिं) । (१) गिरते हैं। 'घुमि धुर्मि जहें तहँ महि परहीं ।' मा० ६.८७.६ (२) अधोगति पाते हैं। 'भव कि परहिं परमात्मा बिदक ।' मा० ७.११२.५ (३) डाले जाते हैं । 'पट पांवड़े 
576 
तुलसी शब्द कोश 
परहि बिधि नाना।' मा० १.३१६.३ (४) शयन करते हैं। 'ए महिं परहि डासि कुस पाता।' मा० २.११६.७ (५) (ज्ञात) हो जायँ । 'लखि जनि परहिं 
सरोष ।' दो० १८७
परहित : दूसरे का कल्याण, परोपकार । मा० २.२१६
परहुं : अव्यय (सं०
परश्व:>प्रा० परसो) । आगामी कल के बाद वाले दिन को।  'आजु कालि परहुं जागन होहिंगे।' गी० १ ५.५
परहेलि : पूकृ० (सं० परिहेल्य) । अवज्ञा करके, अलग डाल कर । 'सींचि सह ___ सुधा खनि काढ़ी लोक बेद परहेलि।' कृ. २६
परहेल : आ०-आज्ञा-मए । तू उपेक्षित कर दे, छोड़ दे। 'के ममता परहेल ।' दो० ७६
परहेलें : क्रिवि. । उपेक्षित किये हुए। अपेक्षा न करके। (चिन्तनीय की) चिन्ता से रहित होकर । 'सुदर जवा जीव परहेलें ।' मा० १.१५६.३
परा : भूकृ०० । (१) गिरा हुआ, लेटा हुआ। 'भूमि परा कर गहत अकासा ।' मा० ५.५७.२ (२) जा पड़ा। 'कूदि परा।' मा० ५.२६.८ (३) भ्रान्त हुआ। 'परा भवकूपा ।' मा० ३.१५.५ (४) थक गया। 'हारि परा ।' मा० ३.२९६ (५) बरसा । 'सूखत धान परा जनु पानी ।' मा० १.२६३.३ (६) व्याप्त हुआ, मच गया । 'जग खरमरु परा।' मा० १.८४ छं० (७) गिर गया। 'मुरुछि 
परा ।' मा० २.१२.८ (6) प्रवृत्त हुआ। 'मनु हठ परा।' मा० १.७८.५ 'परा 
पराइ, ई : (सं० पलायते>प्रा० पलाइ) आप्रए० । भागता है। 'तुलसी छुवत पराइ ज्यों पारद पावक आंच ।' दो० ३३६ 'कबहुं निकट पुनि कबहुं पराई। मा० ३ २७.१२
पराइ :
(:) पराई। परकीय, दूसरे की । 'देखि न सकहिं पराइ बिभती।' मा० २.१२.६ (२) कृ० (सं० पलाय्य)। भाग कर । 'पुनि कपि चले पराइ ।' मा० ६.४१ (३) दौड़कर । ‘गढ़ पर चढ़े पराइ ।' मा० ६.७४ ख
पराई : (१) दे/परा (२) पराइ । भागकर । 'श्रवन मूदि न त चलिअ पराई।' मा० १.६४.४ (३) वि०स्त्री० (सं० परकीया>प्रा० पराई)। दूसरे की। 'बेगि पाइअहिं पीर पराई ।' मा० २.८५.२
पराउ : आ०-संभावना-प्रए० (स० पलायेत>प्रा० पलाउ)। चाहे भाग जाय । रबि दै पीठि पराउ ।' दो० ३१६
पराएँ : पराए........ मे (पराधीन) । 'मुनिहि मोह, मन हाथ पराएँ ।' मा० १.१३४.५
पराए : पराये । कृ० ४७
पराक्रम : सं० (सं.)। शक्ति, आक्रमण आदि का उत्साह, पौरुष । मा. ६.२७ _______________________________________________
577 
पराग : सं०० (सं०) । पुष्प-रज । मा० १.३२५.६
परागा : पराग । 'बंदउँ गुरु पद पदुम परागा।' मा० १.१.१
परात : वकृ०० । भागते । 'भभरे, बनइ न रहत न बनइ परातहिं ।' पा०म० १०३
पराध : अपराध । दो० ४७२
पराधीन : (पर+अधीन) परवश, परतन्त्र । मा० १.१०२.५
पराधीनता : सं०स्त्री० (सं.)। परवशता, परतन्त्रता । विन० २६२.३
परान : भक० अव्यय । भागने, पलायन करने । 'तब लगे कीस परान ।' मा० ६.१०१.३
परानंद : परमानंद । मा० ७.४६
परानि : परानी । 'मानहं सती परानि।' दो० २५३
परानी : भूक०स्त्री० । भागी, भाग चली । 'रानी जाति हैं परानी। कवि० ५.१०
पराने : भक००ब० । भाग चले । 'बालक सब ले जीव पराने।' मा० १.६५.५
परान्यो : भक.पु.कए । भाग चला। पावर लै प्रभुप्रिया परान्यो।' गी० ३.८.२ 
परामउ : पराभव+कए । एकमात्र तिरस्कार । 'सोउ तेहि सभी पराभउ पावा।' मा० १.२६२.८ 
पराभव, भौ : सं०० (सं०)। (१) तिरस्कार । (२) तिरोभाव, प्रलय = लीनावस्था । 'भव भव बिभव पराभव कारिनि ।' मा० १.२३५.८
पराभो : पराभउ । कवि० ७.१२५
पराय : (१) वि०० (सं० परकीय>प्रा० पराय) । पराया, दूसरे का । "पिसुन पराय पाप कहि देहीं ।' मा० २.१६८.१ (२) पराइ। भाग जाता है । 'पुन्य पराय पहार बन ।' दो० ५५६
परायन : वि० (सं० परायण) । (१) समर्पित अनन्य भाव से अनुरक्त==एक निष्ठ । 'विगत काम मम नाम परायन । मा० ७.३८.५ (२) आसक्त । 'काम क्रोध मद लोभ परायन ।' मा० ७.३६.५
पराये : पराय । 'कबहुं न जात पराये धामहिं ।' कृ० ५ 
पराव, वा : पराय । परकीय । 'धन पराव बिष ते बिष भारी।' मा० २.१३०.६
परावन : सं०० (सं० पलायन) । भगदड़ । 'सुरपुर निहिं पराबन होई ।' मा० १.१८०.८
परावनो : परावन+कए । भगदड़। 'परावनो परो सो है ।' कवि० ७.८४
परावर : वि० (सं० परापर, परावर>प्रा० परावर) । सबसे ऊपर तथा सबसे नीचे; दूर तथा निकट, पुरातन तथा नवीन=चिरन्तन; सर्वत्र देशकाल में व्यापक; आरपार ।' मा० १.११६ 
578 
_______________________________________________
परावा : पराव । 'करहिं मोह बस द्रोह परावा।' मा० ७.४०.६
परास : सं०पू० (सं० पलाश) । टेसू का वृक्ष, किंशक । मा० ३.४०.६ 
पराहि, हीं : आ०प्रब० (सं० पलायन्ते>प्रा० पलंति>अ० पलाहिं) । भागते हैं। 'हमहि देखि मृग निकर पराही । मा० ३.३७.५
पराहि : आमए । तू भाग । 'पराहि जाहि पापिनी ।' हन० २६
परि : (१) पू० । पड़ कर । 'बिनय करबि परि पायें।' मा० २.६८ (२) परी । गिर पड़ी। 'परि मुह भर महि।' मा० २.१६३.४ (३) (ज्ञात) हो सकी। 'जरी न परि पहिचानि ।' गी० ६.९.४ (४) अव्यय (सं० परम्) । केवल । 'संत बिसुद्ध मिलहिं परि तेहीं।' मा० ७.६९.७ (५) अवश्य । 'राम परायन सो परि होई।' मा० ७.६७.६
परिअ : आ०भावा० । पड़ा जाय, पड़ना चाहिए। 'मारतहं पा परिअ. तुम्हारे।' मा० १.२७३.७
परिकर : संपु० (सं.)। (१) फेंटा, कमरबन्द। पीत बसन परिकर कटि भाथा ।' मा० १.२१६.३ (२) परिकर बांधना तैयार होना । 'परिकर बाँधि उठे अकुलाई ।' मा० १.२५०.६
परिखिहि : आ०कवा०प्रब० (सं० परीक्ष्यन्ते>प्रा० परिक्खीअंति>अ० परिक्खिअहिं) । परखे जाते हैं, जाँच में आते हैं। 'पुरुष परिखिअहिं समय सुभाएँ।' गी० २.२८३.६
परिखेस : आ०- भ०+आज्ञा-मए० (सं० प्रतीक्षेथाः>प्रा० परिक्खेसु)। तू प्रतीक्षा करना । 'परिखेसु मोहि एक पखवारा। मा० ४.६.६
परिखेहु : आ० - भ०+प्रार्थना-मब० (सं० प्रतीक्षेध्वम् >प्रा० पडिक्खेह>अ० पडिक्खेहु) । तुम प्रतीक्षा करना । तब लगि मोहि परिखेहु तुम्ह भाई ।' मा० ५.१.२ 
परिखौ : आ०मब० (सं० प्रतीक्षध्वम् >प्रा० पडिक्खह>अ० पडिक्सह) । प्रतीक्षा करो । 'परिखो पिय छाँह घरीक व ठाढ़े।' कवि० २.१२
परिगहैगो : आ० भ०पू०प्रए । ग्रहण करेगा । अपनायेगा । 'लटे लटपटेनि को कौन परिगहैगो ।' विन० २५९.३
परिध : सं०० (सं.)। लोहे का बड़ा भाला। मा० ३.१६ छं.
परिचरजा : सं०स्त्री० (सं० परिचर्या) । सेवा, टहल । मा० ७.२४.६
परिचारक : सं०+वि०० (सं.)। सेवक, दास । मा० १.२८७.५.
परिचारिका : सं+वि०स्त्री० (सं.)। दासी, सेविका । मा० १.३२६ छं० २
परिचेहु : आ०-भूकृ००+मब० । (१) परक गये हो, अभ्यस्त हो चुके हो। (२) परख चुके हो। 'डहकि डहकि परिचेहु सब काहू।' मा० १.१३७.३ _______________________________________________
579 
पारयो : सं०पू० (सं० परिचय) कए। पहचान । 'बहतन्ह परिचौ पायो ।' गी. १.१७.१
परिच्छा : संस्त्री० (सं० परीक्षा)। परख, जाँच । मा० १.७७ ।।
परिच्छित : (१) भूक०० (सं० परीक्षित)। परखा हुआ। पाप को दाम परिच्छित ।' कवि० ७.१७६ (२) सं०पु० (सं० परीक्षित) । कुरुवंश का एक .. राजा जो जनमेजय का पिता और अभिमन्य का पुत्र था ।
'परिछन : भकृ० अव्यय (सं० प्रतीक्षितम् >प्रा० पडिच्छिउँ>अ० पडिच्छण)। . पूजन करने, (वर का) स्वागत-सम्मानादि करने । 'परिछन चली हरहि हर वानी ।' मा० १.६६.३
परिछनि : सं०स्त्री० (सं० प्रतीक्षण>प्रा० पडिच्छण) । पूजन, वर पूजन । 'चलों 
__मुदित परिछनि करन ।' मा० १.३१७
परिछोहि : परिछाहीं। 'तनु परिहरि परिछांहि रही है।' गी० २.६.३
'परिछाहीं : सं०स्त्री० (सं० प्रतिच्छाया>प्रा० पडिछाही)। प्रतिच्छवि, प्रतिबिम्ब ।  'जह तह देखहिं निज परिछाहीं।' मा० ७.२८.५
परिछि : पूक० (सं० प्रतीक्ष्य>प्रा० पडिक्खिअ>अ० पडिक्खि) । पूजित करके । 'बधुन्ह सहित सुत परिछि सब चली लवाइ निकेत ।' मा० १.३४६
परिछिन्न : वि० (सं० परिच्छिन्न) । सीमित, आवृत, परिमित । 'माया बस परिछिन्न जड़ जीव ।' मा० ७.१११ ख
परिजन : सं०पु० (सं०) । (१) परिचारक वर्ग जो परिवार के परिवेश में रहता है। 'नतरु प्रजा परिजन परिवारू ।' मा० २.३०५.६ (२) गोस्वामी जी ने परिवार अर्थ में भी लिया है । 'हरहु दुसह आरति परिजन की।' मा० २.७१.२
परिजनन्हि : परिजन+संब० । परिजनों (को)। 'प्रभु सुभाउ परिजनन्हि सुनावा।' मा० ७.२०.५
परिजनहि : परिजन को ! 'सासु ससुर परिजनहि पिआरी ।' मा० २.५८.८
परिताप : सं०पू० (सं.)। (१) तचन, तीव्र आतप (घाम)। 'भय बिषाद परिताप घनेरे ।' मा० २.६६.५ (२) व्यापक क्लेश, यन्त्रणा । 'मिहिं पाप परिताप हिए तें।' मा० १.४३.६
परितापा : परिताप । मा० १.६३.६
परितापी : वि०० (सं० परितापिन्) । अति क्लेशदायी। 'निसिचर निकर देव परितापी ।' मा० १.१८३.३
परितापु : परिताप-+कए । अद्वितीय सन्ताप । 'जितें पाप परितापु ।' दो० ४३२
परितोष : सं०० (सं.)। पूर्ण सन्तोष । 'मम परितोष बिबिध बिधि कीन्हा ।' मा० ७.११३.६ 
380 
_______________________________________________
परितोषत : वकृ०० । परितप्त करता या परितृप्ति पाता । द्वापर परितोषत प्रभु पूजें।' मा० १.२७.३
परितोषा : भूकृ.पुं० । परितोष दिया । 'कहि प्रिय बचन काम परितोषा।' मा० १.१२७.१ 
परितोषि, षी : पू० । परितोष देकर । मा० २.१५१ छं.
परितोषिके : भकृ०० । परितोष देने । 'जन परितोषिबे को.. मोदक सुदान भो । हनु० ११
परितोषी : भूकृ०स्त्री०ब० । पूर्ण सन्तुष्ट की। 'मधुर बचन कहि कहि परितोषीं। मा० २.११८.४
परितोषी : परितोषि । परितोष देकर । मा० १.१७१.६ 
परितोषु, ष: परितोष+कए० । 'दुचित कतहुं परितोष न लहहीं।' मा० १.३०२.७
परितोषे : भूक०पू०ब० । (१) परितुष्ट किये। 'मीत पुनीत प्रेम परितोष ।' मा०. २.८०.४ (२) परितुष्ट हुए । 'पूरनकाम रामु परितोषे ।' मा० १.३४२.६
परितोसु : परितोष । विन० १५६.५
परित्याग :
सम्पूर्णत: त्याग । मा० १.६१.७
परित्राता : सर्वथा त्राण देने वाला, पूर्ण रक्षक । मा० १.१६३.१
परिधन : सं०० (सं० परिधान) । वस्त्र, पहनावा । 'भज प्रलंब परिधन मुनि चीरा।' मा० १.१०६.६
परिधान : सं००(सं०) । पहनावा।
परिधाना : परिधान । 'कृस सरीर मुनि पट परिधाना ।' मा० १.१४३.८
परिनाम : सं०पू० (सं० परिणाम) । (१) फल । 'भल परिनाम न पोचु ।' मा० २.२८२ (२) कर्मफल । 'परिनाम मंगल जानि ।' मा० २.२०१ (३) तात्त्विक परिवर्तन जैसे दूध से दही। (४) अविकृत परिवर्तन जैसे, ब्रह्म से जगत् । (५) अन्त । 'सुनत मधुर परिनाम हित ।' मा० २.५०
परिनामहिं : अन्ततः, फलतः । 'तो कोउ नृपहि न देत दोषु परिनामहि ।' जा०म०७४
परिनामा : परिनाम । मा० २.२३.६ 
परिनामु, मू : परिनाम+कए । 'लागत मोहि नीक परिनामू ।' मा० २.२६१.८
परिनामै : परिनामहिं । 'मतो नाथा सोई जातें नीक परिनामें।' गी० ५.२५.३
पारनामो : परिणाम भी, अन्त भी। 'ता को भलो..... आदि मध्य परिनामो। विन० २२८.१ _______________________________________________
581 
परिपाका : वि०० (सं० परिपक्व)। पका हुआ परिणत । 'सोइ पाइहि यह फलु परिपाका । मा० २.२१.५
परिपाक : सं०० (सं० परिपाक) कए। परिणति, फल । 'बिनु समुझें निज अघ __ परिपाक।' मा० २.२६१.६
परिपाके : भूकृ.पु.ब० । (सं० परिपक्व) । पके, निष्पन्न, परिणत हुए। 'कोने बड़भागी के सुकृत परिपाके हैं ।' गी० १.६४.१
“परिपाटी : संस्त्री० (सं.)। रीति, पद्धति, व्यवस्था, प्रसिद्धि । 'प्रगटी धन विघटन परिपाटी।' मा० १.२३६.६
परिपालय : आ०-प्रार्थना-मए । तू परिपालन कर । मा० ७.३४.७
परिपूरन : वि० (सं० परिपूर्ण) । सर्वथा पूर्ण, भरापूरा । 'प्रेम परिपूरन हियो ।'  मा० १.१०१ छं.
परिपूरन-काम : वि० सं० परिपूर्ण काम) । सम्पूर्ण मनोरथों वाला। इच्छापूर्ति हेतु किसी अन्य की अपेक्षा न करने वाला । 'तुम्ह परिपूरन-काम ।' मा० 
परिपूरित : परिपूरन (सं०) । 'मिले प्रेम परिपूरित गाता।' मा० १.३०८.८
परिपोषे : भूकृ.पु०ब० । सर्वथा पुष्ट किये । पोषण= अनुग्रह से परिपर्ण किये । 'आदर दान प्रेम परिपोषे।' मा० १.३५२.४
'परिबे : भक०० । पड़ना चाहिए । 'प्रभु परमिति परिबे हो।' कृ० ३६ 
परिमिति : सं०स्त्री० (सं.)। परिमाण, सीमा, पराकाष्ठा । 'प्रानो चलिहैं परिमिति पाई।' कृ० २५
परिय : परिअ । 'परिय न कबहुं जमधारि ।' विन० २०३.८
परिये : परिय । पड़ना हो । 'जा तें भवनिधि परिये ।' विन० १८६.५
परिवा : सं०स्त्री० (सं० प्रतिपद्=प्रतिपदा>प्रा० पडिवआ) । पाख की पहली तिथि । विन० २०३.२ 
परिवार, रा : (१) सं०३० (सं० परिवार) । कुटुम्ब । 'प्रिय परिवार पिता अरु माता ।' मा० १.७३.८ (२) समूह, वर्ग। 'प्रबल अविद्या कर परिवारा।' मा० ७.११८.३ 
परिवार, रू: परिवार+कए । 'समन सकल भबरुज परिवारू ।' मा० १.१.२
परिहर : परिहरइ । 'जारेहुं सहज न परिहर सोई।' मा० १.८०.६ 'परिहर
परिहरह: (सं० परिहरति>प्रा० परिहरइ) आप्रए० । छोड़ता है। "जिमि नूतन पट पहिरइ नर परिहरइ पुरान ।' मा० ७.१०६ 
परिहर, ऊ : आ०प्रए० । छोड़ता-ती हं; त्याग सकता-ती हूं । 'नारद बचन न मैं परिहरऊँ।' मा० १.८०.७ 
582. 
_______________________________________________
परिहरत : वकृ.पु । छोड़ता । 'तुलसी मन परिहरत नहिं, घरबिनिआ की बानि ।' दो०१३
परिहरते : क्रियाति०पू०ब० । त्याग देते, छोड़ सकते। 'ती कि जानकिहि जानि जिय परिहरते रघुराउ।' दो० ४६३ 
परिहरहि, ही : आ०प्रब० (सं० परिहरन्ति>प्रा० परिहरहिं)। छोड़ते हैं, छोड़ ___सकते हैं । पर अकाजु लगि तनु परिहरहीं।' मा० १.४.७ 
परिहरहु, हू : आ०मब० । छोड़ दो। 'प्रिया सोचु परिहरहु सबु ।' मा० १.७१
परिहरि : पूक० । छोड़कर । 'हठ परिहरि घर जाएहु तबहीं।' मा० १.७५.३
परिहरिअ : आ०कवा०प्रए । छोड़ा जाय । “सोच परिहरिअ तात ।' मा० २.४५
परिहरिय : परिहरिअ । जा०म०७६
परिहरिये : परिहरिय । छोड़िये। विन० १८६.२
परिहरिहि : आ० भ०प्रए० (सं० परिहरिष्यति>प्रा० परिहरिहिइ)। छोड़ेगा-गी। सीय कि पिय संगु परिहरिहि ।' मा० २.४६
परिहरिहै : परिहरिहि । 'मन..... कलि कुचालि परिहरिहै।' विन० २६८.३
परिहरी : भकृ. स्त्री०ब० । छोड़ दी! 'नर नारिन्ह परिहरी निमेषं ।' मा० १.२४६.१ .
परिहरी : भूकृ०स्त्री० । छोड़ दी । 'झूठे अघ सिय परिहरी ।' दो० १६६
परिहरु : आ० - आज्ञा-मए (अ०) । तू छोड़ दे। 'परिहरु दुसह कलेस सब।" मा० १.७४
परिहरें : छोड़ने से । 'रामहि परिहरें निपट हानि।' दो० ६६
परिहरे : भूकृ००ब० । छोड़ दिये । 'पुनि परिहरे सुखानेउ परना।' मा० 
१.७४.७, परिहरेउ : आ०-भूक पु+उए । मैंने छोड़ा। 'सिसुपन तें परिहरेउ न सँग।' मा० २.२६०.७ 
परिहरेउ, ऊ : भूकृ०० कए ० । छोड़ दिया । 'प्रिय तनु तृन इव परिहरेउ ।' मा० 
परिहरेहि : छोड़ने में ही । 'अस कुमित्र परिहरेहिं भलाई।' मा० ४.७.८
परिहर : परिहरइ । छोड़े। 'मनु परिहरै चरन जनि भोरें।' मा० १.३४२.५
परिहयो : परिहरेउ । छोड़ दिया । 'उदर सुख त परिहर्यो।' विन० १३६.२
परिहहि : आ० भ० प्रब० (सं० पतिष्यन्ति >प्रा. पडिहिति>अ० पडिहिहिं) । पड़ेगे, गिरेंगे । 'परिहहिं धरनि राम सर लागें ।' मा० ६.२७.४
परिहास : सं० पु (सं०) । विनोद, हँसी, मजाक (स्त्री० प्रयोग भी द्रष्टव्य है)। 'जौं परिहास कीन्हि कछु होई ।' मा० २.५०.६
परिहासा : परिहास । 'सुनि तव भगिनि करहिं परिहासा।' मा० ३.२२.१० _______________________________________________
583 
परिहि : आ०भ०ए० (सं० पतिष्यति>प्रा० पडिहिइ)। पड़ेगा। 'समुझि परिहि सोउ आजु बिसेषी।' मा० २.२२६.४
परिहैं : परिहहिं । 'हाड़ पर परिहैं पुहुमी नीर ।' दो० ३०१
परिहै : (१) परिहि । 'जब मन फिरि परिहै।' विन० २६८.१ (२) मए० (सं० पतिष्यसि>प्रा० पडिहिसि>अ० पडिहिहि)। तू पड़ेगा। 'नाहिं त भव बेगारि मह परिहै ।' विन० १८६.१
परी : भूक स्त्री० ब० । पड़ी, जा पड़ी। परी बधिक बस मनहं मराली।' मा० २.२४६.५
परी : भूक० स्त्री० । पड़ी, पड़ी हुई। 'मुरुछित अवनि परी ।' मा० २.१६४.१ (२) आई, प्राप्त हुई। 'परी न राजहि नीद निसि ।' मा० २.३८ (३) घटित हुई । “उपजि परी ममता मन मोरें। मा० १.१६४.४ (४) घटित हुई (होनी)। 'तुलसी परी न चाहिऐ चतर चातकहि चूक ।' दो० २८२ (५) हो सकी, जा सकी । 'समुझि परी कछु मति अनुसारा ।' मा० १.३१.१ (६) आ पड़ी, टूट पड़ी । 'परी जासु फल बिपति घनेरी ।' मा० १.४१८ (७) बन पड़ी । 'परी हस्त असि रेख।' मा० १.६७ (८) प्रणत हुई । 'अस कहि परी धरनि धरि सीसा ।' मा० १.७१.७
परीगो : पड़ गया । 'परीगो काल फग में ।' कवि० ७.७६
परीछा : परिच्छा । मा० २.१५.६
परीछित : परिच्छित । राजा परीक्षित् । कवि० ७.१८१
परुष : वि० (सं०) । कठोर, कर्कश, निष्ठुर, क्रूर, उग्र। मा० ३.३८ ख
परुषपन : (दे० पन) । परुषता, कठोर व्यवहार । 'प्रेम न परखिअ परुषपन ।' दो० २६८
परुषा : परुष+स्त्री० । कठोर, उग्र । 'परुषा बरषा..... सहि के ।' कवि० ७.३३
परुषाच्छर : सं०० (सं० परुषाक्षर)। परुष वचन । 'इरिषा परुषाच्छर लोलुपता।' मा० ७.१०२.४
परसन : भकृ० अव्यय (सं० परिवेषयितुम्>प्रा. परिवेसिउं>अ० परिवेसण) । परोसने, भोज्य-सामग्री देने (परिवेषण करने) । 'परसन लगे सुआर सुजाना ।' मा० १.३२६.३
परसहु : आ०मब० (सं० परिवेषयत>प्रा० परिवेसह >अ० परिवेसह)। परोसो, भोजन सामग्री विभक्त करो। 'तुम्ह परुसहु मोहि जान न कोई।' मा० १.१६८.५
परुसि : प्रकृ० (सं० परिवेष्य>प्रा० परिवेसिअ>अ० परिवेसि)। परोसने का कार्य सम्पन्न कर । 'छिन म सबके परुसि गे।' मा० १.३२८. 'पेखत परसि धरो।' विन० २२६.३ 
584 
_______________________________________________
परें : पड़ने पर, पड़ने से । 'जिमि जवास पर पावस पानी।' मा० २.५४.२
परे : भूकृ०००। (१) लुण्ठित हुए। 'भूतल परे मुकुट अति सुंदर ।' मा० ६.३२.५ (२) गिर पड़े । 'परे भूमि कपि बीर ।' मा० ६.५० (३) प्राप्त हुए, गोचर हुए । 'राम लखन जब दृष्टि परे री।' गो० १.७६.१ (४) प्रणत हुए। 'परे दंड इव गहि पद पानी।' मा० १.१४८.७ (५) डाले (परोसे) गये । 'भांति अनेक परे पकवाने ।' मा० १.३२६.२ (६) टूट पड़े। 'गजि परे रिपु कटक मझारी।' मा० ६.४४.७ (७) पड़ाव डालकर रहे । 'प्रभु आइ परे सुनि सायर काठे।' कवि० ६.२८
परेउ : आ०-भकृ००+उए० । मैं गिर पड़ा। 'परेउँ भूमि करि घोर चिकारा।' मा० ४.२८.४ 
परेउ, ऊ : भूकृ००कए० । (१) गिर पड़ा। 'त्रसित परेउ अवनीं अकुलाई।' मा० १.१७४.८ (२) लेट गया । 'परेउ जाइ तेहि सेज अनूपा ।' मा० १.१७२.१ (३) हो सका । 'राम स्वरूप जानि मोहि परेऊ ।' मा० १.१२०.२ (४) प्रणत हुआ। 'प्रभु पहिचानि परेउ गहि चरना । मा० ४.२.५ (५) फैस गया । फिरेउ महाबन परेउ भुलाई।' मा० १.१५७.८
परेखो : सं०कए । (१) परख, परीक्षण, सोच-विचार । 'इतनो परेखो, सब भांति समरथ ।' हनु० २६ (२) प्रतीक्षा, आदरभाव; सम्मान देकर विचार । 'सोइ बावरि जो परेखो उर आने ।' कृ० ३८ 
परेश, स : वि०+सं०० (सं०-पर+ईश) । सर्वोपरि स्वामी, परमेश्वर । मा० ७.१०८ छं०६
परेस : परेश (प्रा.)। मा० १.११६.८
परेह : आ०-भूक००+मब० (१) आ फैसे हो । 'परेहु कठिन रावन के पाले।' मा० ६.६०.८ (२) लोट रहे हो। 'आजु परेहु अनाथ की नाईं।' मा० ६.१०४.८
परें: परहिं । 'बड़े अलेखी लखि परें ।' विन० १४७.५
पर : (१) परइ । पड़ जाय । 'सेवक प्रभुहि परै जनि भोरें। मा० ४.३.१ (२) (जा) सके । 'सुभगता न पर कही।' मा० १.८६ छं० (३) हो सकता है। 'पर उपास कुबेर घर ।' दो० ७२ (४) घटित होता है । 'सब दिन रूरो पर पूरो।' हनु० १२
परंगी : आ०भ० स्त्री०प्रए०। (१) वह पड़ेगी। 'साँचिये परंगी सही।' विन २५४.३ (२) मए । तू पड़ेगी। 'गुनी के पाले परगी। हनु० २५
परों: परहुं । परसों । 'आज कि कालि परों कि नरों।' कवि० ७.१७६
परो: पर्यो। (१) डाला हुआ। रहीं दरबार परो लटि लूलो।' हनु० ३६ _______________________________________________
585 
(२) गिरा हुआ (पड़ा मिला)। 'कृपिन देइ पाइअ परो।' दो० १७१ 
(३) (जाना) जा सका। 'तुलसी समुझि परो।' विन० २२६.६
परोसो : (१) पड़ा हुआ सा । 'परावनो परोसो है।' कवि० ७.८४ (२) सं०पू० कए० (सं० परिवेषम् >प्रा० परिवेसं>अ० परिवेसउ)। परसा हुआ थाल या पत्तल । 'तुलसी परोसो त्यागि मागे कूर कोर रे।' विन० ६६.५ (३) वि.पु. कए० (सं०
परिवेषक:>प्रा० परिवेसओ>अ० परिवेसउ) । परोसने वाला, भोजन देने वाला। 'पाहुने कृसानु, पवमानु सो परोसो।' कवि० ५.२४ (४) भूक००कए० (सं० परिवेषितम् >प्रा० परिवेसिअं>अ० परिवेसिअउ) । परिवेषण किया। 'करम फल भरि भरि बेद परोसो।' विन० १७३.२
परों : (१) परहुं । परसों। 'पथिक जे एहि पथ परौं सिधाए।' गी० २.३६.१ (२) परउँ । पडूं, पड़ता-ती हूं । 'महरि तिहारे पायँ परौं ।' कृ०७ (३) चाहे पडूं, जा गिरू । 'नरक परौं बरु सुरपुर जाऊ ।' मा० २.४५.१
पर्न : परन । मा० ७.१३ छं० ५
पर्नकटी : परनकुटी । कवि० ३.१
पर्नसाल : परनसाल । गी० ३.१७.१
पर्वत : सं०० (सं० पर्वत)। पहाड़ । मा० ४.१.१
पर्वताकारा : वि०० (सं० पर्वताकार) । पहाड़ जैसे डीलडोल वाला। मा० ४.३०.६
पयंक : पलंग (सं०) । विन० १८.४ 
पर्यत : क्रि०वि० (सं०) । तक । 'भुवन पर्यंत पद तीनि करणं ।' विन० ५२.५
पर्यो : परेउ। (१) गिर पड़ा । 'पर्यो धरनि ब्याकुल सिर धुन्यो।' मा० ६.६५.७ (२) बन गया। 'कमठ कठिन पीठि घट्टा पर्यो मंदर को।' कवि० 
पर्व : दे० परब । पूणि मा। विन० १६.१
पलंग : सं०० (सं० पल्यङक=पर्यङक>प्रा० पल्लंक)। शय्याविशेष । 'चरन पखारि पलंग बैठाए।' मा० ४.२०.५
पल : सं०० (सं.)। (१) घड़ी के ६०वें भाम का समय । (२) पलक मारने का समय । 'देखि मोहि पल जिमि जुग जाता ।' मा० २.२४८.६ (३) पलक, नेपुट । 'रहेउ ठठुकि एकटक पल रोकी ।' मा० ५.४५.३ (४) मांस । 'कलि मल पल पीन ।' कवि० ७.१४२
पलक : पल । (१) नेत्रपुट । 'पलक नयन इव सेवक त्रातहि ।' मा० ७.३०.३ (२) पल भर का समय । 'बासर जाहिं पलक सम बीती।' मा० २.२५२.१ 
पलकनि, न्हि : पलक+संब० । पलकों (ने) । 'जब पलकनि हठि दगा दई ।' कृ० २४ 'पलकन्हिहं परिहरी निमे।' मा० १.२३२.५ 
586 
_______________________________________________
पलक : पलक+ब० । कवि० २.२३
पलको : एक पलक भी । 'पलको न लावतीं।' कवि० २.१३
पलटि : पू० (सं० पर्यस्य>प्रा० पल्लट्टिअ>अ० पल्लट्टि) । (१) नीचे से ऊपर करके । 'उलटि पलटि लंका सब जारी।' मा० ५.२६.८ (२) बदल कर (३) उँडेल कर । 'पलटि सुधा ते सठ बिष लेहीं ।' मा० ७.४४.२
पलटे : भुकृ०० (सं० पर्यस्त>प्रा० पल्लट्ट) । (१) विपरीत, प्रतीप । 'उलटे पलटे नाम महातम ।' विन० २२८.४ (२) बदले में। 'पूजा लेत देत पलटे सुख ।' दिन २३६.२
पलना : पालने में । 'करि सिंगार पलनां पौढ़ाए।' मा० १.२०१.१
पलना : सं०० (सं० पालनक>प्रा० पालणअ)। पालना, बच्चों का झला । मा० १.१६८.८
पलिअहि : आ०कवा०प्रब० (सं० पाल्यन्ते>प्रा० पालीअंति>अ० पालीअहिं)। पाले जाते हैं, पाले जायें । 'बायस पलिअहिं अति अनुरागा।' मा० १.५.२
पलु : पल+कए । एक पल का समय । 'पवन के पूत को न कदिबे को पल गो।' कवि० ४.१
पलुहइ : आ०प्रए० (सं० प्ररोहते>प्रा० पलहइ) उगता-ती है; कल्ले फोड़ता-ती है । 'पुनि ममता जवास बहुताई। पलुहइ नारि सरद ऋतु पाई।' मा० ३.४४.६
पलहत : वकृ० । पनपती-ती है । 'पलु हत गरजत मेह ।' दो० ३१६
पलहावहिंगे : आ०भ.पु.प्रब० । पनपाएंगे, हरा भरा करेंगे। बिरह अगिनि जरि ____ रही लता ज्यों कृपादृष्टि जल पलुहावहिंगे।' गी० ५.१०.३
पलोटत : वकृ.पु. । दबाता-ते । 'पाय पलोटत भाइ।' मा० २.८६
पलोटिहि : आ०भ०प्रए० । दबाएगा-गी। पाय पलोटिहि सब निसि दासी।' मा० २.६७.५
पल्लव : सं०० (सं.)। किसलय । मा० १.८७.५
पल्लवत : वकृ.पु । पल्लवयुक्त होता-ते । बढ़ता, विकास लेता। 'पल्लवत फूलत नवल नित ।' मा० ७.१३.५
पल्लवनि : पल्लव+संब० । पल्लवों (से) । 'कपट दल हरित पल्लवनि छावौं ।' विन० २०८.२
पल्लवित : वि० (सं०) । पल्लव युक्त, परिवधित । मा० १.३४६
पवन : सं०० (सं०) । वायु । मा० १.७.६ 
पवनकुमार, रा : वायु पुत्र-हनुमान् । मा० १.१७; ५.२.३
पवनज : हनुमान । गी० ५.२१.२ .
पवनतनय : हनुमान् । मा० ५.०.६ तुलसो शब्द-कोश 
587 
पवननंदनु : अकेला हनुमान् । कवि० ६.४७
पवनपूत : हनुमान् । दो० ५५
पवनसुत : हनुमान् । मा० १.२६.६।।
पवनसुव : पवनसुत (सं० सुत>प्रा० सुअ)। हनु० १
पवनसुवन : हनुमान । रा०प्र० ३.५.४
पनि : पावनि । पवित्र । 'गावत तुलसिदास कीरति पनि ।' गी० ३.५.५ 
पवनु, न : पवन+कए० । वायु । 'पंथ कथा खर आतप पवन ।' मा० १.४२.४
पवमान : सं०० (सं०) । वायु । 'पाहुने कृसानु पवमान सो परोसो।' कवि० ५.२४
पवमानु : पवमान+कए । कवि० ७.४२
पवरि : पौरि । द्वार । 'पहिलिहि पवरि सुसामध भासुख दायक ।' पा०म० ११७
पवार: (सं० प्लावितेन, प्रवालितन>प्रा० पवालिएण>अ० पव्वालिएँ) । फेंकने . से । 'रज होइ जाइ पषान पवार ।' मा० १.३०१.३ 
पवारे : पबारे।
पवित्र : पबित्र । मा० ७.५५.१
पश्यन्ति : आ०पब० (सं.)। देखते हैं। मा० १ श्लोक २
पषान : सं०० (सं० पाषाण) । पत्थर । मा० १.८०.६
पषाननि : पषान+संब० । पत्थरों (से) । 'सुनियत सेतु पयोधि पषाननि ।' विन० २२६.४
पषाना : पषान । मा० २.२२०.७ 
पसाउ, ऊ : सं००कए० (सं० प्रसादः, प्रसादम् >प्रा० पसाओ, पसायं>अ० पसाउ) । (१) कृपा, अनुग्रह । 'सासति करि पुनि करहिं पसाऊ ।' मा० १.८६.३ (२) देव से प्राप्त वरदान रूप प्रसाद । 'पाइहै प्रेम पसाउ ।' विन० १००.१०
पसारत : वकृ०० (सं० प्रसारयत्>प्रा० पसारंत)। फैलाते । 'किलकत पुनि-पुनि पानि पसारत ।' गी० १.२३.४
पसारहिं : आ०प्रब० (सं० प्रसारयन्ति>प्रा० पसारंति>अ० पसारहिं)। फैलाते हैं । 'फरें पसारहिं हाथ ।' दो० ५२
पसारा : भूकृ.पुं० (सं० प्रसारित>प्रा० पसारिअ)। फैलाया। 'जोजन भरि तेहि बदनु पसारा।' मा० ५.२.७
पसारि : पू० । फैला कर । 'धावा बदन पसारि ।' मा० ६.७०
पसारी : (१) पसारि । 'चले उ गगन कपि पूछ पसारी ।' मा० ६.६५,४ (२) भूकृ०स्त्री० । फैलायी। 'तिन्हहि धरन कहुं भुजा पसारी।' मा० ६.६८.७ 
588 
_______________________________________________
' मा० 
पसीज : आ०प्रए० (सं० प्रस्विद्यते>प्रा. पसिज्जइ) । पसीज उठता है, द्रवीभूत हो जाता है । 'पाहनी पसीज ।' कृ० ४५
पसु : सं० (सं० पशु>प्रा० पसु) । जानवर, चौपाया । मा० १.८५.४ (२) पाश• बद्ध जीव । दे० पसुपति।।
पसुपति : सं०० (सं० पशुपति) । माया-जाल-बद्ध जीवों (पशुओं) के स्वामी= शिवजी । पा०म०/० १२
पसुपाल : पशुओं का रखवाला । विन० १३३.३
पसेउ : सं०पू०कए० (सं० प्रस्वेदः>प्रा० पसेओ>अ० पसेउ)। पसीना । 'तन पलेउ कदली जिमि कॉपी।' मा० २.२०.२
पस्यंति : पश्यन्ति । मा० ३.३२ छं० ४
पस्यामि : आ० उए० (सं० पश्यामि) । देखता हूं। मा० ६.१०७ छं०
पह: पहिं । पास से । 'रावन सिव पह लीन्हीं।' विन० १६२.३
पहर : सं०पू० (सं० प्रहर>प्रा. पहर) । लगभग चार घड़ी का
समय : मा० २.२०३
पहरी : वि०+सं०० (सं० प्रहरिन्) । पहरा देने वाला, सन्तरी, चौकसी करने वाला । 'पालिबे को कपि भालु बम जम काल करालहु को पहरी है।' कवि० ६.६ 
पहरु, रू : पहरी । 'नाथ ही के हाथ सब चोरऊ पहरु ।' विन० २५०.३
पहरू : पहरु । कवि० ७.३१
पहले : पहिले । 'साधु गनती में पहलेहि गनावौं ।' विन० २०८.३ 
पहार, रा : सं०पू० । पहाड़, पर्वत । मा० २.३४.१; ९८.७ 
पहरु, रू : पहार+कए० । एक पहाड़ । 'अवध सोध सत सरिस पहारू।' मा० २.६६.३
पहिं : अव्यय । पास, समीप, प्रति । 'पारबती पहिं जाइ तुम्ह....।' मा० १.७७
पहिचान : (१) संस्त्री० (सं० प्रत्यभिज्ञान>प्रा. पच्चहिआण)। परिचय । 'होइ प्रीति पहिचान बिनु ।' रा०प्र० २.२.५ (२) पहिचानइ। पहचानता है, पहचान सकता है । 'पहिचान को केहि जान ।' मा० १.३२१ छं. '
पहिचान, पहिचानइ, ई : (सं० प्रत्यभिजानीते>प्रा० पच्चहिआणइ) आ०प्रए । पहचानता है । सो प्रभुहि पहिचानई।' विन० १३५.२
पहिचानत : वकृ००। पहचानता-ने; जान जाते। 'बिनय सुनत पहिचानत प्रीती।' मा० १.२८.५
पहिचानहु : आ०मब० । पहचानते हो। 'पहिचानहु तुम्ह कहहु सुभाऊ ।' मा० १.२६१.६ _______________________________________________
589 
पहिचाना : (१) भूकृ००। जाना । 'तातें मैं प्रभु नहिं पहिचाना ।' मा० ४.२.६ (२) पहिचानई । 'निज हित अनहित पसु पहिचाना ।' मा० २.१६.१
पहिचानि : (१) प्रकृ० । पहचान । 'प्रभ पहिचानि परेउ गहि चरना।' मा० ४.२.५ (२) पहिचान कर । परिचय । 'बिनु पहिचानि प्रान हुँते प्यारी।' मा० १.३२२.६ तासों न करी पहिचानि ।' विन० १६०.५
पहिचानिहो : आ०भ०मब० । पहचानोगे। 'प्रनत प्रेम पहिचानिहो।' विन० २२३.२
पहिचानी : (१) पहिचानि । पहचान कर । 'हरषे हृदय हेतु पहिचानी ।' मा० १.३०७.३ (२) पहिचानि । परिचय । 'एहि सन हठि करिहउँ पहिचानी ।' मा० ५.६.४ (३) भूक०स्त्री० । जानी। 'रघुकुल तिलक नारि पहिचानी।" मा० ३.२६.७ (४) आ०कवा०प्र० । पहचाना जाय, जानिए । 'तुलसी ताहि संत पहिचानी।' वैरा० १४
पहिचानें : (१) पहचान में । 'करतल-गत न परहिं पहिचानें ।' मा० १.२१.५ (२) पहिचान के । 'जिमि भुजंग बिन रज पहिचानें ।' मा० १.११२.१
पहिचाने : (१) भूकृ००ब० । जाने । 'कोउ कह ए भूपति पहिचाने ।' मा० १.२२२.३ (२) पहिचानें । 'संग्रह त्याग न बिनु पहिचाने ।' मा० १.६.२
पहिचानेहु : आ०-भ०+आज्ञा-मब० । तुम पहचान जाना ! 'पहिचानेहु तब मोहि।' मा० १.१६६
पहिचान : पहिचानइ । 'पहिचान कोन काहि रे।' कवि० ५.१६ 
/पहिर, पहिरद : (सं० परिदधाति>प्रा० परिहइ) आ०प्रए । पहनता है। जिमि नूतन पट पहिरइ ।' मा० ७.१०६ ग
पहिरत : वकृ०पू० । पहनता, पहनते । देत लेत पहिरत पहिरावत ।' गी० १.४.८
पहिरहि : आ०प्रब० । पहनते हैं । 'पहिरहिं सज्जन बिमल उर।' मा० १.११
पहिराइ : पू० (सं० परिधाप्य>प्रा० परिहाविअ>अ० परिहावि)। पहना कर । 'बालि तनय पहिराइ । बिदा कीन्हि ।' मा० ७.१८ ख
पहिराई : भूकृ०स्त्री०ब० । परिधान युक्त की । 'चैल चारु भूषन पहिराई।' मा० १.३५३.४
पहिराई : भक०स्त्री० । पहनायी। 'पीत झगुलिआ तन पहिरई।' मा० १.१६६.११
पहिराए : भूकृ००ब० । (१) पहनाये । 'सीतहि पहिराए प्रभु सादर ।' मा० ३.१.४ (२) परिधान युक्त किये । 'पुर नर नारि सकल पहिराए।' मा० १.३५१.६ 
पहिरायउ, यो : भूकृ००कए ० । पहिनाया। 'बरहि बसन पहिरायउ।' पा०म० १२३
पहिरायो : पहिरायउ। गी० १.१७.३ 
550 
_______________________________________________
पहिरावत : वकृ०० (सं० परिधापयत् >प्रा० परिहावंत)। पहनाता। 'लसत ललित कर कमल माल पहिरावत ।' जा०म० १०६
पहिरावनि : संस्त्री (सं० परिधापना>प्रा० परिहावणा>अ० परिहावणी= परिहावणि) । परिधानोपहार; पहनावे की भेंट । 'रुचि बिचारि पहिरावनि दीन्ही ।' मा० १.३५३.५
पहिरावहि : आ०मए० । तू पहना । 'रचि रचि हार...... "राम नृपहि पहिरावहि ।' विन० २३७.४
पहिरावहु : आ०मब० । पहनावो । 'पहिरावहु जयमाल सुहाई।' मा० १.२६४.५
पहिरावौं : आ० उए । पहनाऊँ, पहनाती हूं। हार बेल पहिरावों चंपक होत ।' बर० १३
पहिरावो : पहिरावहु । 'पहिरावी राघो जू को सखियाँ सिखावतीं।' कवि० १.१३
पहिरि : पूकृ० । पहन कर । 'अगरी पहिरि कंडि सिर धरहीं।' मा० २.१६१.५
पहिरिअ : आ०कवा०प्रए० । पहना जाता है । 'खाइअ पहिरिअ राज तुम्हारें।' मा० २.१६.४
पहिरें: क्रि०वि० । पहने हए (पहन कर) । 'कहत चले पहिरें पट नाना ।' मा० १.२६६.१
पहिरे : भूकृपु०ब० । पहन लिये । 'कुडल कंकन पहिरे ब्याला ।' मा० १.६२.२
पहिलिहिं : पहली ही। 'पहिलिहिं पवरि सुसामध भा सुखदायक ।' पा०म० ११७
पहिलेहि : पहिले ही । मा० १.२२६
पहिलो : वि.पु.कए० (सं० प्रथमः>प्रा० पहिल्लो) । पहला । 'ऐसिओ मूरति देखे रह्यो पहिलो बिचारु ।' गी० १.८२.३
पहुंच : सं०स्त्री० (सं० प्रभुत्व>प्रा० पहुत्त>अ० पहुच्च)। गति, अधिकार । 'राजनीति पहुंच जहाँ लौं जाकी रही है ।' गी० ५.२४.१ ।।
पहुंचति : वकृ.स्त्री० । पहुंचती, अटती। 'बाहु बिसाल जानु लगि पहुंचति ।' गी० १.१७.७
पहुंचाइ : पू० । भेज कर, प्रेषित कर। 'गए ते प्रभुहि पहुंचाइ फिरे।' गी० २.६६.५
पहुंचाई : भूक०स्त्रो० ब० । भेजीं। 'सम सनेहें जननीं पहुंचाई।' मा० २.३२०.५
पहुंचाई : पहुंचाइ । 'आयसु पाइ फिरे पहुंचाई ।' मा० १.३६०.१०
पहुंचाउ : आ०-~आज्ञा-मए । तू पहुंचा। तहाँ मोहि पहुंचाउ।' मा० २.१४६
पहुंचाए : भूकृ००ब० । 'अति आदर सब कपि पहुंचाए।' मा० ७.१६.६
पहुंचाएसि : आ०-भूकृ०पु+प्रए० । उसने पहुंचाया। 'पहुंचाएसि छन माझ निकेता।' मा० १.१७१.७ _______________________________________________
591 
'पहुंचाव
पहुंचावड : आ.प्रए० (अ० पहच्चावइ) । गन्तव्य प्राप्त कराता है । 'जो पहुंचाव राम-पुर तनु अवसान ।' बर० ६७
पहुंचावन : भकृ० अव्यय । पहुंचाने, भेजने । 'संग चले पहुंचावन राजा ।' मा० १.३३६.४
पहुंचावहिं : आ० प्रब० (अ० पहुच्चावहिं) । पहुंचाते-ती हैं। ‘पहुंचावहिं फिरि मिलहिं बहोरी।' मा० १.३३७.७
पहुंचावा : भूकृ०० । पहुंचाया, साथ ले जाकर भेज दिया । 'कपि पुनि बैद तहाँ ___पहुंचावा।' मा० ६.६२.४
पहुंचि : पू० । पहुंचकर । कृ० ४५
पहुंचियां : पहुंची+ब० । हस्ता-भरण-विशेष । पंकज पानि पहुंचियां राजै ।' गी० 
पहुंची : (१) सं०स्त्री० । हस्ता-भरण-विशेष । 'पहुंची कर कंजनि ।' कवि० १.२ (२) भूक०स्त्री० ! गन्तव्य प्राप्त हुई । 'पहुंची जाइ जनेत ।' मा० १.३४३
पहुँचे : भूकृ.पुब० । 'मुनि आश्रम पहुंचे सुरभूपा।' मा० ३.१२.५ ।।
पहुचेहउ': आ० भ० उए० (अ० पहुच्चाविहिउँ) । पहुंचा दूंगा । 'पहुंचैहउ सोवतहि निकेता।' मा० १.१६६.८
पहुचाहि : पहुंचावहिं । पा०म० १४३ 
पहुनई, नाई : सं०स्त्री० (सं० प्रधुणता>प्रा० पहुणया) । आतिथ्य, अतिथि. सत्कार । 'भूप पहुनई करन पठाई।' मा० १.३०६.८
पहुनाई : पहुनाई में, अतिथि रूप में । 'दिन वें जनु औध हुते पहुनाईं।' कवि० २.२
पहुनाई : पहुनई । 'पहुनाई करि हरहु श्रम ।' मा० २.२१३
पांउ : पाउ । 'भयो रजायसु पांउ धारिए।' गी० ५.३५.२
पांगुरे : सं०० (सं० पङ्गल) पंगु । 'पांगुरे को हाथ पांय आँधरे को आँखि है ।' विन० ६६.३
पांच : पंच । मा० २.२४.१
पांच : पाँचै । पाँचवीं+पञ्चमी तिथि । विन० २०३.६
पाँचसर : पंचबाण (सं० पञ्चशर) । कामदेव । गी० ७.१८.१
पाँचहि : पंचों को, सभी जनवर्गों को। 'जौं पाँचहि मत लागइ नीका ।' मा० २.५.३
पांचा : पाँच । 'कहहिं परसपर मिलि दस पाँचा।' मा० २.२०६.२
पांचें : सं० स्त्री० (सं० पञ्चमी) । पाख की पांचवीं तिथि । पा०म० ५
पांचो : पञ्च भी, जनवर्ग भी । 'बहुरि पूंछिये पांचो।' विन० २७७.३
पछि : पू० (सं० प्रतक्ष्य>प्रा० पच्छिम> अ० पच्छि) । त्वचा छील कर, खुरच कर । मरम् पाछि जन माहुरु देई ।' मा० २.१६०.७ 
592 
_______________________________________________
पांडर : सं०पु. (सं० पाण्डर) । चमेली (पुष्प) । गी० २.४३.३
पांडव : पाण्डपुत्र = युधिष्ठिर, भीम, अर्जुन, नकुल और सहदेव । दो० ४२६
पांडवन : (पांडवन+इ) पाण्डवों को। 'प्रभ प्रसाद सौभाग्य बिजय जस पांडवन बरिआइ बरं ।' विन० १३७.४
पांडु : पाण्डवों के पिता का नाम । दो० ४१६
पांडुबधू : द्रौपदी । कवि० ७.८ ।
पांडसुत : पांडव । विन० १०६.४
पांडसुतन : पांड्सुत+संब० । पाण्डवों। पांडवन की करनी ।' विन० २३६.२ 
पोति, ती : संस्त्री० (सं० पङि क्त>प्रा० पंति)। (१) श्रेणी । मा० १.६६.७ (२) जेवनार में उच्च-नीच के अनुसार बिठाई जाने वाली पंगत । "छोटी जाति पाति ।' कवि० ७१८
पाय : (१) पाय । पर। पांगरे को हाथ पांय ।' बिन०६६.३ (२) पायें। पैरों पर । 'महरि तेरे पाय परौं।' कृ०७।।
पायनि : पायन्ह । पैरों में । 'पैजनी पायनि बाजति ।' गी० १.३२.२
पांव : पाउँ । पैर । 'क हैं सब सचिव पुकारि पाँव रोपि हैं ।' कवि० ६.१
पांवड़े : सं०० (सं० पादपट>प्रा. पावड= पावडय) ब० । पैरों के नीचे स्वागतार्थ बिछाये जाने वाले वस्त्र । “पट पांवड़े परहि बिधि नाना।' मा० १.३१६.३
पांवर : पावर । 'पांवर पूजहिं भूत।' दो० ६५
पांवरनि : पांवर+संब० । नीच जनों । 'पाँवरनि पर प्रीति । विन० २१४.१ 
पांवरि, रो : पावरी । 'खड़ाऊँ । 'पांवरि पुलकि लई है।' गी० २.७८.२ रा०प्र० २.५.५
पांसुरी : पसली से । 'मसक की पांसुरी पयोधि पाटियतु है। कवि० ७.६६
पांसुरी : सं.स्त्री० (सं० पशू>प्रा० पंसू पंसुल्ली-पंसुली) । पसली, वक्ष के पार्श्वभाग की हड्डी।
पांसे : पासे । 'भली भाँति भले पैत भले पसेि परिगे।' गी० २.३२.४
पा: पाय (सं० पाद>प्रा० पा) । चरण, पर। 'मारतहूं पा परिब तुम्हारें।' मा० १.२७३.७
पाइँ : पायें। पैरों में । 'पाई पनह्यो न ।' गी० २.२७.३
पाइ : (१) पाय । पैर । "पाइ तर आइ रह्यो।' कवि० ७.१६६ (२) पूक० (सं. प्राप्य>प्रा० पाविअ>अ० पावि) । पाकर । 'खलउ करहिं भल पाइ सुसंगू।' मा० १.७.४ 
पाइअ, य, ये : आ०कवा०प्रए० (सं० प्राप्यते>प्रा० पावीअइ) । पाया जाता है। 'सुनत श्रवन पाइअ बिश्रामा।' मा० १.३५.७ _______________________________________________
593 
पाइअहिं : आ०कवा०प्रए (सं० प्राप्यन्ते>प्रा० पावीअंति>अ० पावीअहिं) । पाये जाते हैं, पाई जाती हैं । 'बेगि पाइअहिं पीर पराई।' मा० २.८५.२ 
पाइए, ऐ : पाइअ । 'बस्तु बिनु गथ पाइए ।' मा० ७.२८ छं०
पाइक : वि०+सं०० (सं० पायिक =पादातिक>प्रा० पाइक्क) । पैदल अनुचर आदि । 'सरव करहिं पाइक फहराहीं।' मा० १.३०२.७
पाइन्हि : आ०भूकृ०+प्रब० । उन्होंने पाये । 'जन्म फल पाइन्हि ।' पा०म० ७५
पाइब : भकृ०० (सं० प्राप्तव्य>प्रा० पाविअव्व) । पाना (होगा, होता है)। 'बड़े भाग पाइब सतसंगा।' मा० ७.३३.८
पाइबी : पाइब+स्त्री० । पानी (होगी)। 'समय पाइबी थाह ।' दो० ४४६
पाइबे : पाइब का रूपान्तर । पाने । 'सुगम उपाय पाइबे केरे।' मा० ७.१२०.१२
पाइयो : पाइब+कए । पाना (होगा) । पाया जायगा । 'पाइबो न हेरो।' विन० १४६.४ 
पाइमाल : वि० (फा० पायमाल==बर्बाद) । नष्ट । 'देहि सिय, न तो पिय, पाइमाल जाहिगो।' कवि० ६.२३
पाइय : पाइअ । 'जेहि गाये सिधि होइ परम निधि पाइय हो।' रान० १
पाइये : पाइए । विन० ३५.२
पाइहह : आ०भ० मब० (सं० प्राप्स्यथ>प्रा० पाविहिह>अ० पाविहिह) । पावोगे। "पुनि मम धाम पाइहहु ।' मा० ६.११६ घ
पाइहि : आ०भ० प्रए० (सं० प्राप्स्यति>प्रा० पाविहिइ)। पायेगा। 'राम धाम पथ पाइहि सोइ।' मा० १.१२४.२
पाइहैं : (१) आ०भ०प्रब० । पायेंगे। 'पार प्रयास बिनु नर पाइहैं।' मा० ६.१०६ छं० (२) उब० । हम पाएँगे । 'सुखु पाइहैं कान सुनें बतियाँ।' कवि० २.२३
पाइहै : (१) पाइहि । वह पायेगा । 'अंध कहें दुख पाइहै ।' दो० ४८१ (२) बरा बरी करेगा । 'को त्रिभुवनपति पाइहै।' गी० ५.३४.२ (३) मए । तू पायेगा। 'सुरसरि तीर बिन नीर दुख पाइहै ।' विन० ६८.२
पाइहौं : आ०भ० उए' (सं० प्राप्स्यामि>प्रा० पाविहिमि> अ० पाविहिउँ) । पाऊँगा । 'सब सुख पाइहौं ।' मा० २.१५१ छं०
पाइहो : पाइहहु । 'जहाँ तहाँ दुख पाइहो।' दो० ७१
पाई : भक०स्त्री०ब० । प्राप्त की । 'मन भावती असीसें पाईं।' मा० १.३०८.६
पाई : (१) भूक०स्त्री० । प्राप्त की । 'असुर देह तिन्ह पाई।' मा० १.१२२.५ (२) पाइ । पाकर । 'सठ सुधरहिं सत संगति पाई ।' मा० १.४.६
पाउँ : पाउ । पैर । 'पाउँ देइ एहि मारग सोई।' मा० ७.१२६.४ 
594 
_______________________________________________
पाउ : पाय+कए० । एक पैर । 'जीवन पाउ न पाछे धरहीं। मा० १.१६२.२ (२) एक चौथाई-पाव । 'राम रावरे बनाए बने पल पाउ में ।' विन० २६१.१
पाउब : पाइब । 'तो तुम्ह दुख पाउब परिनामा ।' मा० २.६२.३
पाऊँ : पावौं । विन० ७५.३
पाऊ : पाउ । चरण । 'कृपा करिअ पुर धारिअ पाऊ।' मा० १.८८.७
पाएँ : (१) पाने से । 'प्रम फल पढ़ें किएँ अरु पाएँ ।' मा० ३.२१.६ (२) पाकर, पाए हुए (स्थिति में) । 'कौतुक देखहिं अति सचु पाएँ ।' मा० १.३२१.७ (३) (सं० पादाभ्याम्>प्रा० पाएहिं) पैरों से । 'मारग चलहु पया देहिं पाएँ।' मा० २.११२.५
पाए : (१) भूकृ००ब० । प्राप्त किये । 'अधम सरीर राम जिन्ह पाए ।' मा० १.१८ (२) पाएँ । पैरों से । 'गवने भरत पयादेहिं पाए ।' मा० २.२०३.४ (३) पाएँ । पाने पर । 'पाए पालिबे जोग मंजु मग ।' गी० ३.३.२
पाएह,हूं : पाने पर भी । 'पाएहुं ग्यान भगति नहिं तजहीं।' मा० ३.४३.१०
पाक : सं०० (सं.)। (१) पक्वान्न । 'आपु गई जहं पाक बनावा ।' मा० १.२०१.३ (२) एक दैत्य का नाम-दे० पाकरिपु (३) पकाने का पात्र (४) शिशु । अंजनी कुमार सोध्यो राम पानि पाक हौं ।' हनु० ४० (५) वि०० (सं० पक्व>प्रा० पक्क)। पका हुआ। 'जनु छुइ गयउ पाक बरतोरू ।' मा० २.२७.४
पाकत : व.पु. । पकता हुआ, पकते हुए । 'ईति भीति जस पाकत साली ।' मा० २.२५३.१
पाकरि : पाकरी । मा० ७.५७.५
पाकरिप : पाक नामक दैत्य के शत्रु =इन्द्र । मा० २.३०२.२
पाकरी : सं०स्त्री० (सं० पर्कटी>प्रा० पक्कडी) । पीपल के समान वृक्षबिशेष ।  मा० ७.५६.६
पाकारि : पाकरिपु । इन्द्र । विन० २६५
पाकारिजित : इन्द्रजित् । मेधनाद । विन० ५८.४
पाकारिसुत : इन्द्र-पुत्र जयन्त । विन० ४३.५
पाकी : भूकृ०स्त्री० (सं० पक्वा>प्रा० पक्की) । प्रौढ़, पुष्ट । 'धन्य पुन्य रत मति  सोइ पाकी ।' मा० ७.१२७.७
पाके : पके हुए.. में । 'पाके छत जनु लाग अंगारू ।' मा० २.१६१.५ पाके भूकृ००ब० (सं० पक्व>प्रा० पक्क =पक्कय)। पके हुए। दो० ५१० _______________________________________________
595 
'पाख : सं०० (सं० पक्ष>प्रा. पक्ख) । मास का अर्धभाग (शुक्ल-कृष्ण-पक्ष) । "सम प्रकास तम पाख दुहं ।' मा० १.७ ख (२) पन्द्रह दिन का समय । 'कहहु पाख महुं आव न जोई ।' मा० ४.१९.५
पाखंड : सं०० (सं०) । नास्तिक, दैव पर आस्था न रखने वाला। रा०प्र० ७.२.३
'पाखंडबाद : नास्तिक मत । जिमि पाखंडबाद तें लुप्त होहिं सद ग्रंथ ।' मा० ४.१४
पाखु : पाख+कए० । पन्द्रह दिन भर । 'भयउ पाखु दिन सजत समाजू ।' मा० २.१६.३
'पाग : संपु० (सं० पाक>प्रा० पाग)। जलाव में बनाया हुआ पक्वान्न । जलाव । कवि० ५.१४
पागि : पूक । पाग (जलाव) में साँध कर । 'नाना पकवान' 'पागि पागि ढेरी कीन्ही ।' कवि० ५.२४
पागिहै : (१) आ०भ०प्रए० । वह पाग में सौंद कर बनाएगा । 'लंक पधिलाइ पाग पागिहै।' कवि० ५.१४ (२) मए । तू पागेगा । 'राम नाम मोदक सनेह सुधा पागिहै।' विन० ७०.४
'पागी : (१) भूक०स्त्री० । मिठाई के रस में डाल कर सम्पन्न की। 'बचन रचना बीर रस पागी ।' मा० १.२६३.६ 'शुद्ध मति जति पति प्रेम पागी।' विन० ३६.२ (२) पागि । 'बोली बचन नीति रस पागी।' मा० ५.३६.५
पागे : भूक००ब० । जलाव में बनाए हुए। 'बचन.. प्रेम रस पागे।' मा० १.१४६.७
पाछ : अव्यय (सं० पश्चात् >प्रा० पच्छा) पीछे । 'चितयउँ पाछ उड़ात ।' मा० ७.७६ क
पाछिल : वि.पु० (सं० पश्चाद्भव>प्रा० पच्छिल्ल)। पिघला (अतीत) । 'पाछिल मोह समुझि पछिताना।' मा० ७.६३.३
पाछिलि : पाछिली । 'प्रीति करइ नहिं पाछिलि बाता । मा० ३.४३.७
पाछिली : पाछिल+स्त्री० (अ० पच्छिल्ली-पच्छिल्लि)। पिछली (अतीत)।  परिहरु पाछिली गलानि ।' विन० १६३.६
पाछिले : 'पाछिल' का रूपान्तर+ब. (प्रा० पछिलय) । पिछले । हनु०४ 
पाछे, छै : पाछे । (१) बाद में । 'जेहिं न होइ पाछे पछिताऊ।' मा० २.४.५ (२) पीछे, पश्चाद् देश में । 'फिर चितवा पाछे प्रभु देखा ।' मा० १.५४.५ (३) पीछे छिपने से, शरण लेने से । 'बाँचिहे न पाछै तिपुरारिहूं मरारिहूं के।' कवि० ६.१
पाछे : क्रि०वि० (सं० पश्चात् >प्रा० पच्छा>अ० पच्छइ)। पीछे की ओर । "पाछे पाउ न दीन्ह ।' रा०प्र० ५.७.५