_______________________________________________
399 
ढहै : आ०भ०प्रब० । ढहा देंगे, ध्वस्त कर भूमिसात् करेंगे । कवि० ६.१०
ढोटनि : ढोटा+संब० । बालकों। 'जस रावरो लाभ ढोटनि हूं।' गी० १.५०.१
ढोटा : संपु । बालक । 'तैसेइ भप संग दुइ ढोटा ।' मा० १.३११.३।
ढोटो : ढोटा+कए । यह एक बालक । 'कोसिक, छोटो से ढोटो है काको।' कवि० १.२०
ढोल : सं०० (सं०) । वाद्य विशेष । मा० १.२६३.१
ढोल : ढोल+कए । 'कहेउ बजाउ जुझाऊ ढोलू ।' मा० २.१६२.३
ढोव : सं.पु० (सं० ढोक>प्रा. ढोव-भार)। उपहार-संभार । 'ल ले ढोब प्रजा प्रमुदित चले।' गी० १.२.११ 
तबोलिनि : संस्त्री० (सं० ताम्बलिनी>प्रा० तंबोलिणी>अ. तंबोलिणि)। ताम्बल व्यवसायी स्त्री। रान०६
त : (१) अव्यय (सं० तु)। तो । 'नयन मदि न त चलिअ पराई। मा० १.६४.४ (२) (सं० तदा, तर्हि) तब, तो। 'जौं नृप तनय त ब्रह्म किमि ।' मा० १.१०८ "कहहु न हमहि न खोरि ।' मा० १.१६५ (३) (सं० तद्>प्रा० त) सर्वनाम । तिन्ह, ता, ते आदि का मूलरूप
तंतु : सं०० (सं०) तागा, सूत्र । विन० ५४.४
तई : भूक स्त्री० (सं० तप्ता>प्रा तविई) । तची हुई । 'काल के प्रताप कासी तिहुं ताप तई है।' कवि० ७.१७५ 
तर, ऊ : अव्यय (सं० तदपि>प्रा० तयि) तो भी, तथापि । 'तउ न तजा तनु प्रान अभागें ।' मा० २.१६६.६ 'तऊ न उबरन पावहिं ।' कृ० ४
तए : भूक००ब० (सं० तप्त>प्रा० तविय) । तचे हुए । 'सब अँग परिताप तए हैं।' गी० ६.५.१
तक : सं०० (सं० तर्क>प्रा० तक्क) । ताकने की क्रिया। 'दोउ लोचन दिन अरु रनि रहत एकहि तक ।' गी० ५.६.२ (एकहि तक-एक टक ही)। 
Vतक, तकह: (सं० तर्कयति.>प्रा० तक्कइ-ताकना, टकटकी लगाना, लक्ष्य साधना, घुरना, लक्षित करना)। प्रा० प्रए० । ताकता-ती है । 'जिमि गवं तकइ जेउँ केहि भौति ।' मा० २.१३.४ 
400 
_______________________________________________
तकत : वकृ. (सं० नर्क प तात) । ताकता-ते। 'तरनि तकत उलूक ज्यों।' विन० २२२.२ 
तकहि, ही : आ०प्रब० (सं० तर्कयन्ति >प्रा० तति >अ० तक्कहिं) । ताकते हैं। 'भूप बचन सुनि इत उत तकहीं।' मा० १.२६७.८
तकहु : आ० मब० (सं० तर्कयत>प्रा० तक्कह>अ० तक्कहु) । ताको, देखो, खोजो। _ 'तकहु गिरि कंदर ।' मा० ६६६.७
तकि : पू० । ताक कर (लक्ष्य साध कर) । तकि तकि तीर महीप चलावा ।' मा० १.१५६.३ .
तकिया : सं०स्त्री० (फा०
तकिय:-आराम की जगह, सिरहाने रखने की चीज) । उपधान, आश्रय । 'मोसे दीन दूबरे को तकिया तिहारियें ।' हनु० २२
तक : आ०.आज्ञा-मए० (सं० तर्कय>प्रा० तक्क>अ० तक्कु) । तू देख, खोज, लक्ष्य कर । 'तुलसी तक ताहि सरन ।' विन० १३३.५
तके : भूकृ००ब० (सं० तकित>प्रा० तक्किय) । खोजे, लक्ष्य कर चले । 'देवन्ह तके मेरु गिरि खोहा ।' मा० १.१८२.६
तकेउ : भूकृ००कए । तोका, लक्ष्य किया । 'सियहि बिलोकि तकेउ धन कसें ।' मा० १.२५६.८
तकै : तकहिं । 'बनिता सूत भौंह तक सब वै।' कवि० ७.४१०
तक : तकइ । 'तक नीचु जो मीचु साधु की।' विन० १३७.२
तक्यो : तके उ । 'जनु तक्यो तड़ाग तृषित गज ।' गी० २.६८.३ 
तग्य, रा : वि. (सं० तज्ज) । उस विषय का ज्ञाता, तत्त्व द्रष्टा । 'सोइ सर्बग्य तग्य सोइ पंडित ।' मा० ७.४६.६
तज : तजु । तू छोड़ दे । 'तो तज बिषय बिकार ।' विन० २०५.१ 
तिज, तजइ, ई : (सं० त्यजति >प्रा० तजइ-छोड़ना) आ०प्रए० । छोड़ता है। 'तदपि न मग मग तजइ नरेसू ।' मा० १.१५७.६ (२) छोड़ सकता है। परंतु पन राउ न तजई।' मा० १.२२२.४
तजउँ: आ० उए । छोड़ता-ती हूं; छोड़ सकता-ती हूं। 'तजउँ न नारद कर उपदेसू ।' मा० १.८१.६
तजउ : आ.--आज्ञा, संभावना---प्रए । वह छोड़ दे (उसे छोड़ देना चाहिए)। 'सो पर नारि.....'तजउ ।' मा० ५.३८.६
तजत : वक००। छोड़ता, ते । 'तजत बमन जिमि जन बड़ भागी।' मा० २.३२४
तजन : भकृ० । छोड़ना, छोड़ने को। 'तजन चहत सुचि स्वामि सनेही ।' मा० २.६४.३
तजब : भक०० । छोड़ना (चाहिए) । 'तजब छोभु ।' मा० २.६६.५ 
तहिं, हीं : आ०प्रब० । छोड़ते हैं । 'जो दुखु पाइ तजहिं तनु प्राना।' मा २.८१.७ 
_______________________________________________
401 
तजहि : आ०-प्रार्थना, आज्ञा-मए । तू छोड़ दे। 'सुदरि तजहि संसय महा।' मा० ६.६६ छं०
तजहु : आ०मब० । (१) छोड़ो। “संसय तजहु गिरीस ।' मा० १.७० (२) छोड़ देते हो । 'तुम्ह तजहु त काह बसाइ ।' मा० २.७१
तजा : भूकृ०० । छोड़ा । ‘राज तजा सो दूषन काहीं।' मा० १.११०.६
तजि : पूक० । छोड़कर । 'तब तजि दोष गुनहिं मनु राता।' मा० १.७.१ 
तजिअ, ए, तजिय, ये : आ०-कवा०प्रए० । छोड़िए, छोड़ दिया जाय, छोड़ना चाहिए । 'नीति न तजिअ राजपदु पाएँ।' मा० २.१५२.३ 'तुलसी तजिय कुचालि ।'क० ४६ 'तजिये ताहि कोटि बरी सम ।' विन० १७४.१
तजिहउँ' : आ०भ०उए । छोड़गा-गी। 'तजिहउँ तुरत देह तेहि हेतू ।' मा० १.६४.७
तजी : भूक स्त्री० । छोड़ी। 'तजी समाधि संभु अबिनासी ।' मा० २.६०.२
तनु : मा०-आज्ञा-मए । तू छोड़ । 'तजु संसय भजु रामपद ।' मा० १.११५
तजे : छोड़ने से, पर । 'प्रभु सर प्रान तजें भव तरऊँ।' मा० ३.२३.४
तजे : भूक००ब० । छोड़ दिये । 'निमि तजे दिगचल ।' मा० १.२३०.४
तजेउ : मा०-भक०पु+उए । मैंने छोड़ा । 'सो तनु तजेउ ।' मा० ७.१०६ ख
तजेउ : भूक००कए। छोड़ा, छोड़ गया। 'कोउ न मान मद तजेउ निबेही।' मा० ७.७१.१
तजेहि : छोड़ने से-में-पर ही । 'हरि बियोग तनु तजेहि परम सुख ।' कृ० ५६
तजेहु : आ० (१) भूकृ००+मब० । तुमने छोड़ा-छोड़े। 'मम हित लागि तजेहु 
पितु माता ।' मा० ६.६१.४ (२) भवि०+प्रार्थना-+मब० । तुम छोड़ना । __'सेवक जानि तजेहु जाति तजेहु जनि नेहू ।' मा० ३.६.३
तजेंगे : आ०म०पू०प्रब० । छोड़ देंगे । 'अंतहु तोहि तर्जेंगे पामर ।' विन० १९८.३
तज : तजइ। (१) छोड़ता है। ‘मीन जल बिनु तलफि तनु तज।' कृ० ५४ (२) छोड़े, छोड़ सके । 'चरन सरोरुह नाथ जनि कबहुं तर्ज मति मोरि ।' मा० ३.४ (३) तजहि । तू छोड़ता है । 'तू न त अब ही ते।' विन० १६८.३
तजौं : तजउँ । छोड़ दूं । 'भागो तुरत तजौं यह सैला।' मा० ४.१.५
तज्ञ : तग्य । विन० १२.५
तज्यो : तजेउ । 'हौं तज्यो लखन सो भ्राता!' गी० ६.७.२
तट : सं०० (सं०) । तीर, किनारा । मा० ३.२३.७
तटन्हि : तट+संब० । तटों (पर)। 'डारहिं रत्न तटन्हि नर लहहीं।' मा० ७२३.६
तटिनी : सं०स्त्री० (सं०) । नदी । कृ० २० तड़ाग
गा : सं०० (सं० तटाक = तडाग) । ताल, सरोवर । मा० ७.३१.७ ७.२३.१० 
402 
तुलसी शब्द कोश
तड़ागु : तड़ाग+कए । वह एक सरोवर । 'बागु तड़ागु बिलोकि प्रभु हरषे ।' मा० १.२२७
तड़ित : सं०स्त्री० (सं० तडित्) । बिजली । मा० १.१४७ 
तत्, द् : सर्वनाम (सं०) । वह, उसे । मा० ७.१३० श्लो० १
ततकाला : क्रि०वि० (सं० तत्काल)। उसी समय, तत्क्षण, तुरन्त । 'मज्जन फलु पेखिअ ततकाला।' मा० १.३.१
तत्पर : वि० (सं०) । उसी एक में संलग्न । मा० ४ श्लो०१
तत्र : क्रि०वि० अव्यय (सं.) । वहाँ । 'यत्र हरि तत्र नहि भेदमाया ।' विन० ४७.५
तत्रैव : (तत्र+एव-सं०) । वहीं, वहाँ हो । विन० ५७.५
तत्त्व : सं०प० (सं.)। (१) निष्कर्ष, सार, मर्म । 'तत्त्व प्रेम कर मम अरु तोर ।' मा० ५.१५ (२) रहस्य, अन्तर्निहित वस्तु स्वरूप । 'गूढ़उ तत्त्व न साधु दुरावहिं ।' मा० १.११०.२ (३) सांख्य भाव जो सर्वान्तर्यामी हो। 'वेद तत्त्व नृप तव सुत चारी।' मा० १.१९८.१ (५) वैष्णव दर्शन में तीस तत्त्व-दे० तत्त्व विभाग।
तत्त्वदरसी : वि०० (सं० तत्त्वशिन्) । तत्त्व द्रष्टा, मर्मज्ञ, विश्व रहस्य का ज्ञाता, ब्रह्मज्ञानी । विन० ४७.६
तत्वाविभाग : सांख्यशास्त्र के २५ तत्वों का
वर्गीकरण-प्रथमत: प्रकृति और पुरुष (चेतन तत्त्व); फिर प्रकृति का परिणाम महतत्त्व (बुद्धि); उसका विकार अहंकार । प्रकृति और पुरुष अव्यक्त तत्त्व हैं । प्रकृति के विकारों से व्यक्तत्त्व बनते हैं । जो २३ हैं जिनमें से दो ऊपर आ चुके हैं। अहंकार के सात्त्विक (वैकृत), राजस (तेजस) और तामस (भूतादि) भेद होते हैं जिनसे आगे के २१ परिणाम बनते हैं --राजस या तैजस अहंकार शेष दोनों के साथ रहता है। सात्त्विक+राजस से ११ तत्त्वों का परिणाम होता है-मन, ज्ञानेन्द्रिय पञ्चक तथा कर्मेन्द्रियपञ्चक । तामस+तेजस अहंकार से पांच तन्मात्र (शब्द, रूप, रस, स्पर्श और गन्ध) परिणत होते हैं जिन्हें सूक्ष्मभूत कहा गया है। इन्हीं सूक्ष्म भूतों का परिणाम स्थूल महाभूत हैं---आकाश, तेज, जल, वायु और पृथ्वी । 'बरनहिं तत्त्वबिभाग ' मा० १४४ वैष्णव दर्शन में ईश्वर काल, कर्म, गुण और स्वभाव मिलाकर ३० तत्व हैं । मा० ७.२१
तत्त्वमय : वि० (सं०) तत्त्व स्वरूप, निगूढ रहस्यरूप (ब्रह्मस्वरूप)। 'जोगिन्ह परम तत्त्वमय भासा ।' मा० १.२४२.४
तथा : क्रि०वि० अव्यय (सं०) । उस प्रकार, वैसे । मा० १.११४.४
तथापि : क्रि०वि० अव्यय (सं.)। उस प्रकार से भी, फिर भी, वैसे भी । मा० १.१६४.८
तदपि : (तद्+अपि-सं०) तो भी, तथापि । मा० १.६.६ 
_______________________________________________
403 
सदभ्रात : उसका भाई। विन० ५८.३
तद्यपि : तदपि (यद्यपि के सादृश्य पर बनाया हुआ शब्द) । 'परम प्रबल रिपु सीस पर तद्यपि सोच न त्रास ।' मा० ६.१०
तन : (१) तनु (फा०)। शरीर । मा० १.१.३ (२) अव्यय । ओर, प्रति । 'चितइ जानकी लखन तन ।' मा० २.१००
तनक : वि० (सं० तृणक) । स्वल्प, तुच्छ । 'बातहू केतिक तिन तुलसी तनक की।' कवि० ७.२०१
तनको : तनक भी, थोड़ा-सा भी। 'जाग न बिराग त्याग तीरथ न तनको।' कवि० ७.७७
तनये : तनय ने, पुत्र ने । 'तेहि पर वांधेउँ तनय तुम्हारे ।' मा० ५.२२.५
तनय : सं०पू० (सं) । पुत्र । मा० १.८८.१
तमरुह : तनोरुह (सं० तनुरुह) । रोम, रोएँ । गी० १.१.२
तनाए : भूकृ००ब० (सं० तानित>प्रा० तणाविय)। फैलाए, विस्तार में लगवाये । 'धुजा बितान तनाए।' गी० १.६.६
तनियां : सं०स्त्री० (सं० तनी)। (१) परिधान कसने-बांधने का सूत्र, कमरबंद दि । 'कटि किकिनी कलित पीत पट तनियाँ ।' गी० १.३४.२ (२) करधनी, कटिसूत्र । 'तनियां ललित कटि ।' कृ० २
तनी : भूक०स्त्री० । विस्तृत की, फैलायो । गी० ७.५.५
तनु : तन+कए। शरीर । 'प्रिय तनु तन इव परिहारेउ।' मा० १.१६ (२) सं०स्त्री० (सं.)। शरीर । 'बिष्नु जो सुर हित नर तनु धारी।' मा० १.५१.१
तनुजा : सं. स्त्री. (सं०)। पुत्री। मा० १.१७८.२
तनूज : सं०पु० (सं०) । पुत्र ।
तनूजो : पुत्र भी। पाल्यो ज्यों काहुं न बाल तनूजो।' कवि० ७.५ (तनू शरीर से जना हुआ भी)
तने : तनय । पुत्र । 'भए राजहंस बायस तन ।' गी० ५.४०.३
तनोतु : आ०-प्रार्थना-प्रए० (सं०) । करे, फैलाए । मा० ३.११.१६
तनोरुह : सं०० (सं० तनूरुह, तनुरुह) । रोम । मा० ७.५.३
तप : (१) तपइ । 'रबि तप जेतनेहि काज ।' मा० ७.२३ (२) सं०पु० (सं० तपस्) । तपस्या, साधना । 'भृगुपति गए बनहि तप हेतू ।' मा० १.२८५.७ (३) (सं० तप) ग्रीष्म । 'बिनु तप तेज कि कर बिस्तारा ।' मा० ७.६०.५ (तप तपस्या+ग्रीष्म) तप
तपइ : (१) (सं० तपति-तप दाहे>प्रा० तप्पइ.-जलाना) (२) सं० तपति, तप्यते-तप सन्तापे>प्रा० तप्पइ-~-तचना, सन्तप्त होना, जलना) आ०प्रए० । जलता है, तचता है। 'तपइ अवां इव उर अधिकाई ।' मा. १.५८.४ 
404 
_______________________________________________
तपत : (१) व कृ०० । जलाता, दाहक तेज फेंकता । 'काल करम गुन सुभाउ सब के सीस तपत ।' विन० १३०.३ (२) तचता, जलता । 'तुलसी तपत तिहु ताप जग ।' गी० १.५.६ (३) (सं० तप्त)। तचा हुआ, गर्भ, तपाया हुआ। 'बारिद तपत तेल जनु बरिसा।' मा० ५.१५.३
तपन : सं०० (सं०) । सूर्य । विन० ५५.४
तपनि : सं०स्त्री० । तपने की क्रिया, दाह, सन्ताप । 'तुलसी कोटि तपनि हरै।' वरा० २१
तपसानल : तपस्या रूपी अग्नि । कवि० ७.५५
तपसालि : वि.पु.० (सं० तपः शालिन्) । तपस्वी। मा० १.३३०
तपसिन्ह : तपसी+संब० । तपस्वियों । 'मम पुर बसि तपसिन्ह पर प्रीति ।' मा ५.४१.५
तपसी : वि०० (सं० तपस्वी) । तपस्या करने वाला । मा० ७.१०१ छं.
तपस्या : सं०स्त्री० (सं.)। समाधि आदि की निष्ठा के साथ कठोर संयम जीवन चर्या ।' मा० १.७८.१
तपस्वी : तपसी (सं.)। तापस । विन० ५५.४
तपहिं : तप में । 'बिसरी देह तपहिं मनु लागा।' मा० १.७४.३
तपिहै : आ०भ० मए । तू तपेगा, सन्तप्त होगा। तो लौ तू कहूं जाय तिहूं ताप तपिहै ।' विन० ६८.१
तपी : वि.पु । तपस्वी । 'द्विज चिन्ह जनेउ उघार तपी।' मा० ७.१०१ छं०
तपु : तप+कए० । वही एकमात्र तपश्चर्या । करै सो सपू जेहिं मिलहिं महेसू। मा० १.७२.२
तपोधन : वि० (सं.) । तपस्ती (जिसका तप धन धन है)। मा० १.१०५
तप्त : भूकृ०वि० (सं०) । तपा हुआ। 'तप्त कांचन ।' विन० ५०.२
तब : अव्यय । उस समय । मा० १.७.१ 
तबहि, हीं : तभी, उसी समय । मा० १.७७.८ त 
बहुं, हूं : तब भी, उस समय भी। मा० १.१२७.८
तम् : सर्वनाम (सं०) । उसे, उसको मा० १.श्लोक ६
तम : सं०० (सं० तमस्) । (१) अन्धकार । 'सम प्रकास तम पाख दुहुँ । मा० १.७ ख (२) प्रकृति के तीन गुणों में अन्य तम= तमोगुण । (३) अविद्या, अज्ञान, अविवेक । 'जीव हृदय तम मोह बिसेषी ।' मा० ७.११७.७
तमकि : पू० । तमतमाकर, आवेशयुक्त होकर, क्रुद्ध होकर । 'तमकि धरहिं धनु मूढ़ नृप ।' मा० १.२५०
तमकप : सं०१० (सं० तमःकूप = अन्धकूप) । अन्धा कुआ, इतना गहरा कि उसके भीतर कुछ सूझता न हो (२) अज्ञान रूपी कूप । ' पर्यो भीम तम-कप ।' विन १४४.५ तुलसा शब्द-कोश 
405 
तमकूपक : तमकूप ।
तमके : भूक पुब० । तमतमा उठे, रोषावेश से भर गये । 'तमके धननाद से बीर पचारि के ।' कवि० ६.१५
तमक्यो : भू० कृपु०कए० । तमतमा उठा, रोषाविष्ट हुआ। 'दुसासन दुरजन तमक्यो तकि दुई कर गहि सारी।' कृ० ६०
तमचुर : सं०पु० (सं० ताम्रचूड>प्रा० तंब चूड)। मुर्गा, कुक्कुट (पक्षिविशेष)। गी० १.३६.१
तमतोम : सं०पु० (सं० तमःस्तोम>प्रा. तमत्थोम)। अन्धकार समूह । गी० १.१६.३
समपर : वि० (सं० तमःपर) । अन्धकार, अविद्या तथा तमोगुण से परे-त्रिगुणा 
_तीत, मायातीत । विन० ५५.४
तमसा : संस्त्री० (सं०) । नदीविशेष । मा० २.८४
तमाइ : संस्त्री० (अरबी-तम-खाहिश, लालच) । लोभ, इच्छा । 'लोक परलोक को बिसोक सो तिलोक, ताहि तुलसी तमाइ कहा काहू बीर बान की।' हनु० १३ 
तमारि, री : सं०पु० (सं० तमोरि) । अन्धवार का शुभ = सूर्य । मा० २.८६; २७२.४
तमाल : सं०० (सं०) । वृक्षविशेष जिसकी शाखाएँ नीली होती हैं। मा० २.११५.६
तमाला : तमाल । नील जलज तनु स्याम तमाना ।' मा० १.२०६.१
तमी : सं०स्त्री० (सं.)। रात्रि । मा० ५.४७.३
तमीचर : निशाचर । मा० ६.७४ ख
तये : तए। 
तयो, यो : भूकृ०००कए० (सं० तप्तः>प्रा० तविओ)। सन्तप्त । 'तयो है तिहूं ताव रे ।' हनु० ३७
तर : सं०+क्रि०वि० (सं० तल) । नीचे, निचला भाग । 'प्रभु तरु तर कपि डरि पर।' मा० १.२६ क (२) समीप, सामने । 'अब न आखि तर आवत कोऊ।' मा० १.२६३.५ (३) नीचे में। 'पर्नकुटी तर बैठे हैं।' कवि० ३.१ (४) अल्प, अवर, लघु । 'पुन्य सिलोक तात तर तोरें।' मा० २.२६३.६ (५) अधीनता में, वश में । 'सो कि बंध तर आवइ।' मा० ६.७३ (६) तरह। पार करता है। 'भव निधि तर नर बिमहिं प्रयासा।' मा० ७.५५.६ (७) (अतिशयार्थक संस्कृत प्रव्यय) अधिक, बढ़कर । 'होहिं बिषयरत मंद मंद तर।' मा० ७.१२१.११ 
406 
_______________________________________________

तरंग, गा : (१) सं०स्त्री० (सं० तरङ्ग-पु.)। लहर । मा० १.३२.१४ (२) स्वर-लहरी। 'करहिं गान बहु तान तरंगा।' मा० १.१२६.५ (३) उल्लास । 'नाहिं नाना रंग तरंग बढ़ावहिं ।' पा०म० ६३ 
तरंगिनि, नी : सं०स्त्री० (सं० तरङ्गिणी) । नदी । मा० २.३४.१
तरंगी : वि०पू० (सं० तरङ्गिन)। मानसिक तरंगों वाला, उल्लासयुक्त, स्वतन्त्र, सनकी, नशे में धुत्त । 'परम तरंगी भूत सब।' मा० १.६३
तरंति : आ०प्रब० (सं० तरन्ति>प्रा० तरंति) पार करते हैं । दुस्तरं तरंति ते।' मा० ७.१२३ श्लोक १ Vतर
तरई : (सं० तरति-त
पल्वन-तरणयो:>प्रा० तरह-उतरना, उतराना, आल्पावित होना, पार जाना, तैरना) आ.प्रए । पार जाता है। गुरु बिनु भवनिधि तरइ न कोई।' मा० ७.६३.५ 
तरउँ, ऊँ : आउए । पार करूँ । 'प्रभु सर प्रान तजें भव तरऊँ।' मा० ३.२३.४
तरक : सं०स्त्री० (सं० तर्क-पु.) । (१) युक्ति । 'तासु तरक तिय गन मन मानी।' मा० २.२२२.५ (२) अनुमान । 'मन महुं तरक करै कपि लागा।' मा० ५.६.२ (३) वाद-विवाद, सन्देहवाद, वितर्क-दे० तरका
तरकस : सं०पू० (फा० तरकश) । तूणीर, तीर रखने का चोंगा । मा० २.१६०
तरकसी : छोटा तरकस । गी० १.४२.२
तरका : तरक। विवाद । 'दूषहि श्रुति करि तरका।' मा० ७.१००.४
तरकि : प्रक० । (१) तर्क कर, युक्ति लगा (कर) । 'तरकि न सकहिं सकल अनुमानी ।' मा० १.३४१.७ (२) तड़क कर, कूदकर । 'तरकि चढ़े उ कपि खेल ।' मा० ६.४३
तरकी : भूक स्त्री० । तर्क की (हुई), युक्ति या अनुमान से जानी (हुई)। 'प्रीति प्रतीति जाइ नहिं तरकी ।' मा० २.२८६.५ तरके
उ : भूक००कए । तड़क गया, फांद गया । 'तरके उ पवन तनय बल भारी।' मा० ५.१.६
तरजत : तर्जत।
तरजति : वक०स्त्री० । डाँटती। 'तरजनिन्ह तरजति ।' कृ० ११
तरजनिन्ह : तरजनी+सं० ० । तर्जनियों से (कई वार तर्जनी अंगुली चमकाने से)। गरजति कहा तरजनिन्ह तरजति ।' कृ० ११
तरजनी : सं०स्त्री० (सं० तर्जनी) । हाथ के अंगूठे के पास की अंगुली (जिससे तर्जन किया जाता है) । मा० १.२७३.३
तरजि : पूक० । तर्जन करके, डाँटकर, भय दिखाकर । 'उपल बरषि गरजत तरजि ।' दो० २८३ 
_______________________________________________
407 

तरजिए, ये : आ०कवा०प्रए । डाँटिए । 'सरुष बरजि तरजिये तरजनी कुम्हिल है कुम्हड़े की जई है।' विन० १३६.८
तरत : व.पु. । पार करता-करते । 'यह लघु जलधि तरत कति बारा ।' मा० 
तरन : (१) सं०० (सं० तरण) । पार जाना । 'सिंधु तरन कपि गिरि हरन ।' दो० ४४५ (२) वि.पुं० । पार करने वाला । 'होत तरन तारन नर तेऊ ।' मा० २.२१७.४ (३) भक० अव्यय (सं० तत्त म>प्रा० तरिउ>अ० तरण)। पार करना । 'भव सागर चाहे तरन ।' विन० १७३.६ (४) सं००-नौका। गी० ५.४३.५
तरनि : (१) सं०० (सं० तरणि) । सूर्य । “तहँ कि तिमिर जहँ तरनि प्रकासू।' मा० २.२६५.७ (२) सं० स्त्री० । नाव । 'हथवांसहु बोरहु तरनि ।' मा० २.१८६
तरनिउ : नाव भी । 'तरनिउ मनि घरनी होइ जाई ।' मा० २.१००.६
तरनी : तरनि । (१) सूर्य । 'भे पुनीत पातक तम तरनी।' मा० २.२४८.१ (२) नाव । 'करउँ कथा भव सरिता तरनी।' मा० १.३१.४ (३) पार करने वाली।
तरनु : तरन+कए । पार जाना । 'सेत सागर तरनु भो।' कवि० ६.५६
तरपन : सं०पू० (सं० तर्पण) । देवों तथा पितरों को जल देने की धार्मिक क्रिया । मा० २.१२६.७
तरपहिं : आ०प्रब० । तड़पते हैं; बिजली की फुर्ती से गति लेते हैं । 'अति तरल तरुन प्रताप तरपहिं ।' मा० ६.४१ छं०
तरल : वि० (सं.)। चञ्चल, फुर्तीला, वेगशील । 'अस कहि तरज त्रिसूल चलायो।' मा० ६.७४.६ (२) द्रवीभूत ।
तरवारि : सं०स्त्री० (सं.)। तलवार । मा० २.३१.१
तरसत : वकृ.पु. (सं० तर्षत् >प्रा० तरिसंत) । तृषाकुल होता-ते । इच्छापूर्ति के बिना क्लेश पाते । 'हम पँख पाइ पीजरन तरसत ।' गी० २.६६.४
तरस्यो : भूकृपु०कए० (सं०
तृषित:>प्रा० तरिसिओ)। तृष्णाकुल हुआ, ललचाया। 'त्यों रघुपति पद पदुम परस को तनु पातकी न तरस्यौ।' विन० १७०.४ 
तरहि, हीं : आप्रब० (सं० तरन्ति >प्रा० तरंति->अ० तरहिं) । पार करते हैं। ___'तरहिं भव प्रानी।' मा० ७.१०३.१ ‘भव बारिधि गोपद इव तरहीं।' मा० १.११६.४
तरहि : आ०मए ० । तु पार जा। 'तुलसीदास भव तरहि ।' वि० २३७.५
तराक : तड़-तड़ ध्वनि के साथ । 'बैठो तोरि तरकि तराक हौं।' हनु० ४० 
408 
_______________________________________________
तरि : (१) पू० । पार कर, तर (कर)। 'तरि सके सरित सनेह की।' मा० २.२७६ छ० (२) सं०स्त्री० (सं.)। छोटी नाव । 'बहुत पतित भवनिधि तरे बिनु तरि बिनु बेरे।' विन० २७३.२ 
तरिअ, ए : आ०कवा०प्रए० (सं० तीर्यते>प्रा० तरीअइ) । पार किया जाय ।  'केहि बिधि तरिअ जलधि गंभीरा।' मा० ५.५०.५
तरित : क्रियाति० । तरता, पार पाता। 'घोर भव अपार सिंधु तुलसी किमि तरित।' विन० १६.३
तरिने : भकृ०० । पार करने (योग्य) । 'नेह निधि निज भुजबल तरिबे हो।' कृ. ३६ 
तरिय, ये : तरिअ । 'पर हित कीन्हें तरिये।' विन० १८६.३
तरिहउँ : आ०भ० उए० (सं० तरिष्यामि>प्रा० तरिहिमि>अ० तरिहिउँ । तरूँगा, __ पार करूँगा। ‘पद पंकज बिलोकि भव तरिह।' मा० ७.१८.७
तरिहहिं : आ०म०प्रब० । पार करेंगे । 'गाइ गाइ भव निधि नर तरिहहिं ।' मा० 
तरिहि : आ०म०ए० (सं० तरिष्यति>प्रा० तरिहिइ तरिही)। पार करेगा गी। 'बिनु प्रयास सागर तरिहि सकल भालु कपि धारि ।' मा० ५.५० सो श्रम बिनु भव सागर तरिही।' मा० ६.३.४
तरिहैं : तरिहहिं । पार जायंगे । ते कुल जुगल सहित तरिहैं भव ।' गी० १.१६.४
तरी: भकृ०स्त्री० । पार गई, तर गई। 'जे पद परसि तरी रिषि नारी।' मा० ५.४२.६
तरीवन : सं०पू० । तर्योना, कान का बाला, कर्णाभरणविशेष । रा०न० ११
तर : सं०० (सं.)। वृक्ष । मा० १.२६ क
तरुजीबी : वि० (सं० तरुजीविन्) । वृक्ष व्यवसायी। दो० ३४१
तरुन : वि०पू० (सं० तरुण) । (१) युवक । 'तब मैं तरुन रहेउ बल भारी।' मा० ४.२६.८ (२) प्रौढ़, पुष्ट, प्रखर ।। 'तिमिरु तरुन तरनिहि मकु गिलई।' मा० २.२३२.१ (३) विकसित, पूर्ण विकास युक्त । तरुन अरुन अंबुज सम चरना।' मा० १.१०६.७
तरनतर : अत्यन्त तरुण । विन० २१८.२
तरुनता : सं०स्त्री० (सं० तरुणता) । जवानी । विन० १६४.७
तरुनाई : तरुनता। मा० ४.२८.२
तरुनि : तरुनी। दो० ४३८
तरुनी : वि०स्त्री० (सं० तरुणी)। युवती । मा० १.११.२
तरुवर : श्रेष्ठ वृक्ष । मा० २.११६.८ 
_______________________________________________
409 
तरुवरन्ह : तरुवर+संब० । तरुवरों । 'जिन्ह तरुवरन्ह मध्य बटु सोहा।' मा० २.२३७.३
तरु : तरु। मा० ७.१२१.१६
तरे : भूकृ.पुब०। (१) तैरे, उतराये। सिंधु तरे पाषान ।' मा० ६.३ (२) उतर गये, पार पा गये । 'खल नर तरे।' विन० २११.१
तरेरी : पूक० । तरेर कर, अमर्षपूर्वक तिरछा करके । 'कहत दसानन नयन तरेरी।' मा० ६.२२.३
तरेरे : भूक.पुब०। (१) वक्र किये । 'नयन तरेरे राम ।' मा० १.२७८ (२) वक्र किये हुए (मुद्रा में)। 'खिझे तें डाटत नयन तरेरे ।' कृ० ३
तर : तरइ । पार जाय । 'जो न तरै भवसागर ।' मा० ७.४४
तरंगी : आ.भ.स्त्री०प्रए । तर जायगी। 'गौतम की घरनी ज्यों तरनी तरंगी मेरी।' कवि० २.८
तरो: (१) तर्यो। 'कपि कटक तरो।' विन० २२६.४ (२) आ०-संभावना प्रए० (सं० तरतु>प्रा० तरउ) । तर जाय, पार उतर जाय । 'राम नाम बोहित, भव सागर चाहे तरन तरो सो।' विन० १७३.६
तरौं : तरउ । पार कर जाऊँ । 'गोपद ज्यों भवसिंधु तरौं।' विन० १४१ 
तर्क : सं.पु. (सं.)। (१) उलझी युक्ति । 'खेद खिन्न मन तर्क बढ़ाई।' मा० ७.५६.२ (२) न्याय में अपुष्ट अनुमान । 'दुष्ट तर्क सब दूरि बहाई ।' मा. ७.४६.८ (३) आनुमानिक कल्पना । 'रामहि भजहिं तर्क सब त्यागी।' मा० ६.७४.२ (४) युक्ति ।
तक : पूकृ० । तर्क द्वारा ज्ञात कर ; 'तकि न जाहिं बुद्धि बल बानी ।' मा० ६.७४.१
तर्जत : वकृ.पु । डांटता-डराता। 'गर्जत तर्जत सन्मुख धावा।' मा० ६.६०.२
तर्जन : वि०पू० । तरजने वाला। भय दिखाने वाला । मा० ३.११.१३ 
तर्जहि, ही : आ०प्रब० । डाँटते-डराते हैं। मा० ३.१८.८; ५.३ छं० २
तर्जा : भकृ०पू० । तर्जन किया, डाँटा । 'बाली अति तर्जा ।' मा० ४.८.२
तर्पन : तरपन । दो० ३०४
तर्यो : भूकृ००कए। (सं० तीर्णः>प्रा० तरिओ)। तर गया। 'सुनि सुनि लोक तर्यो।' विन० २३६.२
तर्ष : सं०पु० (सं.) । तृषा, तृष्णा, वासना, विषय-लालसा, तरसना । 'तम तर्ष गण.. विच्छेदकारी ।' विन० ५७ ७
तल : सं०० (सं.)। (१) चौरस भाग, ऊपरी भाग । 'परेउ धरनि तल सुधि कछु नाहीं।' मा० ६.८३.७ (२) प्रदेश । 'नभ तल ।' हनु० ५ (३) अधोभाग। 'काम तून तल सरिस जानु जग ।' गी० ७.१७.५ (४) पर, में, नीचे (दे० तर)। 'सकल सिद्धि करकमल तल ।' रा०प्र० ६.४.१ 
410 
_______________________________________________
तलफत : वक०० (अरबी-तलफ़ =हलाक)। छटपटाता, तिलौंछता, तिल मिलाता, तड़फड़ाता । 'तलफत मीन पाव जिमि बारी।' मा० ५.२८.५
तलफति : वकृस्त्री० । (आंच में) छटपटाती, खोलती। कनक कराही लंक तलफति ताय सों।' कवि० ५.२४ ।
तलफि : पू० । तड़फड़ा कर, छटपटा कर, (मरणासन्न) तिलमिलाकर । 'मीन जल बिनु तलफि तनु तजै।' कृ०५४ ।।
तलई : तलाई+ब० । तलैयाँ, पोखरियाँ। 'संगम करहिं तलाव तलाई।' मा० १.८५.२ 
तलाव, वा : सं०पू० (सं० तडाग>प्रा० तलाय) । ताल, पोखर, जलाशय । 'बन सागर सब नदीं तलावा।' मा० १.६४.४
तल : तल+कए । 'जगती तलु ।' विन० २४.६
तल्प: सं०पू० (सं०) । शय्या । विन० ५४.६
तव : सम्बन्धार्थक सर्वनाम (सं०) । तेरा-तेरी-तेरे । मा० १.५१.६
तवा : सं०० (सं० तपक>प्रा० तवअ)। लेहि आदि का छिछला पात्रविशेष । ___'तुलसी यह तन तवा है, तपत सदा त्रयताप ।' वैरा०६ 
तवानन : तेरा मुख । मा० ७.५२ ख
तस : वि०० (सं० तादृश>प्रारिस>अ० तइस) । वैसा । जेहि जस रघुपति _ करहिं जब, सो तस तेहि छन होइ।' मा० १.१२४
तसकर : सं०पु० (सं० तस्कर) । चोर । विन० १२५.८
तसि : बि००स्त्री० (सं० तादशी>अ० तइसी तइसि)। सी। तसि पूजा चाहिअ जस देवता ।' मा० २.२१३.७
तह : अव्यय (सं० तत्र>प्रा० तहि, तह) । वहाँ। मा० १.५५.१
तहई : वहाँ हो । 'तहँइ दिवसु जहँ भानु प्रकासू ।' मा० २.७४.३
तहउ': तहहुँ । 'तहउँ तुम्हार अलप अपराधू ।' मा० २.२०७.७
तहहुँ : वहाँ भी । 'तहहुँ सती संकरहि बिबाहीं।' मा० १.६८.६
तहवाँ : तह । वहाँ। 'बहुरि मातु तहवाँ चलि आई।' मा० १.२० १.४
तहसनहस : नष्ट-भ्रष्ट, सत्यानास । कवि० ५.२
तहाँ : तहँ । मा० १.१३.२
तहिा : क्रिवि० अव्यय (सं० तदा>प्रा० तइआ) । तब । 'धरिहहिं बिस्नु मनुज तनु तहिआ।' मा० १.१३६.६
तहीं : तहँई। वहीं । 'जाब जहँ पाउब तहीं।' मा० १.९७ छ०
तहूं : (१) तहँउँ । वहाँ भी। खेलउँ तहूं बालकन्ह मीला।' मा० ७.११०.४ (२) तू भी । 'तहूँ बंधु सम बाम ।' मा० १.२८२ 
तांति, ताँती : संस्त्री० (सं० तन्त्री प्रा. तंती)। तारों वाला वाद्य-वीणा आदि । 'बाज सुराग कि गाँडर तांती।' मा० २.२४१.६ 
_______________________________________________
411 
ता : 'त' सर्वनाम का रूपान्तर । उस । 'ता कहँ यह बिसेष सुखदाई।' मा० ७.१२८.८ ताको, तातें, तासो, ताकी, तामहिं आदि परसर्गीय प्रयोग द्रष्टव्य हैं।
तांडव : सं०० (सं०) । उद्धत नृत्य, उग्र नर्तन (जो शिव के लिए प्रसिद्ध है)
तांडवित : वि० (सं०) । ताण्डवयुक्त । विन० १०.५
तांबूल : सं०पू० (सं०) । पान । विन० ४७.३
ताइ : पू० (सं० तापयित्वा =प्रा० ताविअ>अ० तावि)। तपा कर, आंच देकर (खरी परीक्षा लेकर) । 'और भूप परखि सुलाखि तौलि ताइ लेत।' कवि० ७.२४
ताउ : ताय+कए । ताव, रोषावेश । 'भगुनाथ खाइ गए ताउ ।' विन० १००.५
ताए : भूकृ०००। (सं० तापित>प्रा० ताइय-ताविय) । तचाए हुए, सन्तापित, क्लेशित । 'नाथ बियोग ताप तन ताए।' मा० २.२२६.४ 
Vताक, ताकइ : तकइ । देखता है, विचारता या चाहता है। 'ताकै जो अनर्थ सो समर्थ एक आंक को।' हनु० १२
ताकत : (१) वकृ.पु -तकत । देखता, देखते । (२) संस्त्री० (अरबी ताकत) शक्ति । 'उपमा तकि ताकत है कबि कौं की।' कवि० ७.१४३ ।
ताकर : (ता+कर) उसका। मा० १.१६७.७
ताहि : तकहिं । देखते हैं, लक्ष्य करते। 'जे ताकहिं पर धन पर दारा।' मा० २.१६८.३
ताका : भूकृ०० (सं० तकित>प्रा० तक्किअ)। देखा, लक्ष्य किया, सोचा बिचारा, चाहा । 'जस कौसिला मोर भल ताका ।' मा० २.३३.८
ताकि : तकि । लक्ष्य करके, सोच-समझकर । 'तमकि ताकि तकि सिव धनु धरहीं।' मा० १.२५०.७
ताकिसि : आ०-भकृस्त्री०+प्रए० । उसने लक्षित की, निश्चित की। 'तब ताकिसि रघुनायक सरना।' मा० ३.२६.५ ताकि
है : आ०भ०प्रए । ताकेगा, घूर कर देखेगा। 'ताकि है तमकि ताकी ओर को।' विन० ३१.१
ताकी : (१) ताकि । मा० २.२२८.४ (२) (ता+की) उसकी। 'कोन ताकी कानि ।' विन० २१५.२
ताकें : (१) (सं० तकितेन>प्रा० तक्किएण>अ० तक्किएँ) ताकने से । 'जिमि गज हरि किसोर के ताकें ।' मा० १.२६३.४ (२) (ता+के) उसके प्रति, उसके लिए। ‘मंगल सगून सुगम सब ताके ।' मा० १.३०४.१
ताके : (१) (ता+के) उसके । 'ताके जुग पद कमल मनावउँ ।' मा० १.१८.८ (२) भूक पुब० । देखे, लक्षित किये । 'सरन को समरथ तुलसिउ ताके हैं।' गी० १.६४.४ 
412 
_______________________________________________
ताकेउ : तकेउ । लक्ष्य किया । 'ताकेउ हर कोदंडु।' मा० १.२५६
ताके : ताकद
ताको : (१) आ०-आज्ञा-मए । देखो । 'साखी बेद पुरान हैं, तुलसी तन ताको। विन० १५२.१३ (२) (ता+को) उसका । 'तहँ ताको काज सरो।' विन० २२६.५
ताग : सं०० (प्रा० तग्ग) । धागा, सूत्र, डोरा । मा० १.११
ताज : सं०पु+स्त्री० (फा०) । मुकुट, टोपी । 'मानो खेलवार खोली सीस ताज बाज की।' कवि० ६.३०
ताजी : सं०० (सं० ताजीय) । ताज देश का घोड़ा, तुर्की या ईरानी अश्व । मा० ३.३८.६
ताटंक : सं०० (सं०) । तरकी, कर्णाभरण, कर्णपूर । मा० ६.१३ क
'ताटका : ताटक । मा० ६.१३.६
ताड़का : सं०स्त्री० (सं०) । एक राक्षसी जो सुबाहु और मारीच की माता थी। मा० १.२०६.५
ताड़त : वकृ०० (सं० ताडयत्>प्रा० ताउंत)। ताड़न (प्रहार) करता-ते । मा० ३.३४.१
ताड़न : सं० (सं.)। प्रहार, पीटना । 'उर ताड़न बहु भाँति पुकारी।' मा० ६.७७.७
ताड़ना : सं०० (सं०) ताड़ना । “उर ताड़ना करहिं ।' मा० ६.१०४.४ थाप या ताल, करतल प्रहार; फटकार; प्रशिक्षण परक वाचिक व्यापार; कामशास्त्री प्रहजन-ढोल गँवार सूद्र पसु नारी । सकल ताड़ना के अधिकारी। मा० ५.५६.६ ताड़
का : ताड़का।
तात : सं०पू० (सं०) । (१) पिता । 'तात मात गुर सखा तूं सब बिधि हितु मेरो।' विन० ७६ (२) सम्मान्य, माननीय । 'बिनती करउँ तात कर जोरें।' मा० २.६६.१ (३) स्निग्ध जन, प्रिय बन्धु आदि । 'नतरु तात होइहि बड़ दोषू ।' मा० २.७१.५ (४) ममता भाजन । 'तात जाउँ बलि बेगि नहाहू।' मा० २.५३.१ (५) क्लेशादि सूचक प्रयोग में-बाप-रे-बाप । 'तात तात तौं सिअत ।' मा० ५.१५ (६) वि०० (सं० तप्त>प्रा० तत्त) । उष्ण
तातप्यमाव : वकृ०० (सं०) । बार बार अतिशय सन्ताप पाता हुआ। मा० ७.१०८/०१६
ताता : तात । (१) पिता, स्निग्ध, प्रिय, सम्मान्य आदि । 'मागहु बर प्रसन्न मैं ताता ।' मा० १.१७७.२ (२) उष्ण । 'सब जगु ताहि अनल हुँते ताता।' मा. ३.२.८ 
_______________________________________________
413 
ताति : वि०स्त्री० (सं० तप्ता>प्रा० तत्ती>म० तत्ति) । उष्ण । 'भुई तरनिहुं ते __ ताति ।' विन० २२१.३ ताते . (ता+तें) इससे, इस कारण । 'तातें मैं तेहि बरजउँ राजा।' मा०. 
ताते : (१) तातें । 'ताते मैं अति अलप बखाने ।' मा० १.१२.६ (२) (दे० तात) उष्ण, दाहक । पिय बिन तिहि तरनिहंते ताते ।' मा० २.६५.३
तातो : (१) तात+कए । उष्ण (२) क्रियाति००ए० । तो सन्तप्त होता । 'तुलसी राम प्रसाद सों तिहुं ताप न तातो।' विन० १५१.६
तान : सं०० (सं०) । (१) विस्तार (२) संगीत के रागों में स्वरालाप या स्वर विस्तार । 'करहिं गान बहु तान तरंगा।' मा० १.१२६.५
तानत : वक०० । फैलाता, फैलाते । 'लख्यो न चढ़ावत, न तानत, न तोरतहू गी० १.६२.५
तानि : पूकृ० । खींचकर, फैलाकर । 'पुनि धनु तानि कोपि रघुनायक ।' मा० ६.६६५
तानिहैं : आ०भ०प्रब० । खींचेंगे, फैलाएंगे। 'बय किसोर बरजोर बाहुबल मेरु मेलि गुन तानि हैं। गी० १.८०.६
तानी : (१) तानि । 'धायउ दस हु सरानन तानी ।' मा० ६.६३.२ (२) आ०भ० प्रए० (सं० तानयिष्यति>प्रा० ताणिटी)। खींचेगा, संधान करेगा । 'कोपि रघनाथ जब बान तानी ।' कवि० ६.२०
ताने : भूकृपुं०ब० । चढ़ाए, फैलाये, खींचे। मा० ६.५०.४
तानेउ : भूकृ००कए । ताना, खींचा। 'ताने उ चाप श्रवन लगि ।' मा० ६.६१
तान्यो : तानेउ। विन० ८८.१
ताप : सं० (सं०) । (१) दाह, ऊष्मा। 'नाथ बियोग ताप तन ताए ।' मा० २.२२६.४ (२) त्रिताप । 'तुलसी यह तन तवा है तपन सदा त्रय ताप ।' वैरा०६
तापघ्न : वि० (सं०) । सन्ताप-नाशक । विन० ५५.४
तापत्रय : तीन प्रकार के क्लेश-(१) आध्यात्मिक-शारीरिक पीडा आदि तथा मानसिक चिन्ता आदि (आधि-व्याधि); (२) दैविक = शीत, उष्ण आदि; (३) भौतिक प्राणियों से मिलने वाले दुःख । 'बदन मयंक तापत्रय मोचन ।' मा० १.२१६.६
तापस : वि० (सं०)। तपस्वी । मा० १.२३.३
तापनि : तापस-संब०। तपस्वियों। पालिबी सब तापसनि ज्यों।' गी० ७.२६.३
तापसी : तापसी+ब० । तपस्विनियाँ ! कवि० ६.५०
तापसी : तापस+स्त्री० । तपस्विनी । गी० ७.२६.२ 
414 
_______________________________________________
तापसु: तापस+कए० । वह तपस्वी । जिमि तापस कथइ उदासा।' मा० ७.१६२.५
तापह : (दे० ह) तापघ्न । मा० ३ श्लोक १
तापहर : वि० (दे० हर)। ताप हरण करने वाला, तापनाशक । मा० २.२४६.६
तापहि :
आ०प्रब० : तापते हैं, शीत से बचने हेतु अपने को उष्ण बनाते हैं । 'हरे चरहिं तापहिं बरे।' दो० ५२
तापा : ताप । 'दैहिक दैविक भौतिक तापा ।' मा० ७.२१.२
तामरस : सं०पु० (सं०) । कमल । मा० ३.११.३
तामरसु : तामरस+कए । 'परसत तुहिन तामरसु जैसें।' मा० २.७१.८
तामस : (१) सं०० (सं०) । तमोगुण (अज्ञानकारी प्रकृति का गुण जिससे ज्ञान पर आवरण पड़ जाता है) । तामस बहुत रजोगुण थोरा ।' मा० ७.१०४.५ (२) वि०पू० । तमोगुणी, अज्ञानावरणयुक्त, मोहग्रस्त । 'तामस असुर देह तिन्ह पाई।' मा० १.१२२.५
तामसो : तामस भी, तमोगुणी भी। 'जाके भजे तिलोक तिलक भए त्रिजग जोनि तन तामसो।' विन० १५७.४
ताय : सं०० (सं० ताप>प्रा. ताय) । (१) संताप दाह, आँच । 'कनक कराही लंक तलफति ताय सौं।' कवि० ५.२४ (२) सन्ताप की अनुभूति, तचन की वेदना । —तुलसी जागे तें जाय ताप तिहूं-तिहूं ताय रे ।' विन० ७३.४
तायो : भूक००कए । तचाया, जलाया हुआ। 'ग्रीषम के पथिक ज्यों धरनि तरनि तायो।' गी० ५.१५.२
तार : ताल (संगीत में) । 'काम करतल तार ।' गी० ७.१८.५
तारक : सं०० (सं०)। (१) नक्षत्र (२) एक असुर जिसे कार्तिकेय ने मारा था (३) आँख की पुतली । 'रुचिर पलक लोचन जुग तारक स्याम ।' गी. ७.१२.१ (४) वि०पू० (सं.)। तारने वाला, पार पहुंचाने वाला। 'भवतारक ।' विन० १४५.६
तारकमै : वि० (सं० तारकमय)। नक्षत्रों से पूर्ण । 'मनो रासि महातम तारकम ।' कवि० २.१३
तारक : तारक+कए । तारकासुर । मा० १.८२.५
तारति : वकृ०स्त्री० (सं० तारयन्ती>प्रा. तारंती) । आप्लावित 
करती, भिगोती, धोती : गी० ५.१६.२
तारन : वि० । तारने वाला, पार पहुंचाने वाला। होत तरन तारन नर तेऊ ।' मा० २.२१७.४
तारनतरन : (दे० तरन) । पार ले जाने की नौका । 'पाहि कहें काहि कीन्हो न तारनतरन ।' गी० ५.४३.५ (तारनतरन-पार ले जाने वाली नाव-वे स्वयं दूसरों के लिए नाव बन गये ।) 
_______________________________________________
415 
तारय : आ०-प्रार्थना-मए० (सं०) । पार पहुंचाओ। 'तारय संसृति दुस्तर ।' मा० ६.११५.६
तारा : (१) सं०० (सं० तारक>प्रा० तारअ)। नक्षत्र । 'अवनि न आवत एकउ तारा ।' मा० ५.१२.८ (२) सं०स्त्री० (सं०) । नक्षत्र । ‘मंदिर मनि समूह जनु तारा।' मा० १.१६५.६ (३) आँख की पुतली (४) वानर-राज बालि की पत्नी । मा० ४.११.२
तारागन : नक्षत्र समूह । मा० ६.३
तारि : पूक० । तार कर, सद्गति देकर । 'सिला तारि पूनि केवट मीत कियो।' गी० ५.४६.२
तारिबो : भकृ००कए । तारना (चाहिए)। 'तुलसी ओ तारिबो।' कवि० ७.१८
तारिहो : आ.-म०-मब । तारोगे, पार पहंचाओगे। तो तुलसिहि तारिहो बिप्र ज्यों ।' विन० ६६.३
तारी : (१) भूक०स्त्री० (सं० तारिता)। पार पहुंचाई (संसारमुक्त की)। 'राम एक तापस तिय तारी।' मा० १.२४.६ (२) संस्त्री० (सं० ताली)। हथेली, हथेली से ताल देने की क्रिया, थपेड़ी। 'बाहिं ढोल देहि सब तारी।' मा० ५.२५.७
तारु : आ०-आज्ञा-मए । तू उतार, (तौल कर तराजू से उतार)। 'पन औ कुवँर दोऊ प्रेम की तुला धौं तारु ।' गी० १.८२.३
तारुण्य : सं०० (सं०) तरुनाई । तरुण अवस्था । विन० ५१.१
तारे : (१) भूकृपुब० (सं०
तारिता:>प्रा० तारिया) । पार पहुंचाये । 'गजादि खल तारे घना।' मा० ७.१३० छ० १ (२) सं०० ब० । आँख की पुतलियाँ । 'एकटक लोचन चलत न तारे।' मा० १.२४४.३ (३) नक्षत्र । 'जनु राकेस उदय भएँ तारे।' मा० १.२४५.१
तारेह : आ०-भकृ००+मब० । तुमने तारे-पार पहुंचाये। 'तो कत बिप्र ब्याध गनिकहि तारेह, कछ रही सगाई।' विन० ११२.२
तारो : तारा+कए० (सं०
तारक:>प्रा. तारओ>आ० तारउ) । एक नक्षत्र । 'टि तारो गगन मग ज्यों होत छिन छिन छीन ।' गी० २.५८.२
तार्यो : भूकृपु०कए० (सं० तारितः>प्रा० तारिओ)। पार पहुंचाया । 'निज आतमा न तार्यो ।' विन० २०२.३
ताल : सं०० (सं.) (१) संगीत का ताल । अनुहरि ताल गतिहि नटु नाचा ।' मा० २.२४१.४ (२) वाद्य विशेष जिस से ताल दिया जाता है। 'बाहिं ताल पावाउज बीना ।' मा० ६.१०.६ (३) करताल (वाद्य)। 'कपाल ताल बजाइ जोगिनि नंचहीं।' मा० ३.२० छं० १ (४) ताड़ वृक्ष । 'कदलि ताल बर धुजा पताका ।' मा० ३.३८.२ (५) ताली का शब्द । उड़त अध विहग सुनि ताल 
416 
_______________________________________________
करतालिका ।' विन० ४८.२ (६) (सं० तल्ल) =तलाव । सरोवर । 'गिरि 
बन नदी ताल छबि छाए।' मा० ३.१४.२
तालऊ : ताड़ वृक्ष भी। 'तालऊ बिसाल बेधे ।' कवि० ६.११
ताला : ताल । सरोवर । मा० ७.५७.६
तालिका : सं०स्त्री० (सं.)। हथेली। हाथ का चिकना प्रसृत भाग । विन० ४८.२
तालू : (१) ताल+कए । एक ताड़ वृक्ष । 'दामिनि हनेउ मनहुं तरु तालू ।' मा०. २.२६.६ (२) सं०० (सं० तालु) । मुख के भीतर ऊपरी भाग । 'निज तालू गत रुधिर पान करि मन संतोष धरै ।' विन० ६२.४
ताव : सं०० (सं० ताप>ताव) । (१) सन्ताप, दुःख । 'तयो है तिहूं ताव रे ।' ___हनु० ३७ (२) क्रोध । 'भृगुनाथ खाइ गए ताव ।'
तावत् : अव्यय (सं०) । तब तक । मा० ७.१०८ १४
तावौं : आ० उए० (सं० स्तायति-ष्ट वेष्ट ने; तायति-ताय संवरणे>प्रा० तायमि>अ० ताय) । ढक दूं, लेइ से मूद दू, संवृत कर दूं। 'भेदि भुवन करि भानु बाहिरो तुरत राहु दे तावौं ।' गी० ६.८.२
तासु : मर्वनाम (सं० तस्य>प्रा० तस्स>अ० तासु) । उसका-की-के। 'तासु नास कल्पांत न होई ।' मा० ७.५७.१
तासू : तासु । 'नित नूतन मंगल गृह तासू।' मा० १.६६.४ 
ताहि, ही : उसको । 'सर निंदा करि ताहि बुझावा ।' मा० १.३६.४ 'काल धर्म नहिं ब्यापहिं ताही ।' मा० ७.१०४.७ 
ताहु, हू : उसे भी । 'हरषु बिरहु अति ताहु ।' मा० ७.४ ख 'आएँ सरन तजउ नहिं ताहू ।' मा० ५.४४.१
तिकाल : त्रिकाल । कवि० ७ १२१
तिक्खन : वि.पु. (सं० तीक्ष्ण>प्रो० तिक्ख) । (१) तीव्र । 'ते रन तिक्खन लक्खन लाखन ।' कवि० ६.३३ (२) नुकीला । प्रवेश करने वाला । 'लक्ख मैं पक्खर तिक्खन तेज ।' कवि० ६.३६
तिजरा : सं०० (सं० त्रिज्वर>प्रा० तिज्जर-तिज्जरअ)। एक प्रकार का ज्वर जो तीसरे दिन आता है और स्थायी होता है । विन० २७२.२
तिजारी : सं०स्त्री० (सं० त्रिज्वारिका>प्रा० तिज्जारिअ'>अ० तिज्जारी। तिजरा । मा० ६.१२१.१८
तितीर्षा : सं०स्त्री० (सं०) । पार जाने की इच्छा । मा० १ श्लो० ६
तिथि : संस्त्री० (सं.)। सूर्य और चन्द्र की गतियों के अन्तर से बनने वाला समयभागविशेष । मा० १.१६० 
_______________________________________________
417 
तिन : (१) सं०पु० (सं० तृण>प्रा० तिण)। तिनका । 'बिलोकि सब तिन तारही । मा० १.३२७ छं० १ (२) घास । 'चरइ हरित तिन बलि पसु जैसें ।' मा० २.२२.२ (३) तिन्ह । उन । 'सोध कीजे तिन को जो दोष दुख देत हैं।' हनु० ३२
तिनु : तिन+कए । एक तिनका । 'गिरि सिर तिनु धरहीं।' मा० २.२८५.३
तिन्ह : त+संब० (सं० तेषाम् >प्रा० ताण) । उन । 'तिन्ह निज ओर न लाउब भोरा ।' मा० १.५.१ 'तिन्ह कह सुखद।' मा० १.६.३ (२) उन्होंने। 'तिन्ह पाती दोन्ही ।' मा० १.२६०.३ 
तिन्हहि, ही : उन्हें । मा० १.६.५
तिन्हैं : तिन्हहि । 'तिन्हें समुझाइ कछू मुसुकाइ चली।' कवि० २.२२
तिपुरारि : त्रिपुरारि । मा० १.२७१ 
तिभुप्रन, तिभुवन : त्रिभुवन । मा० २.२६३.६; १६४.६
तिमि : (१) अव्यय (सं० तथा =अ० तिम)। उस प्रकार, वैसे, त्यों। तिमि 
सुरपतिहि न लाज ।' मा० १.१२५ (२) सं०० (सं.)। ह्वल मछली । __ 'महामीनाबास तिमि तोमनि को थल भो।' हनु० ७
तिमिर : सं०० (सं०) । अन्धकार । मा० १.११६.४
तिमिरु : तिमिर + कए । एक क्षुद्र अँधेरा । 'तिमिरु तरुन तरनिहि मकु गिलई ।' मा० २.२३२.१
तिमुहानी : सं० स्त्री० । तीन धाराओं का संगम (जहाँ तीन मुहाने हों)। 'त्रिविध  ताप भासक तिमुहानी ।' मा० १.४०.४
तिय : ती। स्त्री० । मा० १.१६.७ (२) पत्नी। राम एक तापस तिय तारी।' मा० १.२४.६ 
तियन, नि, न्हि : तिय+संब० । स्त्रियों। 'देखि तियनि के नयन सम्ल भए ।' गी० १.१०७.३
तियमनि : स्त्रियों में शिरोमणि, श्रेष्ठ स्त्री । 'मैना तासु घरनि घर त्रिभुभव तिय 
___मनि ।' पा०म०६
तिरछी : वि०स्त्री० (सं० तिरश्चीचला>प्रा० तिरिच्छी)। टेढ़ी; वक्र । राना १४
तिरछे : वि०पू०प० । 'तिरछे करि नैन, द सैन।' कवि० २.२२
तिरछौंहैं : क्रि०प० (सं० तिर्यङ मुख>प्रा. तिरिच्छमुह) । तिरछे होकर, तिरछे प्रकार से । 'अचान दिष्टि परी तिरछों हैं।' कवि० २.२५
तिरहुति : सं०स्त्री०=तेरहुति । 'भूमि तिलक सम तिरहुति ।' जा०म० ४
तिरहूति : तिरहुति। 
418 
तुलसी शब्दकोश 
तिरा : भूकृ.पु । तीर पर पहुंचा, तर गया, पार हो गया। 'लोह ल लोका तिरा।' मा० २.२५१ छं०
तिरीछी : तिरछी। कवि० २.२१
तिरीछे : क्रि०वि० । वक्रता से, टेढ़े-टेढ़े। 'तिरी, प्रियाहि चित।' कवि० २.२६
तिरीछे : तिरछे (सं० तिरश्चीन>प्रा. तिरिच्छय)। आड़े-टेढ़े । 'खंजन मंज तिरीछे नयननि ।' मा० २.११७.७
तिल : सं०० (सं.)। धान्य विशेष जिससे तेल निकलता है। मा० ३.१६ ख (२) शरीर में तिलाकार चिन्ह । 'चारु चिबुक तिल जासु ।' दो० १६१
तिलक : सं०० (सं०) । टीका । (१) मस्तक का ऊर्ध्वपुण्ड । 'किएँ तिलक गुन गन बस करनी।' मा० १.१.४ (२) राज्याभिषेक का टीका। 'रामहि तिलक कालि जौं भयऊ ।' मा० २.१६.६ (३) तिलक के समान उत्तम (शिरोमणि); श्रेष्ठ । 'रघुकुल तिलक जोरि दोउ हाथा।' मा० २.५२.१ (४) तिल का पुष्प-नासा तिलक को बरन पारे। मा० १.१६६.८
तिलकु : तिलक+कए । मा० १.३२७.६
तिल-तिल : (तिल के समान) थोड़ा-थोड़ा, धीरे-धीरे । 'जा के मन ते उठि गई तिल-तिल तस्ना चाहि।' वैरा० २६
तिलांजलि : संस्त्री० (सं.)। पितृ कर्म में तिल सहित जल की अञ्जलि। 'देउ तिलांजलि ताहि ।' मा० ४.२७
तिलांजूलि : तिलांजलि । मा० २.१७०.५
तिली : तेली (प्रा० तेल्लिअ तिल्लिअ) । पेरत कोल्हू मेलि तिल, तिली सनेही जानि ।' दो० ४०३
तिल : तिल+कए । एक तिल (की मात्रा)। 'तिलु भरि भूमि न सके छड़ाई ।' मा० १.२५२.२
तिलोक : त्रिलोक । मा० २.२०६.३
तिलोकिए : त्रिलोकी भर में तीनों ही लोकों में। ‘मानहुँ रह्यो है भरि बानरु तिलोकिए।' कवि० ५.१७
तिलोकु : तिलोक+कए० । एकीभूत सम्पूर्ण त्रैलोक्य । कवि० ६.५६
तिलोचन : कवि० ७.१५७
तिलौ : तिल भी, तिल भर भी, थोड़ा-सा भी । 'तुलसी तिलो न भयो बाहेर अगार को। कवि० ५.१२ तिष्ट
इ : आ० प्रब० (सं० तिष्ठति>प्रा० मागधी--तिस्टइ) । ठहरता है, रह सकता ___है। 'भूत द्रोह लिष्टइ नहिं सोई ।' मा० ५.३८.७
तिष्ठन्ति : आप्रब० (सं०) । रहते हैं, स्थिति हैं । विन० ५७.५
तिसिरा : त्रिसिरा । मा० ३.२५ 
_______________________________________________
419 

तिहारिय, ये : तेरी ही । 'मोसे दीन दुबरे को तकिया तिहारिये।' हनु० २२
तिहारी : तेरी। कृ० ६
तिहारें : तेरे से । 'सुजस तिहारें भरे भुअन ।' कवि० १.१६
तिहारे : तेरे । 'महरि तिहारे पायँ परौं ।' कृ० ७
तिहारो : बि.पु.कए । तेरा । 'सदा जन के मन बास तिहारो।' हनु० १६ ॥
तिहारोइ : तेरा ही। तहरोइ नामु गयंद चढ़ायो .' कवि० ७.६० ।। 
तिहुं, तिहु : तीनों। 'चहुं जुगतीनि काल तिहुँ लोका।' मा० १.२७.१ 'पुरुषसिंघ तिहु पुर उजिआरे ।' मा० १.२६२.१
तिहूँ : तिहुं+उ। तीनों ही । 'तजें तिहूं पुर अपजसु छावा।' मा० २.६५.६.
तिहुन : तिहूँ । 'प्रीति परिच्छा तिहुन की।' दो० ३५२
तो : (१) हुती थी। (२) तिय । स्त्री । 'किय भूषन तिय ती को।' मा० १.१६.७
तीखी : वि०स्त्री० (सं० तीक्ष्णा>प्रा० तिक्खी)। तीव्र । 'तीखी तुरा तुलसी कहतो, पहिएँ उपमा को समाउ न आयो।' कवि० ६.५४ ।।
तीखे : वि.पु.ब० (सं० तीक्ष्ण>प्रा० तिक्ख=तिक्खय)। तीव्र, अति वेगशील । तीखे तुरंग कुरंग सुरंगनि ।' कवि० ६.३२ 
तोच्छन, तीछन : तिक्खन (सं० तीक्ष्ण>प्रा. तिच्छ) । विन० ५५.४ ‘राम भजन तीछन कुठार ।' विन० २०२.२
तीछी : वि०स्त्री० (सं० तीक्ष्णा>प्रा० तिच्छी)। तीखी, तीव्र । 'तजहि बिषम बिषु तामस तीछी।' मा० २.२६२.८
तीछे : (सं० तीक्ष्णेन>प्रा० तिच्छेण>अ० तिच्छे) तीक्ष्ण से। ‘राम बियोगि बिकल दुख तीछे।' मा० २.१४३.६
तीज : सं०+वि० (सं० तृतीय, तृतीया>प्रा० तिइज्ज, तिइज्जा>अ० तिइज्ज = तिज्ज) । (१) पक्ष की तीसरी तिथि+ (२) तीसरी (बात) । विन० 
२०३.४, तीजे : वि०पु० (सं० तृतीये>प्रा० तिइज्जे )। तीसरे। 'मोहि तोहि भूप भेंट दिन तीजे ।' मा० १.१६६.७
तीतर : सं०पु० (सं० तित्तिरि) । पक्षिविशेष । कवि० ६.२६ तीतिर । तीतर । मा० ३.३८.७
तीनि : संख्या (सं० त्रीणि)। तीन । मा० १.२७.१
तोनिअवस्था : तुरीय को छोड़कर चेतन की शेष तीन
दशाएँ :-- (१) जाग्रत् = स्थूल शरीर=अन्नमय कोश= स्थूल देहाभिमानी जीवदशा। (२) स्वप्न == सूक्ष्मश-रीर =(क) पञ्चकर्मेन्द्रिय सहित प्राणपञ्चक का प्राणमय कोश (ख) पञ्चज्ञानेन्द्रिय सहित मन का मनोमय कोश (ग) ज्ञानेन्द्रिय सहित बुद्धि का विज्ञानमय कोश सूक्ष्मशरीराभिमानी-जीवदशा (३) सुषप्ति=कारणशरीर 
420 
_______________________________________________
आनन्दमय कोश आनन्द रूप आत्मा+सूक्ष्म मायावृत्ति का आवरण= आनन्दाभिमानी जीवदशा । 'तीनि-अवस्थी तीनि गुन तेहि कपास तें काढ़ि।' 
मा० ७.११७ ग । दे० तुरीय
तीनिउँ : तीनों ने । 'कीन्हि दंडवत तीनिउँ भाई।' मा० ७.३३.१
तीनिउ : तीनों । 'तीनिउ भाइ राम सम जानी ।' मा० १.३२८.६
तीनिहुं : तीनिउँ । कीन्ह बिबिध तप तीनिहुं भाई ।' मा० १.१७७.१
तीनी : तीनि । मा० ७.७१.६
तीनो : तीनिउ । दो० ५३८
तोत्र : वि० (सं० तीव्र) । तीक्ष्ण, वेगयुक्त । मा० ६.७१.४ 
तीय, या : तिय । मा० १.२४७.४ ।
तीर : सं०पु० (सं.) (१) तट । 'जन सरि तीर तीर बन बागा। मा० १.४०.६ (२) (सं०+फा०) बाण । 'तकि तकि तीर महीस चलावा ।' मा० १.१५७.३
तीरथ : सं० पु. (सं० तीर्थ) । (१) पूज्य स्थानों के अधिदेव । 'तीरथ सकल तहाँ चलि आवहिं ।' मा० १.३४.६ (२) पूज्य पावन भू-भाग। 'तीरथ बर नैमिष बिख्याता ।' मा० १.१४३.२ (३) तीर्थाटन । 'आज सुफल तपु तीरथ त्याग।' मा० २.१०७.५ (४) पूज्य जन के जन्म-कर्म का प्रसिद्ध स्थान । 'चरन राम तीरथ चलि जाहीं।' मा० २.१२६.५ (५) उत्तम जलाश्रय=नदी-सरोवर आदि । 'तीरथ .........निमज्जहिं ।' मा० १.२२४.२ 'तीरथ-मज्जन ।' मा० ७.४६.२
तीरथन्ह : तीरथ-+संब०। तीर्थों । 'सब तीरथन्ह बिचित्र बनाए।' मा० १.१५५.८
तीरथपति : तीरथराज । प्रयाग । मा०
२.१०६:२
तीरथराऊ : (दे० राऊ) । एकमात्र तीर्थों का राजा, प्रयाग। मा० १.२.१३ 
तीरथराज, जा: प्रयाग । मा० १.२.११; ४४.७ 
तीरथराजु, जू : तीरथराज+कए० । एकमात्र तीर्थराज ।' मा० १.२.७; २.१०५.२
तीरा : तीर । (१) तट । 'पहुँचे जाइ धेनुमति तीरा ।' मा० १.१४३.५ (२) बाण। 'छन महं जरे निसाचर तीरा ।' मा० ६.६१.३
तीर्थाटन : (तीर्थ+अटन-सं०) तीर्थ-यात्रा । मा० ७.१२६.४
तीस : संख्या (सं० त्रिंशत् >प्रा० तीसा) । मा० ६.६२.१०
तीसर : वि०पू० । तृतीय । मा० १.८७.६
तीसरि : वि.स्त्री० । तीसरी । मा० ३.३५
तीसरें: तीसरे में, पर । 'तीसरें उपास.. एक दिन दानु भो।' कवि० ५.३२
तीसरे : 'तीसर' का रूपान्तर । भरत तीसरे पहर कहें कीन्ह प्रबेस प्रयाग।' मा० २.२०३